Date,A_SB,A_NB,A_Total,B_SB,B_NB,B_Total,H_SB,H_NB,H_Total,A_Day,H_Day,A_WD,H_WD,A_M,H_M,A_DM,H_DM,Year
1/1/2019,4791,6094,10885,6215,8470,14685,4679,6844,11523,2,2,0,0,1,1,1,2,2019
1/2/2019,5678,6445,12123,5526,7377,12903,4160,5961,10121,3,3,0,0,1,1,2,3,2019
1/3/2019,5962,6492,12454,5275,6580,11855,3971,5317,9288,4,4,0,0,1,1,3,4,2019
1/4/2019,6124,8369,14493,5118,6025,11144,3853,4869,8722,5,5,1,1,1,1,4,5,2019
1/5/2019,6200,8665,14865,5420,8503,13923,4080,6871,10951,6,6,1,1,1,1,5,6,2019
1/6/2019,4963,8714,13677,4793,8618,13411,3608,6964,10572,7,7,1,1,1,1,6,7,2019
1/7/2019,3905,7996,11901,2917,6372,9289,2196,5149,7345,1,1,0,0,1,1,7,8,2019
1/8/2019,3110,6672,9782,3019,5961,8981,2273,4817,7090,2,2,0,0,1,1,8,9,2019
1/9/2019,2636,5322,7958,2698,5118,7816,2031,4136,6167,3,3,0,0,1,1,9,10,2019
1/10/2019,3177,4783,7960,2929,4604,7533,2205,3720,5925,4,4,0,0,1,1,10,11,2019
1/11/2019,3188,5030,8218,3410,4354,7764,2567,3518,6085,5,5,1,1,1,1,11,12,2019
1/12/2019,2927,5766,8693,2906,4313,7219,2188,3485,5673,6,6,1,1,1,1,12,13,2019
1/13/2019,2974,5729,8703,2637,5289,7926,1985,4274,6259,7,7,1,1,1,1,13,14,2019
1/14/2019,1931,4413,6344,1767,4685,6452,1330,3786,5116,1,1,0,0,1,1,14,15,2019
1/15/2019,2056,4208,6264,1914,4154,6069,1441,3357,4798,2,2,0,0,1,1,15,16,2019
1/16/2019,2179,3558,5737,2144,4149,6293,1614,3353,4967,3,3,0,0,1,1,16,17,2019
1/17/2019,3321,3636,6957,3244,3402,6646,2442,2749,5191,4,4,0,0,1,1,17,18,2019
1/18/2019,3858,3617,7475,3116,3403,6520,2346,2750,5096,5,5,1,1,1,1,18,19,2019
1/19/2019,2977,4293,7270,2500,3668,6168,1882,2964,4846,6,6,1,1,1,1,19,20,2019
1/20/2019,2439,4593,7032,2674,4635,7309,2013,3745,5758,7,7,1,1,1,1,20,21,2019
1/21/2019,1751,4809,6560,1740,3679,5419,1310,2973,4283,1,1,0,0,1,1,21,22,2019
1/22/2019,1844,3983,5827,2010,3237,5247,1513,2616,4129,2,2,0,0,1,1,22,23,2019
1/23/2019,2074,3249,5323,2305,2896,5201,1735,2340,4075,3,3,0,0,1,1,23,24,2019
1/24/2019,2959,3393,6352,3280,3318,6598,2469,2681,5150,4,4,0,0,1,1,24,25,2019
1/25/2019,3284,3213,6497,3475,3091,6566,2616,2498,5114,5,5,1,1,1,1,25,26,2019
1/26/2019,2472,3890,6362,2455,3541,5995,1848,2861,4709,6,6,1,1,1,1,26,27,2019
1/27/2019,2453,4243,6696,2762,4517,7279,2079,3650,5729,7,7,1,1,1,1,27,28,2019
1/28/2019,1801,3955,5756,2083,3146,5229,1568,2542,4110,1,1,0,0,1,1,28,29,2019
1/29/2019,1761,3116,4877,2314,3138,5452,1742,2536,4278,2,2,0,0,1,1,29,30,2019
1/30/2019,2275,3057,5332,3018,3716,6734,2272,3003,5275,3,3,0,0,1,1,30,31,2019
1/31/2019,3073,4023,7096,4570,6374,10944,1932,2964,4896,4,4,0,0,1,2,31,1,2019
2/1/2019,2657,4499,7156,2032,3631,5663,1654,3178,4832,5,5,1,1,2,2,1,2,2019
2/2/2019,2273,3873,6146,2152,3526,5678,1752,3086,4838,6,6,1,1,2,2,2,3,2019
2/3/2019,2161,4151,6312,2005,4093,6098,1632,3582,5214,7,7,1,1,2,2,3,4,2019
2/4/2019,3650,3152,6802,3785,2557,6342,3081,2238,5319,1,1,0,0,2,2,4,5,2019
2/5/2019,2952,2754,5706,2824,2474,5298,2299,2165,4464,2,2,0,0,2,2,5,6,2019
2/6/2019,2289,2767,5056,2576,2450,5026,2097,2144,4241,3,3,0,0,2,2,6,7,2019
2/7/2019,2780,2497,5277,3702,2794,6496,3014,2445,5459,4,4,0,0,2,2,7,8,2019
2/8/2019,2983,2981,5964,3215,2659,5874,2617,2327,4944,5,5,1,1,2,2,8,9,2019
2/9/2019,2588,3288,5876,2763,3201,5963,2249,2801,5050,6,6,1,1,2,2,9,10,2019
2/10/2019,2588,3487,6075,2965,3791,6757,2414,3318,5732,7,7,1,1,2,2,10,11,2019
2/11/2019,1752,3453,5205,1876,3177,5052,1527,2780,4307,1,1,0,0,2,2,11,12,2019
2/12/2019,2002,2734,4736,2004,2833,4836,1631,2479,4110,2,2,0,0,2,2,12,13,2019
2/13/2019,2654,2275,4929,2375,2854,5229,1933,2498,4431,3,3,0,0,2,2,13,14,2019
2/14/2019,4271,2429,6700,4228,3038,7267,3442,2659,6101,4,4,0,0,2,2,14,15,2019
2/15/2019,4483,3020,7503,4350,3012,7362,3541,2636,6177,5,5,1,1,2,2,15,16,2019
2/16/2019,3252,3397,6649,3188,3357,6545,2595,2938,5533,6,6,1,1,2,2,16,17,2019
2/17/2019,2925,3906,6831,2556,4312,6869,2081,3774,5855,7,7,1,1,2,2,17,18,2019
2/18/2019,1996,5981,7977,1899,5059,6958,1546,4427,5973,1,1,0,0,2,2,18,19,2019
2/19/2019,1934,4230,6164,1903,4068,5971,1549,3560,5109,2,2,0,0,2,2,19,20,2019
2/20/2019,2168,3045,5213,2018,3038,5057,1643,2659,4302,3,3,0,0,2,2,20,21,2019
2/21/2019,3322,3113,6435,2773,3097,5869,2257,2710,4967,4,4,0,0,2,2,21,22,2019
2/22/2019,3389,3351,6740,2489,2906,5395,2026,2543,4569,5,5,1,1,2,2,22,23,2019
2/23/2019,2522,3973,6495,2026,3610,5635,1649,3159,4808,6,6,1,1,2,2,23,24,2019
2/24/2019,2741,4616,7357,2715,4416,7131,2210,3865,6075,7,7,1,1,2,2,24,25,2019
2/25/2019,2188,3568,5756,1760,2972,4732,1433,2601,4034,1,1,0,0,2,2,25,26,2019
2/26/2019,2267,3016,5283,1499,3018,4516,1220,2641,3861,2,2,0,0,2,2,26,27,2019
2/27/2019,2560,2687,5247,2673,2913,5586,2176,2549,4725,3,3,0,0,2,2,27,28,2019
2/28/2019,3787,3067,6854,2373,3387,5760,2335,2267,4602,4,4,0,0,2,3,28,1,2019
3/1/2019,3846,3027,6873,3070,2674,5745,2281,2218,4499,5,5,1,1,3,3,1,2,2019
3/2/2019,3194,3380,6574,2582,3008,5590,1918,2495,4413,6,6,1,1,3,3,2,3,2019
3/3/2019,2936,3940,6876,2432,3854,6286,1807,3196,5003,7,7,1,1,3,3,3,4,2019
3/4/2019,2051,3503,5554,1981,3048,5030,1472,2528,4000,1,1,0,0,3,3,4,5,2019
3/5/2019,2167,3374,5541,1848,2720,4568,1373,2256,3629,2,2,0,0,3,3,5,6,2019
3/6/2019,2283,3064,5347,2135,2688,4823,1586,2229,3815,3,3,0,0,3,3,6,7,2019
3/7/2019,3092,3345,6437,3127,2630,5757,2323,2181,4504,4,4,0,0,3,3,7,8,2019
3/8/2019,3453,3411,6864,3271,2627,5898,2430,2179,4609,5,5,1,1,3,3,8,9,2019
3/9/2019,2741,3964,6705,2910,3494,6405,2162,2898,5060,6,6,1,1,3,3,9,10,2019
3/10/2019,2702,4021,6723,3371,3661,7031,2504,3036,5540,7,7,1,1,3,3,10,11,2019
3/11/2019,2344,4093,6437,2446,3077,5523,1817,2552,4369,1,1,0,0,3,3,11,12,2019
3/12/2019,2280,3340,5620,2451,2549,5000,1821,2114,3935,2,2,0,0,3,3,12,13,2019
3/13/2019,2675,2828,5503,2945,2638,5583,2188,2188,4376,3,3,0,0,3,3,13,14,2019
3/14/2019,3523,3795,7318,3727,3037,6765,2769,2519,5288,4,4,0,0,3,3,14,15,2019
3/15/2019,3801,4072,7873,3579,3370,6949,2659,2795,5454,5,5,1,1,3,3,15,16,2019
3/16/2019,3893,4615,8508,3243,3515,6758,2409,2915,5324,6,6,1,1,3,3,16,17,2019
3/17/2019,3310,4503,7813,3190,4171,7361,2370,3459,5829,7,7,1,1,3,3,17,18,2019
3/18/2019,4204,3291,7495,3699,3121,6820,2748,2588,5336,1,1,0,0,3,3,18,19,2019
3/19/2019,3276,2925,6201,2675,2894,5569,1987,2400,4387,2,2,0,0,3,3,19,20,2019
3/20/2019,2945,2935,5880,3084,3691,6775,2291,3061,5352,3,3,0,0,3,3,20,21,2019
3/21/2019,3805,3371,7176,3933,3839,7772,2922,3184,6106,4,4,0,0,3,3,21,22,2019
3/22/2019,4649,3606,8255,4198,5611,9809,3119,4653,7772,5,5,1,1,3,3,22,23,2019
3/23/2019,4702,4408,9110,3906,6066,9973,2902,5031,7933,6,6,1,1,3,3,23,24,2019
3/24/2019,3737,4825,8562,3733,6544,10276,2773,5427,8200,7,7,1,1,3,3,24,25,2019
3/25/2019,2809,4025,6834,2766,5320,8086,2055,4412,6467,1,1,0,0,3,3,25,26,2019
3/26/2019,2476,3802,6278,2603,5327,7930,1934,4418,6352,2,2,0,0,3,3,26,27,2019
3/27/2019,2771,3458,6229,3124,5615,8740,2321,4657,6978,3,3,0,0,3,3,27,28,2019
3/28/2019,3752,3873,7625,2373,3387,5760,3068,4395,7463,4,4,0,0,3,3,28,29,2019
3/29/2019,4335,4178,8513,4986,4349,9335,3704,3607,7311,5,5,1,1,3,3,29,30,2019
3/30/2019,4112,5636,9748,6573,5184,11756,4883,4299,9182,6,6,1,1,3,3,30,31,2019
3/31/2019,3579,5317,8896,4900,4647,9545,4537,3915,8452,7,7,1,1,3,4,31,1,2019
4/1/2019,2673,4920,7593,3410,3919,7330,3185,3749,6934,1,1,0,0,4,4,1,2,2019
4/2/2019,2330,4033,6363,2939,3464,6403,2757,3315,6072,2,2,0,0,4,4,2,3,2019
4/3/2019,2477,3493,5970,3104,3231,6335,2907,3093,6000,3,3,0,0,4,4,3,4,2019
4/4/2019,3421,3760,7181,3681,3049,6730,3431,2920,6351,4,4,0,0,4,4,4,5,2019
4/5/2019,3508,3845,7353,3497,2847,6344,3264,2728,5992,5,5,1,1,4,4,5,6,2019
4/6/2019,3070,4678,7748,3364,3297,6661,3143,3156,6299,6,6,1,1,4,4,6,7,2019
4/7/2019,2887,5287,8174,3281,4251,7532,3068,4516,7584,7,7,1,1,4,4,7,8,2019
4/8/2019,2128,4511,6639,2316,3402,5717,2190,3256,5446,1,1,0,0,4,4,8,9,2019
4/9/2019,2082,3864,5946,1948,2742,4691,1856,2628,4484,2,2,0,0,4,4,9,10,2019
4/10/2019,2511,3550,6061,2062,2479,4541,1874,2377,4251,3,3,0,0,4,4,10,11,2019
4/11/2019,3676,4559,8235,3121,3326,6447,2553,2686,5239,4,4,0,0,4,4,11,12,2019
4/12/2019,3572,5762,9334,3337,4869,8206,2449,2614,5063,5,5,1,1,4,4,12,13,2019
4/13/2019,3161,7079,10240,3099,5266,8364,2041,3288,5329,6,6,1,1,4,4,13,14,2019
4/14/2019,2433,5966,8399,2957,5681,8638,2045,3698,5743,7,7,1,1,4,4,14,15,2019
4/15/2019,2321,5415,7736,2167,4616,6783,1703,2819,4522,1,1,0,0,4,4,15,16,2019
4/16/2019,2417,5101,7518,2034,4622,6656,1660,2443,4103,2,2,0,0,4,4,16,17,2019
4/17/2019,2883,5037,7920,2460,4873,7333,1956,2337,4293,3,3,0,0,4,4,17,18,2019
4/18/2019,3855,4805,8660,3281,4598,7879,2713,2439,5152,4,4,0,0,4,4,18,19,2019
4/19/2019,4577,3855,8432,3981,3770,7751,2584,2628,5212,5,5,1,1,4,4,19,20,2019
4/20/2019,4820,3859,8679,5278,4497,9775,1936,2727,4663,6,6,1,1,4,4,20,21,2019
4/21/2019,4917,4067,8984,4897,4094,8991,2164,3503,5667,7,7,1,1,4,4,21,22,2019
4/22/2019,4317,4186,8503,3410,3919,7330,1882,2967,4849,1,1,0,0,4,4,22,23,2019
4/23/2019,3829,4174,8003,3077,3464,6541,1647,2448,4095,2,2,0,0,4,4,23,24,2019
4/24/2019,3882,3662,7544,3250,3231,6480,2072,2598,4670,3,3,0,0,4,4,24,25,2019
4/25/2019,4693,3482,8175,3852,3049,6901,2513,3310,5823,4,4,0,0,4,4,25,26,2019
4/26/2019,4966,3082,8048,3660,2847,6508,2257,3676,5933,5,5,1,1,4,4,26,27,2019
4/27/2019,4578,3853,8431,3521,3297,6818,1980,3319,5299,6,6,1,1,4,4,27,28,2019
4/28/2019,4264,4622,8886,3435,3725,7160,2233,3747,5980,7,7,1,1,4,4,28,29,2019
4/29/2019,2966,4564,7530,2425,3402,5827,1938,2755,4693,1,1,0,0,4,4,29,30,2019
4/30/2019,2805,3679,6484,2041,2742,4783,3225,2198,5423,2,2,0,0,4,5,30,1,2019
5/1/2019,3322,3588,6910,3321,2302,5623,2696,2017,4713,3,3,0,0,5,5,1,2,2019
5/2/2019,4481,3287,7768,3649,2812,6461,2962,2464,5426,4,4,0,0,5,5,2,3,2019
5/3/2019,3990,3664,7654,3748,2828,6576,2951,2380,5331,5,5,1,1,5,5,3,4,2019
5/4/2019,3429,3874,7303,3316,2736,6052,2601,2496,5097,6,6,1,1,5,5,4,5,2019
5/5/2019,3418,4420,7838,3256,3739,6995,2461,3276,5737,7,7,1,1,5,5,5,6,2019
5/6/2019,3013,4423,7436,2539,3250,5789,1970,2848,4818,1,1,0,0,5,5,6,7,2019
5/7/2019,3138,3739,6877,2721,2881,5602,2209,2524,4733,2,2,0,0,5,5,7,8,2019
5/8/2019,3648,2965,6613,3547,2487,6034,2788,2179,4967,3,3,0,0,5,5,8,9,2019
5/9/2019,4727,3222,7949,3029,2997,6026,2459,2626,5085,4,4,0,0,5,5,9,10,2019
5/10/2019,3644,3661,7305,2829,3598,6427,2296,3153,5449,5,5,1,1,5,5,10,11,2019
5/11/2019,2798,4464,7262,2459,3840,6299,1996,3463,5459,6,6,1,1,5,5,11,12,2019
5/12/2019,3040,5077,8117,2459,4309,6768,1996,3874,5870,7,7,1,1,5,5,12,13,2019
5/13/2019,2451,4338,6789,2336,3468,5804,1896,3039,4935,1,1,0,0,5,5,13,14,2019
5/14/2019,2267,4354,6621,2534,3212,5746,2057,2814,4871,2,2,0,0,5,5,14,15,2019
5/15/2019,2656,3633,6289,2340,3135,5475,1899,2747,4646,3,3,0,0,5,5,15,16,2019
5/16/2019,3788,3766,7554,3107,3029,6136,2522,2654,5176,4,4,0,0,5,5,16,17,2019
5/17/2019,3301,3950,7251,3070,3544,6614,2492,3105,5597,5,5,1,1,5,5,17,18,2019
5/18/2019,2904,4375,7279,2485,3290,5775,2017,2883,4900,6,6,1,1,5,5,18,19,2019
5/19/2019,3198,4691,7889,2943,3906,6850,2389,3521,5910,7,7,1,1,5,5,19,20,2019
5/20/2019,2359,4200,6559,2243,3212,5455,1821,2814,4635,1,1,0,0,5,5,20,21,2019
5/21/2019,2841,3799,6640,2657,2870,5528,2157,2515,4672,2,2,0,0,5,5,21,22,2019
5/22/2019,3440,3464,6904,2953,2902,5855,2397,2543,4940,3,3,0,0,5,5,22,23,2019
5/23/2019,5452,3536,8988,4916,3111,8027,3990,2726,6716,4,4,0,0,5,5,23,24,2019
5/24/2019,5644,3421,9065,5445,2982,8427,4420,2688,7108,5,5,1,1,5,5,24,25,2019
5/25/2019,4859,3761,8620,4098,3081,7179,3236,2700,5936,6,6,1,1,5,5,25,26,2019
5/26/2019,3582,3999,7581,2965,3585,6550,2407,3141,5548,7,7,1,1,5,5,26,27,2019
5/27/2019,3016,6948,9964,2661,5641,8302,2160,5041,7201,1,1,0,0,5,5,27,28,2019
5/28/2019,2742,5322,8064,2386,4542,6929,1937,4078,6015,2,2,0,0,5,5,28,29,2019
5/29/2019,2731,3878,6609,2330,3360,5690,1891,2944,4835,3,3,0,0,5,5,29,30,2019
5/30/2019,3569,3706,7275,3319,3241,6560,2694,2840,5534,4,4,0,0,5,5,30,31,2019
5/31/2019,3689,4253,7942,3190,3156,6346,2589,3222,5811,5,5,1,1,5,6,31,1,2019
6/1/2019,3128,4313,7441,3130,3692,6822,2429,3063,5492,6,6,1,1,6,6,1,2,2019
6/2/2019,3586,4358,7944,3204,3999,7202,2486,3318,5804,7,7,1,1,6,6,2,3,2019
6/3/2019,3487,3885,7372,3103,3164,6267,2408,2625,5033,1,1,0,0,6,6,3,4,2019
6/4/2019,3324,3414,6738,3148,2893,6041,2443,2400,4843,2,2,0,0,6,6,4,5,2019
6/5/2019,3438,3214,6652,3267,2808,6075,2535,2330,4865,3,3,0,0,6,6,5,6,2019
6/6/2019,4412,2983,7395,3845,2803,6649,2984,2326,5310,4,4,0,0,6,6,6,7,2019
6/7/2019,4306,3004,7310,4271,3190,7461,3314,2647,5961,5,5,1,1,6,6,7,8,2019
6/8/2019,4463,3991,8454,4057,3238,7295,3148,2687,5835,6,6,1,1,6,6,8,9,2019
6/9/2019,3913,4125,8038,3832,3972,7805,2974,3296,6270,7,7,1,1,6,6,9,10,2019
6/10/2019,3679,3953,7632,3206,3105,6311,2488,2576,5064,1,1,0,0,6,6,10,11,2019
6/11/2019,4142,3360,7502,3747,3109,6857,2908,2580,5488,2,2,0,0,6,6,11,12,2019
6/12/2019,3778,3193,6971,3732,3112,6844,2896,2582,5478,3,3,0,0,6,6,12,13,2019
6/13/2019,4937,3338,8275,4277,3350,7627,3319,2780,6099,4,4,0,0,6,6,13,14,2019
6/14/2019,4710,3463,8173,4624,3255,7879,3588,2701,6289,5,5,1,1,6,6,14,15,2019
6/15/2019,5159,4749,9908,4834,4136,8970,3751,3432,7183,6,6,1,1,6,6,15,16,2019
6/16/2019,4643,4478,9121,4104,4597,8701,3185,3482,6667,7,7,1,1,6,6,16,17,2019
6/17/2019,4496,4544,9040,3537,3741,7278,2745,3104,5849,1,1,0,0,6,6,17,18,2019
6/18/2019,4402,4455,8857,4026,3706,7732,3124,3075,6199,2,2,0,0,6,6,18,19,2019
6/19/2019,4131,3469,7600,3933,3529,7462,3052,2928,5980,3,3,0,0,6,6,19,20,2019
6/20/2019,5533,4331,9864,4628,3208,7836,3591,2662,6253,4,4,0,0,6,6,20,21,2019
6/21/2019,4729,4524,9253,4664,4024,8688,3619,3339,6958,5,5,1,1,6,6,21,22,2019
6/22/2019,4556,5343,9899,4376,4728,9104,3396,3923,7319,6,6,1,1,6,6,22,23,2019
6/23/2019,4216,5406,9622,4112,4837,8949,3191,4013,7204,7,7,1,1,6,6,23,24,2019
6/24/2019,3685,5245,8930,3268,4387,7655,2536,3640,6176,1,1,0,0,6,6,24,25,2019
6/25/2019,4084,5069,9153,3528,4374,7902,2738,3629,6367,2,2,0,0,6,6,25,26,2019
6/26/2019,3969,4399,8368,3809,4168,7977,2956,3458,6414,3,3,0,0,6,6,26,27,2019
6/27/2019,5095,4866,9961,4722,3884,8606,3664,3223,6887,4,4,0,0,6,6,27,28,2019
6/28/2019,4507,5016,9523,4836,4585,9421,3753,3804,7557,5,5,1,1,6,6,28,29,2019
6/29/2019,4671,6058,10729,5053,4464,9517,3921,4368,8289,6,6,1,1,6,6,29,30,2019
6/30/2019,4082,6158,10240,3336,4283,7619,2865,4776,7641,7,7,1,1,6,7,30,1,2019
7/1/2019,3389,5589,8978,2890,4921,7811,2243,4079,6322,1,1,0,0,7,7,1,2,2019
7/2/2019,4241,5242,9483,3892,5148,9040,3021,4267,7288,2,2,0,0,7,7,2,3,2019
7/3/2019,4918,5001,9919,3841,4986,8827,2981,4133,7114,3,3,0,0,7,7,3,4,2019
7/4/2019,5483,4503,9986,3772,4998,8771,2928,4143,7071,4,4,0,0,7,7,4,5,2019
7/5/2019,3572,5255,8827,3656,5178,8834,2838,4292,7130,5,5,1,1,7,7,5,6,2019
7/6/2019,3647,5943,9590,3478,5966,9445,2700,4945,7645,6,6,1,1,7,7,6,7,2019
7/7/2019,3420,7359,10779,3493,6087,9579,2711,5045,7756,7,7,1,1,7,7,7,8,2019
7/8/2019,3018,6255,9273,2895,5879,8774,2247,4873,7120,1,1,0,0,7,7,8,9,2019
7/9/2019,3233,5537,8770,3341,5055,8396,2593,4190,6783,2,2,0,0,7,7,9,10,2019
7/10/2019,3165,4543,7708,3686,4668,8354,2861,3869,6730,3,3,0,0,7,7,10,11,2019
7/11/2019,4129,4778,8907,4166,5370,9536,3234,4451,7685,4,4,0,0,7,7,11,12,2019
7/12/2019,3985,5135,9120,4201,5120,9322,3261,4244,7505,5,5,1,1,7,7,12,13,2019
7/13/2019,3822,5710,9532,3640,5979,9618,2825,4729,7554,6,6,1,1,7,7,13,14,2019
7/14/2019,3478,5709,9187,3744,5923,9667,2906,4683,7589,7,7,1,1,7,7,14,15,2019
7/15/2019,3021,5213,8234,2912,5111,8022,2260,4236,6496,1,1,0,0,7,7,15,16,2019
7/16/2019,3450,5283,8733,3373,4710,8083,2618,3904,6522,2,2,0,0,7,7,16,17,2019
7/17/2019,3705,4860,8565,3873,4982,8854,3006,4129,7135,3,3,0,0,7,7,17,18,2019
7/18/2019,4864,5037,9901,4384,5450,9834,3403,4291,7694,4,4,0,0,7,7,18,19,2019
7/19/2019,4426,4906,9332,4553,5223,9776,3534,4103,7637,5,5,1,1,7,7,19,20,2019
7/20/2019,4311,5702,10013,4480,5454,9934,3477,4521,7998,6,6,1,1,7,7,20,21,2019
7/21/2019,4246,5588,9834,4303,5450,9753,3340,4517,7857,7,7,1,1,7,7,21,22,2019
7/22/2019,3840,5467,9307,3803,4766,8569,2952,3950,6902,1,1,0,0,7,7,22,23,2019
7/23/2019,4036,4863,8899,3990,4586,8576,3097,3801,6898,2,2,0,0,7,7,23,24,2019
7/24/2019,4045,4413,8458,4146,4160,8306,3218,3448,6666,3,3,0,0,7,7,24,25,2019
7/25/2019,5027,4729,9756,4432,4804,9236,3440,3982,7422,4,4,0,0,7,7,25,26,2019
7/26/2019,4761,4675,9436,4661,5177,9838,3618,4291,7909,5,5,1,1,7,7,26,27,2019
7/27/2019,4527,5550,10077,4628,5307,9935,3678,4399,8077,6,6,1,1,7,7,27,28,2019
7/28/2019,4299,6013,10312,4346,5802,10147,3373,4809,8182,7,7,1,1,7,7,28,29,2019
7/29/2019,3894,5600,9494,3701,5327,9028,2873,4415,7288,1,1,0,0,7,7,29,30,2019
7/30/2019,4089,5753,9842,3741,5018,8759,2904,4159,7063,2,2,0,0,7,7,30,31,2019
7/31/2019,4118,4572,8690,3802,4669,8471,2951,3870,6821,3,3,0,0,7,8,31,1,2019
8/1/2019,4444,4324,8768,4126,4738,8864,3289,4138,7427,4,4,0,0,8,8,1,2,2019
8/2/2019,4214,5251,9465,4485,4730,9215,3444,4131,7575,5,5,1,1,8,8,2,3,2019
8/3/2019,4202,5191,9393,3806,4492,8298,3034,3923,6957,6,6,1,1,8,8,3,4,2019
8/4/2019,3835,5997,9832,3931,5728,9659,3134,4584,7718,7,7,1,1,8,8,4,5,2019
8/5/2019,3155,4968,8123,2688,5529,8217,2143,4410,6553,1,1,0,0,8,8,5,6,2019
8/6/2019,3454,5309,8763,2861,4488,7350,2281,3920,6201,2,2,0,0,8,8,6,7,2019
8/7/2019,3315,4539,7854,2737,4175,6912,2182,3646,5828,3,3,0,0,8,8,7,8,2019
8/8/2019,4121,4815,8936,3315,4251,7567,2643,3713,6356,4,4,0,0,8,8,8,9,2019
8/9/2019,3789,4812,8601,3339,4215,7554,2662,3681,6343,5,5,1,1,8,8,9,10,2019
8/10/2019,3703,5153,8856,3268,4490,7757,2605,3921,6526,6,6,1,1,8,8,10,11,2019
8/11/2019,3348,5934,9282,3150,5582,8732,2511,4457,6968,7,7,1,1,8,8,11,12,2019
8/12/2019,2657,5085,7742,2787,4185,6972,2222,3655,5877,1,1,0,0,8,8,12,13,2019
8/13/2019,2912,4966,7878,2942,3753,6695,2345,3278,5623,2,2,0,0,8,8,13,14,2019
8/14/2019,2860,4199,7059,2817,3284,6101,2246,2868,5114,3,3,0,0,8,8,14,15,2019
8/15/2019,3491,3877,7368,3299,3540,6839,2630,3092,5722,4,4,0,0,8,8,15,16,2019
8/16/2019,3158,4171,7329,3312,3328,6640,2640,2907,5547,5,5,1,1,8,8,16,17,2019
8/17/2019,3152,4600,7752,3175,3840,7015,2531,3354,5885,6,6,1,1,8,8,17,18,2019
8/18/2019,2913,5158,8071,3160,4588,7748,2519,4007,6526,7,7,1,1,8,8,18,19,2019
8/19/2019,2523,4334,6857,2156,3530,5686,1719,3083,4802,1,1,0,0,8,8,19,20,2019
8/20/2019,2569,3990,6559,2212,3175,5387,1763,2773,4536,2,2,0,0,8,8,20,21,2019
8/21/2019,2556,3762,6318,2227,2880,5106,1775,2515,4290,3,3,0,0,8,8,21,22,2019
8/22/2019,3295,3670,6965,2955,3141,6096,2356,2743,5099,4,4,0,0,8,8,22,23,2019
8/23/2019,3002,3724,6726,2760,2977,5737,2200,2600,4800,5,5,1,1,8,8,23,24,2019
8/24/2019,3230,3923,7153,2447,3570,6017,1951,3118,5069,6,6,1,1,8,8,24,25,2019
8/25/2019,3137,4374,7511,2530,4050,6580,2017,3537,5554,7,7,1,1,8,8,25,26,2019
8/26/2019,2589,3628,6217,2066,3154,5221,1647,2755,4402,1,1,0,0,8,8,26,27,2019
8/27/2019,2540,3135,5675,2010,2762,4771,1602,2412,4014,2,2,0,0,8,8,27,28,2019
8/28/2019,3075,2987,6062,2725,2730,5454,2172,2384,4556,3,3,0,0,8,8,28,29,2019
8/29/2019,4782,2991,7773,4362,2720,7082,3346,2376,5722,4,4,0,0,8,8,29,30,2019
8/30/2019,5172,2898,8070,4978,2795,7773,3968,2441,6409,5,5,1,1,8,8,30,31,2019
8/31/2019,3882,3417,7299,3373,2993,6366,2689,2614,5303,6,6,1,1,8,9,31,1,2019
9/1/2019,2857,3931,6788,2707,3417,6124,2162,2930,5092,7,7,1,1,9,9,1,2,2019
9/2/2019,2238,6739,8977,1911,5850,7761,1526,5017,6543,1,1,0,0,9,9,2,3,2019
9/3/2019,2044,5462,7506,2144,4493,6637,1546,3853,5399,2,2,0,0,9,9,3,4,2019
9/4/2019,2070,3298,5368,2159,3227,5385,1724,2767,4491,3,3,0,0,9,9,4,5,2019
9/5/2019,2797,3031,5828,2509,2684,5194,2004,2302,4306,4,4,0,0,9,9,5,6,2019
9/6/2019,3147,3191,6338,2981,2703,5684,2381,2318,4699,5,5,1,1,9,9,6,7,2019
9/7/2019,2770,3615,6385,2866,3086,5952,2289,2646,4935,6,6,1,1,9,9,7,8,2019
9/8/2019,2789,3838,6627,2649,3161,5811,2116,2711,4827,7,7,1,1,9,9,8,9,2019
9/9/2019,2376,3403,5779,2152,2826,4978,1719,2423,4142,1,1,0,0,9,9,9,10,2019
9/10/2019,2319,3148,5467,2324,2625,4949,1856,2251,4107,2,2,0,0,9,9,10,11,2019
9/11/2019,2766,3298,6064,2603,2723,5326,2079,2335,4414,3,3,0,0,9,9,11,12,2019
9/12/2019,3054,3977,7031,3363,3329,6692,2686,2855,5541,4,4,0,0,9,9,12,13,2019
9/13/2019,2501,4045,6546,3202,3251,6453,2557,2788,5345,5,5,1,1,9,9,13,14,2019
9/14/2019,2686,4042,6728,2659,2722,5381,2124,2334,4458,6,6,1,1,9,9,14,15,2019
9/15/2019,3090,3714,6804,3508,3363,6871,2469,2884,5353,7,7,1,1,9,9,15,16,2019
9/16/2019,3547,2296,5843,2700,3192,5891,2156,2737,4893,1,1,0,0,9,9,16,17,2019
9/17/2019,3359,2596,5955,2599,3329,5929,2076,2855,4931,2,2,0,0,9,9,17,18,2019
9/18/2019,2990,3012,6002,2477,2977,5454,1978,2553,4531,3,3,0,0,9,9,18,19,2019
9/19/2019,3759,3248,7007,3080,3185,6265,2460,2731,5191,4,4,0,0,9,9,19,20,2019
9/20/2019,3801,3231,7032,3366,3290,6655,2688,2821,5509,5,5,1,1,9,9,20,21,2019
9/21/2019,3485,3696,7181,3189,3152,6341,2547,2883,5430,6,6,1,1,9,9,21,22,2019
9/22/2019,3460,4209,7669,3173,3809,6981,2534,3266,5800,7,7,1,1,9,9,22,23,2019
9/23/2019,2619,4262,6881,2536,3276,5811,2025,2809,4834,1,1,0,0,9,9,23,24,2019
9/24/2019,2722,3018,5740,2623,2753,5376,2095,2361,4456,2,2,0,0,9,9,24,25,2019
9/25/2019,3072,2874,5946,3152,2654,5806,2517,2276,4793,3,3,0,0,9,9,25,26,2019
9/26/2019,4290,3346,7636,3629,3063,6692,2898,2627,5525,4,4,0,0,9,9,26,27,2019
9/27/2019,4166,3331,7497,3467,3186,6653,2769,2732,5501,5,5,1,1,9,9,27,28,2019
9/28/2019,3623,3602,7225,3263,3147,6410,2606,2880,5486,6,6,1,1,9,9,28,29,2019
9/29/2019,3346,4457,7803,3398,4122,7520,2714,3716,6430,7,7,1,1,9,9,29,30,2019
9/30/2019,2858,4302,7160,2742,3681,6424,2190,3157,5347,1,1,0,0,9,10,30,1,2019
10/1/2019,2754,3927,6681,2365,3323,5688,1873,2740,4613,2,2,0,0,10,10,1,2,2019
10/2/2019,2738,3100,5838,2728,2986,5714,2256,2430,4686,3,3,0,0,10,10,2,3,2019
10/3/2019,3552,3424,6976,3208,2709,5917,2653,2281,4934,4,4,0,0,10,10,3,4,2019
10/4/2019,3465,3070,6535,3468,3150,6618,2868,2652,5520,5,5,1,1,10,10,4,5,2019
10/5/2019,3184,3922,7106,2736,3488,6224,2262,2937,5199,6,6,1,1,10,10,5,6,2019
10/6/2019,3165,4798,7963,2442,4310,6752,2019,3629,5648,7,7,1,1,10,10,6,7,2019
10/7/2019,2273,4012,6285,2020,3843,5863,1670,3236,4906,1,1,0,0,10,10,7,8,2019
10/8/2019,2578,3716,6294,2089,3289,5377,1727,2769,4496,2,2,0,0,10,10,8,9,2019
10/9/2019,3000,2969,5969,2523,3230,5753,2086,2720,4806,3,3,0,0,10,10,9,10,2019
10/10/2019,4045,3306,7351,3333,3291,6624,2756,2687,5443,4,4,0,0,10,10,10,11,2019
10/11/2019,3887,3216,7103,3181,2951,6132,2630,2485,5115,5,5,1,1,10,10,11,12,2019
10/12/2019,3370,4123,7493,2520,3272,5792,2084,2755,4839,6,6,1,1,10,10,12,13,2019
10/13/2019,3026,4763,7789,2670,4184,6854,2208,3523,5731,7,7,1,1,10,10,13,14,2019
10/14/2019,2546,4537,7083,2405,3550,5955,1989,2989,4978,1,1,0,0,10,10,14,15,2019
10/15/2019,2600,3769,6369,2465,2993,5458,2038,2520,4558,2,2,0,0,10,10,15,16,2019
10/16/2019,2862,3405,6267,2551,2771,5321,2109,2333,4442,3,3,0,0,10,10,16,17,2019
10/17/2019,4218,3461,7679,3620,2884,6503,2993,2428,5421,4,4,0,0,10,10,17,18,2019
10/18/2019,3664,3094,6758,3647,2901,6549,3016,2443,5459,5,5,1,1,10,10,18,19,2019
10/19/2019,3399,3957,7356,3069,3273,6342,2538,2756,5294,6,6,1,1,10,10,19,20,2019
10/20/2019,3530,4181,7711,2915,4207,7121,2410,3542,5952,7,7,1,1,10,10,20,21,2019
10/21/2019,2620,4269,6889,2324,3507,5831,1922,2953,4875,1,1,0,0,10,10,21,22,2019
10/22/2019,2899,3589,6488,2272,2910,5182,1879,2450,4329,2,2,0,0,10,10,22,23,2019
10/23/2019,3072,2849,5921,2667,3328,5994,2205,2802,5007,3,3,0,0,10,10,23,24,2019
10/24/2019,4276,3158,7434,3756,3648,7405,3106,3072,6178,4,4,0,0,10,10,24,25,2019
10/25/2019,3985,3338,7323,3832,3426,7259,3169,2885,6054,5,5,1,1,10,10,25,26,2019
10/26/2019,3520,4189,7709,3186,4469,7655,2927,3763,6690,6,6,1,1,10,10,26,27,2019
10/27/2019,3140,4171,7311,3397,4265,7662,3101,3591,6692,7,7,1,1,10,10,27,28,2019
10/28/2019,3013,4316,7329,3199,3571,6770,2645,3007,5652,1,1,0,0,10,10,28,29,2019
10/29/2019,3062,3892,6954,3333,3815,7148,2756,3381,6137,2,2,0,0,10,10,29,30,2019
10/30/2019,3902,3556,7458,2965,4353,7318,2744,3665,6409,3,3,0,0,10,10,30,31,2019
10/31/2019,4247,3281,7528,3609,3680,7289,3359,3099,6458,4,4,0,0,10,11,31,1,2019
11/1/2019,4344,2938,7282,3336,3028,6363,3008,2730,5738,5,5,1,1,11,11,1,2,2019
11/2/2019,3880,3552,7432,3508,3276,6784,3163,2954,6117,6,6,1,1,11,11,2,3,2019
11/3/2019,3522,5190,8712,3908,3840,7749,3524,3463,6987,7,7,1,1,11,11,3,4,2019
11/4/2019,2962,5045,8007,2918,4033,6951,2631,3637,6268,1,1,0,0,11,11,4,5,2019
11/5/2019,2766,4245,7011,2572,3936,6508,2319,3549,5868,2,2,0,0,11,11,5,6,2019
11/6/2019,2753,3404,6157,2617,3188,5806,2360,2875,5235,3,3,0,0,11,11,6,7,2019
11/7/2019,4809,3195,8004,3724,2940,6664,3358,2651,6009,4,4,0,0,11,11,7,8,2019
11/8/2019,4408,3338,7746,3779,3008,6787,3408,2712,6120,5,5,1,1,11,11,8,9,2019
11/9/2019,3870,4625,8495,2893,3461,6355,2609,3121,5730,6,6,1,1,11,11,9,10,2019
11/10/2019,3167,4476,7643,2658,5310,7969,2397,3567,5964,7,7,1,1,11,11,10,11,2019
11/11/2019,2639,5534,8173,2365,4413,6778,2133,3979,6112,1,1,0,0,11,11,11,12,2019
11/12/2019,2417,3265,5682,2628,3484,6113,2370,3142,5512,2,2,0,0,11,11,12,13,2019
11/13/2019,2535,4086,6621,3238,3418,6656,2920,3082,6002,3,3,0,0,11,11,13,14,2019
11/14/2019,3256,5073,8329,4184,3605,7790,3773,3251,7024,4,4,0,0,11,11,14,15,2019
11/15/2019,3125,5412,8537,4906,4817,9724,4424,4344,8768,5,5,1,1,11,11,15,16,2019
11/16/2019,3117,4869,7986,5620,5137,10757,5068,4632,9700,6,6,1,1,11,11,16,17,2019
11/17/2019,3608,4804,8412,4944,4483,9427,4458,4042,8500,7,7,1,1,11,11,17,18,2019
11/18/2019,4923,3101,8024,5402,3498,8900,4871,3154,8025,1,1,0,0,11,11,18,19,2019
11/19/2019,4266,3347,7613,3202,5464,8666,4476,3756,8232,2,2,0,0,11,11,19,20,2019
11/20/2019,3679,3153,6832,2940,4326,7266,5061,4772,9833,3,3,0,0,11,11,20,21,2019
11/21/2019,5573,3299,8872,3670,3431,7101,3890,5341,9231,4,4,0,0,11,11,21,22,2019
11/22/2019,6310,3588,9898,4144,3567,7711,3313,5247,8560,5,5,1,1,11,11,22,23,2019
11/23/2019,6935,4498,11433,3725,3437,7162,3337,6578,9915,6,6,1,1,11,11,23,24,2019
11/24/2019,4782,4258,9040,4823,5709,10532,4349,7591,11940,7,7,1,1,11,11,24,25,2019
11/25/2019,4214,4183,8397,3839,7029,10868,3462,6338,9800,1,1,0,0,11,11,25,26,2019
11/26/2019,4377,4699,9076,4964,4165,9129,2887,4927,7814,2,2,0,0,11,11,26,27,2019
11/27/2019,5270,5326,10596,5613,5969,11582,2651,3901,6552,3,3,0,0,11,11,27,28,2019
11/28/2019,4926,5387,10313,4314,6600,10914,3309,3094,6403,4,4,0,0,11,11,28,29,2019
11/29/2019,3918,5571,9489,3674,5819,9493,3737,3216,6953,5,5,1,1,11,11,29,30,2019
11/30/2019,4202,7565,11767,3701,7295,10996,3659,3961,7620,6,6,1,1,11,12,30,1,2019
12/1/2019,4930,8050,12980,4823,8018,12841,3685,3942,7627,7,7,1,1,12,12,1,2,2019
12/2/2019,4252,7328,11580,3746,7029,10775,2986,3495,6481,1,1,0,0,12,12,2,3,2019
12/3/2019,3568,5163,8731,3306,2587,5893,2993,2551,5544,2,2,0,0,12,12,3,4,2019
12/4/2019,3663,3864,7527,3585,2401,5986,3228,2383,5611,3,3,0,0,12,12,4,5,2019
12/5/2019,4559,3222,7781,4160,2371,6531,3847,2446,6293,4,4,0,0,12,12,5,6,2019
12/6/2019,4564,3329,7893,4523,2739,7262,4174,2778,6952,5,5,1,1,12,12,6,7,2019
12/7/2019,4263,3811,8074,4332,3187,7519,4002,3182,7184,6,6,1,1,12,12,7,8,2019
12/8/2019,4447,4185,8632,4049,3883,7932,3744,3809,7553,7,7,1,1,12,12,8,9,2019
12/9/2019,3864,3928,7792,3504,3446,6949,3255,3415,6670,1,1,0,0,12,12,9,10,2019
12/10/2019,3773,3164,6937,3731,2711,6443,3460,2753,6213,2,2,0,0,12,12,10,11,2019
12/11/2019,3778,2807,6585,3823,2265,6088,3443,2260,5703,3,3,0,0,12,12,11,12,2019
12/12/2019,4431,2902,7333,4655,2972,7627,4293,2988,7281,4,4,0,0,12,12,12,13,2019
12/13/2019,5131,2938,8069,5670,4060,9730,5208,3969,9177,5,5,1,1,12,12,13,14,2019
12/14/2019,4979,4815,9794,5644,5183,10827,5185,4936,10121,6,6,1,1,12,12,14,15,2019
12/15/2019,4801,5223,10024,5215,5292,10507,4798,5080,9878,7,7,1,1,12,12,15,16,2019
12/16/2019,4695,4586,9281,4794,4998,9792,4418,4815,9233,1,1,0,0,12,12,16,17,2019
12/17/2019,4715,3958,8673,5677,4754,10432,5115,4595,9710,2,2,0,0,12,12,17,18,2019
12/18/2019,5649,4494,10143,5559,5099,10658,5108,4906,10014,3,3,0,0,12,12,18,19,2019
12/19/2019,6421,5063,11484,6708,4113,10821,6144,3972,10116,4,4,0,0,12,12,19,20,2019
12/20/2019,7372,5727,13099,8188,5645,13833,7479,5398,12877,5,5,1,1,12,12,20,21,2019
12/21/2019,7864,7098,14962,7829,7024,14853,7155,6642,13797,6,6,1,1,12,12,21,22,2019
12/22/2019,6538,6595,13133,7099,7824,14923,6497,7363,13860,7,7,1,1,12,12,22,23,2019
12/23/2019,5918,5993,11911,5224,4934,10158,4806,4757,9563,1,1,0,0,12,12,23,24,2019
12/24/2019,4892,5058,9950,6404,6322,12726,5870,6009,11879,2,2,0,0,12,12,24,25,2019
12/25/2019,6219,6193,12412,6446,7214,13660,5908,6813,12721,3,3,0,0,12,12,25,26,2019
12/26/2019,7339,7396,14735,6479,6875,13354,5938,6507,12445,4,4,0,0,12,12,26,27,2019
12/27/2019,6977,8161,15138,6340,6937,13276,5812,6563,12375,5,5,1,1,12,12,27,28,2019
12/28/2019,6474,8650,15124,5878,7177,13056,5396,6780,12176,6,6,1,1,12,12,28,29,2019
12/29/2019,5918,7680,13598,5498,6810,12308,5053,6449,11502,7,7,1,1,12,12,29,30,2019
12/30/2019,5567,7809,13376,4043,7205,11248,3641,6805,10446,1,1,0,0,12,12,30,31,2019
12/31/2019,4597,7084,11681,5314,6759,12072,4791,6094,10885,2,2,0,0,12,1,31,1,2019
1/1/2020,5367,6555,11922,7196,7064,14260,5678,6445,12123,3,3,0,0,1,1,1,2,2020
1/2/2020,6555,6979,13534,7551,7116,14667,5962,6492,12454,4,4,0,0,1,1,2,3,2020
1/3/2020,6969,8166,15135,7754,9157,16911,6124,8369,14493,5,5,1,1,1,1,3,4,2020
1/4/2020,7427,9666,17093,7849,9479,17328,6200,8665,14865,6,6,1,1,1,1,4,5,2020
1/5/2020,6272,8250,14522,6301,9532,15832,4963,8714,13677,7,7,1,1,1,1,5,6,2020
1/6/2020,5131,8757,13888,4976,8751,13727,3905,7996,11901,1,1,0,0,1,1,6,7,2020
1/7/2020,4557,6872,11429,3980,7311,11292,3110,6672,9782,2,2,0,0,1,1,7,8,2020
1/8/2020,3665,5851,9516,3387,5843,9230,2636,5322,7958,3,3,0,0,1,1,8,9,2020
1/9/2020,4216,4805,9021,4064,5257,9321,3177,4783,7960,4,4,0,0,1,1,9,10,2020
1/10/2020,4080,5747,9827,4078,5526,9604,3188,5030,8218,5,5,1,1,1,1,10,11,2020
1/11/2020,3563,6677,10240,3751,6326,10077,2927,5766,8693,6,6,1,1,1,1,11,12,2020
1/12/2020,3413,6697,10110,3810,6286,10096,2974,5729,8703,7,7,1,1,1,1,12,13,2020
1/13/2020,2366,5986,8352,2504,4855,7359,1931,4413,6344,1,1,0,0,1,1,13,14,2020
1/14/2020,2508,5168,7676,2661,4632,7292,2056,4208,6264,2,2,0,0,1,1,14,15,2020
1/15/2020,3035,4693,7728,2815,3925,6740,2179,3558,5737,3,3,0,0,1,1,15,16,2020
1/16/2020,4615,4032,8647,4245,4010,8254,3321,3636,6957,4,4,0,0,1,1,16,17,2020
1/17/2020,4897,4672,9569,4917,3989,8906,3858,3617,7475,5,5,1,1,1,1,17,18,2020
1/18/2020,3789,4954,8743,3814,4724,8538,2977,4293,7270,6,6,1,1,1,1,18,19,2020
1/19/2020,3259,5408,8667,3140,5051,8191,2439,4593,7032,7,7,1,1,1,1,19,20,2020
1/20/2020,2369,6168,8537,2279,5285,7564,1751,4809,6560,1,1,0,0,1,1,20,21,2020
1/21/2020,2447,5053,7500,2395,4387,6782,1844,3983,5827,2,2,0,0,1,1,21,22,2020
1/22/2020,2813,3873,6686,2683,3589,6272,2074,3249,5323,3,3,0,0,1,1,22,23,2020
1/23/2020,3841,3888,7729,3791,3746,7537,2959,3393,6352,4,4,0,0,1,1,23,24,2020
1/24/2020,3730,3093,6823,4198,3550,7748,3284,3213,6497,5,5,1,1,1,1,24,25,2020
1/25/2020,3430,3681,7111,3181,4286,7468,2472,3890,6362,6,6,1,1,1,1,25,26,2020
1/26/2020,3280,4848,8128,3158,4670,7828,2453,4243,6696,7,7,1,1,1,1,26,27,2020
1/27/2020,2381,5216,7597,2341,4357,6698,1801,3955,5756,1,1,0,0,1,1,27,28,2020
1/28/2020,2495,4047,6542,2291,3444,5736,1761,3116,4877,2,2,0,0,1,1,28,29,2020
1/29/2020,2852,3931,6783,2935,3380,6315,2275,3057,5332,3,3,0,0,1,1,29,30,2020
1/30/2020,3881,5290,9171,3934,4431,8365,3073,4023,7096,4,4,0,0,1,1,30,31,2020
1/31/2020,3526,5455,8981,3413,4948,8361,2657,4499,7156,5,5,1,1,1,2,31,1,2020
2/1/2020,2886,5014,7900,2744,4832,7576,2273,3873,6146,6,6,1,1,2,2,1,2,2020
2/2/2020,2769,4907,7676,2599,5185,7785,2161,4151,6312,7,7,1,1,2,2,2,3,2020
2/3/2020,4600,3767,8367,4525,3917,8442,3650,3152,6802,1,1,0,0,2,2,3,4,2020
2/4/2020,3740,3593,7333,3622,3412,7034,2952,2754,5706,2,2,0,0,2,2,4,5,2020
2/5/2020,3075,3264,6339,2765,3429,6193,2289,2767,5056,3,3,0,0,2,2,5,6,2020
2/6/2020,4017,3420,7437,3400,3086,6486,2780,2497,5277,4,4,0,0,2,2,6,7,2020
2/7/2020,3959,3694,7653,3662,3700,7363,2983,2981,5964,5,5,1,1,2,2,7,8,2020
2/8/2020,3683,4555,8238,3151,4090,7241,2588,3288,5876,6,6,1,1,2,2,8,9,2020
2/9/2020,3488,4765,8253,3151,4342,7494,2588,3487,6075,7,7,1,1,2,2,9,10,2020
2/10/2020,2420,4362,6782,2070,4299,6370,1752,3453,5205,1,1,0,0,2,2,10,11,2020
2/11/2020,2686,3371,6057,2394,3387,5780,2002,2734,4736,2,2,0,0,2,2,11,12,2020
2/12/2020,3721,3152,6873,3237,2804,6041,2654,2275,4929,3,3,0,0,2,2,12,13,2020
2/13/2020,5782,3364,9146,5328,3000,8328,4271,2429,6700,4,4,0,0,2,2,13,14,2020
2/14/2020,5958,3234,9192,5602,3750,9352,4483,3020,7503,5,5,1,1,2,2,14,15,2020
2/15/2020,5344,4589,9933,4010,4228,8238,3252,3397,6649,6,6,1,1,2,2,15,16,2020
2/16/2020,3946,4590,8536,3587,4874,8462,2925,3906,6831,7,7,1,1,2,2,16,17,2020
2/17/2020,2937,5427,8364,2386,7508,9894,1996,5981,7977,1,1,0,0,2,2,17,18,2020
2/18/2020,2856,6234,9090,2306,5286,7591,1934,4230,6164,2,2,0,0,2,2,18,19,2020
2/19/2020,3630,4232,7862,2608,3781,6390,2168,3045,5213,3,3,0,0,2,2,19,20,2020
2/20/2020,4850,3744,8594,4101,3868,7968,3322,3113,6435,4,4,0,0,2,2,20,21,2020
2/21/2020,4668,3795,8463,4187,4170,8357,3389,3351,6740,5,5,1,1,2,2,21,22,2020
2/22/2020,3748,5530,9278,3066,4959,8025,2522,3973,6495,6,6,1,1,2,2,22,23,2020
2/23/2020,3178,5210,8388,3349,5775,9125,2741,4616,7357,7,7,1,1,2,2,23,24,2020
2/24/2020,2233,5141,7374,2634,4445,7079,2188,3568,5756,1,1,0,0,2,2,24,25,2020
2/25/2020,2501,3840,6341,2736,3745,6481,2267,3016,5283,2,2,0,0,2,2,25,26,2020
2/26/2020,2740,4057,6797,3115,3327,6442,2560,2687,5247,3,3,0,0,2,2,26,27,2020
2/27/2020,4131,3832,7963,4702,3809,8511,3787,3067,6854,4,4,0,0,2,2,27,28,2020
2/28/2020,3917,3820,7737,4778,3759,8537,3846,3027,6873,5,5,1,1,2,3,28,1,2020
2/29/2020,3414,4496,7910,3935,4207,8142,3194,3380,6574,6,6,1,1,2,3,29,2,2020
3/1/2020,3149,5289,8438,3511,4443,7954,2936,3940,6876,7,7,1,1,3,3,1,3,2020
3/2/2020,2174,4688,6862,2476,3940,6416,2051,3503,5554,1,1,0,0,3,3,2,4,2020
3/3/2020,2156,3541,5697,2611,3791,6403,2167,3374,5541,2,2,0,0,3,3,3,5,2020
3/4/2020,2581,3298,5879,2747,3434,6181,2283,3064,5347,3,3,0,0,3,3,4,6,2020
3/5/2020,3963,3026,6989,3693,3758,7451,3092,3345,6437,4,4,0,0,3,3,5,7,2020
3/6/2020,3800,3030,6830,4115,3834,7949,3453,3411,6864,5,5,1,1,3,3,6,8,2020
3/7/2020,2983,4127,7110,3283,4471,7754,2741,3964,6705,6,6,1,1,3,3,7,9,2020
3/8/2020,2913,4288,7201,3237,4537,7774,2702,4021,6723,7,7,1,1,3,3,8,10,2020
3/9/2020,2522,4318,6840,2818,4620,7438,2344,4093,6437,1,1,0,0,3,3,9,11,2020
3/10/2020,2364,3431,5795,2743,3752,6496,2280,3340,5620,2,2,0,0,3,3,10,12,2020
3/11/2020,2955,3510,6465,3205,3163,6368,2675,2828,5503,3,3,0,0,3,3,11,13,2020
3/12/2020,3829,3436,7265,4197,4276,8474,3523,3795,7318,4,4,0,0,3,3,12,14,2020
3/13/2020,3702,3636,7338,4522,4595,9118,3801,4072,7873,5,5,1,1,3,3,13,15,2020
3/14/2020,3447,3520,6967,4630,5221,9851,3893,4615,8508,6,6,1,1,3,3,14,16,2020
3/15/2020,3463,4088,7551,3948,5092,9040,3310,4503,7813,7,7,1,1,3,3,15,17,2020
3/16/2020,3209,3045,6254,4994,3696,8690,4204,3291,7495,1,1,0,0,3,3,16,18,2020
3/17/2020,3022,2412,5434,3908,3274,7183,3276,2925,6201,2,2,0,0,3,3,17,19,2020
3/18/2020,2302,2447,4749,3521,3286,6807,2945,2935,5880,3,3,0,0,3,3,18,20,2020
3/19/2020,1905,1898,3803,4527,3788,8315,3805,3371,7176,4,4,0,0,3,3,19,21,2020
3/20/2020,2045,2735,4780,5514,4059,9573,4649,3606,8255,5,5,1,1,3,3,20,22,2020
3/21/2020,1197,3448,4645,5576,4982,10559,4702,4408,9110,6,6,1,1,3,3,21,23,2020
3/22/2020,1061,2937,3998,4448,5463,9910,3737,4825,8562,7,7,1,1,3,3,22,24,2020
3/23/2020,607,1617,2224,3362,4541,7903,2809,4025,6834,1,1,0,0,3,3,23,25,2020
3/24/2020,582,1266,1848,2973,4284,7257,2476,3802,6278,2,2,0,0,3,3,24,26,2020
3/25/2020,443,815,1258,3318,3888,7206,2771,3458,6229,3,3,0,0,3,3,25,27,2020
3/26/2020,447,797,1244,4465,4366,8831,3752,3873,7625,4,4,0,0,3,3,26,28,2020
3/27/2020,562,701,1263,5147,4718,9864,4335,4178,8513,5,5,1,1,3,3,27,29,2020
3/28/2020,643,1157,1800,4886,6397,11283,4112,5636,9748,6,6,1,1,3,3,28,30,2020
3/29/2020,572,961,1533,4263,6029,10292,3579,5317,8896,7,7,1,1,3,3,29,31,2020
3/30/2020,388,740,1128,3203,5572,8775,2673,4920,7593,1,1,0,0,3,4,30,1,2020
3/31/2020,428,639,1067,2802,4551,7352,2330,4033,6363,2,2,0,0,3,4,31,2,2020
4/1/2020,433,560,993,265,273,538,2477,3493,5970,3,3,0,0,4,4,1,3,2020
4/2/2020,471,421,892,388,351,739,3421,3760,7181,4,4,0,0,4,4,2,4,2020
4/3/2020,434,555,989,377,443,820,3508,3845,7353,5,5,1,1,4,4,3,5,2020
4/4/2020,561,466,1027,334,544,878,3070,4678,7748,6,6,1,1,4,4,4,6,2020
4/5/2020,480,601,1081,257,459,716,2887,5287,8174,7,7,1,1,4,4,5,7,2020
4/6/2020,382,412,794,245,416,661,2128,4511,6639,1,1,0,0,4,4,6,8,2020
4/7/2020,302,244,546,255,392,647,2082,3864,5946,2,2,0,0,4,4,7,9,2020
4/8/2020,316,319,635,304,387,692,2511,3550,6061,3,3,0,0,4,4,8,10,2020
4/9/2020,287,327,614,407,369,776,3676,4559,8235,4,4,0,0,4,4,9,11,2020
4/10/2020,359,290,649,483,296,780,3572,5762,9334,5,5,1,1,4,4,10,12,2020
4/11/2020,288,330,618,509,297,805,3161,7079,10240,6,6,1,1,4,4,11,13,2020
4/12/2020,279,510,789,519,313,832,2433,5966,8399,7,7,1,1,4,4,12,14,2020
4/13/2020,244,281,525,456,322,778,2321,5415,7736,1,1,0,0,4,4,13,15,2020
4/14/2020,228,271,499,404,321,725,2417,5101,7518,2,2,0,0,4,4,14,16,2020
4/15/2020,269,293,562,410,282,691,2883,5037,7920,3,3,0,0,4,4,15,17,2020
4/16/2020,373,248,621,495,268,763,3855,4805,8660,4,4,0,0,4,4,16,18,2020
4/17/2020,327,416,743,524,237,761,4577,3855,8432,5,5,1,1,4,4,17,19,2020
4/18/2020,253,367,620,483,296,780,4820,3859,8679,6,6,1,1,4,4,18,20,2020
4/19/2020,443,472,915,450,355,805,4917,4067,8984,7,7,1,1,4,4,19,21,2020
4/20/2020,226,302,528,282,378,661,4317,4186,8503,1,1,0,0,4,4,20,22,2020
4/21/2020,238,225,463,246,310,556,3829,4174,8003,2,2,0,0,4,4,21,23,2020
4/22/2020,184,218,402,261,269,530,3882,3662,7544,3,3,0,0,4,4,22,24,2020
4/23/2020,418,287,705,361,289,650,4693,3482,8175,4,4,0,0,4,4,23,25,2020
4/24/2020,366,459,825,370,296,666,4966,3082,8048,5,5,1,1,4,4,24,26,2020
4/25/2020,230,280,510,324,360,684,4578,3853,8431,6,6,1,1,4,4,25,27,2020
4/26/2020,466,434,900,305,407,711,4264,4622,8886,7,7,1,1,4,4,26,28,2020
4/27/2020,269,409,678,225,347,572,2966,4564,7530,1,1,0,0,4,4,27,29,2020
4/28/2020,231,188,419,220,297,517,2805,3679,6484,2,2,0,0,4,4,28,30,2020
4/29/2020,339,346,685,351,276,627,3322,3588,6910,3,3,0,0,4,5,29,1,2020
4/30/2020,413,638,1051,473,253,726,4481,3287,7768,4,4,0,0,4,5,30,2,2020
5/1/2020,420,422,842,415,367,782,3990,3664,7654,5,5,1,1,5,5,1,3,2020
5/2/2020,383,397,780,357,388,745,3429,3874,7303,6,6,1,1,5,5,2,4,2020
5/3/2020,446,583,1029,356,442,798,3418,4420,7838,7,7,1,1,5,5,3,5,2020
5/4/2020,392,520,912,314,443,756,3013,4423,7436,1,1,0,0,5,5,4,6,2020
5/5/2020,410,403,813,327,374,701,3138,3739,6877,2,2,0,0,5,5,5,7,2020
5/6/2020,408,374,782,380,297,677,3648,2965,6613,3,3,0,0,5,5,6,8,2020
5/7/2020,569,457,1026,492,322,815,4727,3222,7949,4,4,0,0,5,5,7,9,2020
5/8/2020,641,493,1134,379,366,746,3644,3661,7305,5,5,1,1,5,5,8,10,2020
5/9/2020,539,477,1016,291,447,738,2798,4464,7262,6,6,1,1,5,5,9,11,2020
5/10/2020,549,529,1078,317,508,824,3040,5077,8117,7,7,1,1,5,5,10,12,2020
5/11/2020,478,548,1026,255,434,690,2451,4338,6789,1,1,0,0,5,5,11,13,2020
5/12/2020,394,539,933,236,436,672,2267,4354,6621,2,2,0,0,5,5,12,14,2020
5/13/2020,358,374,732,277,364,640,2656,3633,6289,3,3,0,0,5,5,13,15,2020
5/14/2020,555,535,1090,394,377,771,3788,3766,7554,4,4,0,0,5,5,14,16,2020
5/15/2020,607,564,1171,344,395,739,3301,3950,7251,5,5,1,1,5,5,15,17,2020
5/16/2020,599,654,1253,302,438,740,2904,4375,7279,6,6,1,1,5,5,16,18,2020
5/17/2020,680,830,1510,333,469,802,3198,4691,7889,7,7,1,1,5,5,17,19,2020
5/18/2020,465,600,1065,246,420,666,2359,4200,6559,1,1,0,0,5,5,18,20,2020
5/19/2020,484,526,1010,296,380,676,2841,3799,6640,2,2,0,0,5,5,19,21,2020
5/20/2020,493,402,895,358,347,705,3440,3464,6904,3,3,0,0,5,5,20,22,2020
5/21/2020,719,509,1228,568,354,922,5452,3536,8988,4,4,0,0,5,5,21,23,2020
5/22/2020,932,595,1527,588,342,930,5644,3421,9065,5,5,1,1,5,5,22,24,2020
5/23/2020,788,685,1473,506,376,882,4859,3761,8620,6,6,1,1,5,5,23,25,2020
5/24/2020,901,876,1777,373,400,773,3582,3999,7581,7,7,1,1,5,5,24,26,2020
5/25/2020,0,0,0,314,695,1009,3016,6948,9964,1,1,0,0,5,5,25,27,2020
5/26/2020,0,0,0,286,533,818,2742,5322,8064,2,2,0,0,5,5,26,28,2020
5/27/2020,0,0,0,285,388,673,2731,3878,6609,3,3,0,0,5,5,27,29,2020
5/28/2020,0,0,0,372,371,743,3569,3706,7275,4,4,0,0,5,5,28,30,2020
5/29/2020,0,0,0,384,426,810,3689,4253,7942,5,5,1,1,5,5,29,31,2020
5/30/2020,0,0,0,326,432,757,3128,4313,7441,6,6,1,1,5,6,30,1,2020
5/31/2020,0,0,0,373,436,809,3586,4358,7944,7,7,1,1,5,6,31,2,2020
6/1/2020,0,0,0,414,454,869,3487,3885,7372,1,1,0,0,6,6,1,3,2020
6/2/2020,0,0,0,395,399,794,3324,3414,6738,2,2,0,0,6,6,2,4,2020
6/3/2020,0,0,0,409,376,784,3438,3214,6652,3,3,0,0,6,6,3,5,2020
6/4/2020,0,0,0,524,349,873,4412,2983,7395,4,4,0,0,6,6,4,6,2020
6/5/2020,0,0,0,512,351,863,4306,3004,7310,5,5,1,1,6,6,5,7,2020
6/6/2020,0,0,0,530,467,997,4463,3991,8454,6,6,1,1,6,6,6,8,2020
6/7/2020,0,0,0,465,482,947,3913,4125,8038,7,7,1,1,6,6,7,9,2020
6/8/2020,0,0,0,437,462,899,3679,3953,7632,1,1,0,0,6,6,8,10,2020
6/9/2020,0,0,0,492,393,885,4142,3360,7502,2,2,0,0,6,6,9,11,2020
6/10/2020,0,0,0,449,373,823,3778,3193,6971,3,3,0,0,6,6,10,12,2020
6/11/2020,0,0,0,587,390,977,4937,3338,8275,4,4,0,0,6,6,11,13,2020
6/12/2020,0,0,0,559,405,964,4710,3463,8173,5,5,1,1,6,6,12,14,2020
6/13/2020,0,0,0,614,555,1169,5159,4749,9908,6,6,1,1,6,6,13,15,2020
6/14/2020,0,0,0,552,524,1075,4643,4478,9121,7,7,1,1,6,6,14,16,2020
6/15/2020,0,0,0,534,531,1066,4496,4544,9040,1,1,0,0,6,6,15,17,2020
6/16/2020,0,0,0,523,521,1044,4402,4455,8857,2,2,0,0,6,6,16,18,2020
6/17/2020,0,0,0,491,406,897,4131,3469,7600,3,3,0,0,6,6,17,19,2020
6/18/2020,0,0,0,658,506,1164,5533,4331,9864,4,4,0,0,6,6,18,20,2020
6/19/2020,0,0,0,562,529,1091,4729,4524,9253,5,5,1,1,6,6,19,21,2020
6/20/2020,0,0,0,541,625,1166,4556,5343,9899,6,6,1,1,6,6,20,22,2020
6/21/2020,0,0,0,501,632,1133,4216,5406,9622,7,7,1,1,6,6,21,23,2020
6/22/2020,0,0,0,438,613,1051,3685,5245,8930,1,1,0,0,6,6,22,24,2020
6/23/2020,0,0,0,485,593,1078,4084,5069,9153,2,2,0,0,6,6,23,25,2020
6/24/2020,0,0,0,472,514,986,3969,4399,8368,3,3,0,0,6,6,24,26,2020
6/25/2020,0,0,0,606,569,1175,5095,4866,9961,4,4,0,0,6,6,25,27,2020
6/26/2020,0,0,0,536,587,1122,4507,5016,9523,5,5,1,1,6,6,26,28,2020
6/27/2020,0,0,0,555,708,1264,4671,6058,10729,6,6,1,1,6,6,27,29,2020
6/28/2020,0,0,0,485,720,1205,4082,6158,10240,7,7,1,1,6,6,28,30,2020
6/29/2020,0,0,0,403,654,1056,3389,5589,8978,1,1,0,0,6,7,29,1,2020
6/30/2020,0,0,0,504,613,1117,4241,5242,9483,2,2,0,0,6,7,30,2,2020
7/1/2020,0,0,0,699,722,1421,4918,5001,9919,3,3,0,0,7,7,1,3,2020
7/2/2020,0,0,0,779,650,1429,5483,4503,9986,4,4,0,0,7,7,2,4,2020
7/3/2020,0,0,0,508,759,1266,3572,5255,8827,5,5,1,1,7,7,3,5,2020
7/4/2020,0,0,0,518,858,1376,3647,5943,9590,6,6,1,1,7,7,4,6,2020
7/5/2020,0,0,0,486,1062,1548,3420,7359,10779,7,7,1,1,7,7,5,7,2020
7/6/2020,0,0,0,429,903,1332,3018,6255,9273,1,1,0,0,7,7,6,8,2020
7/7/2020,0,0,0,459,799,1259,3233,5537,8770,2,2,0,0,7,7,7,9,2020
7/8/2020,0,0,0,450,656,1106,3165,4543,7708,3,3,0,0,7,7,8,10,2020
7/9/2020,0,0,0,587,690,1277,4129,4778,8907,4,4,0,0,7,7,9,11,2020
7/10/2020,0,0,0,566,741,1308,3985,5135,9120,5,5,1,1,7,7,10,12,2020
7/11/2020,0,0,0,543,824,1368,3822,5710,9532,6,6,1,1,7,7,11,13,2020
7/12/2020,0,0,0,494,824,1319,3478,5709,9187,7,7,1,1,7,7,12,14,2020
7/13/2020,0,0,0,429,753,1182,3021,5213,8234,1,1,0,0,7,7,13,15,2020
7/14/2020,0,0,0,490,763,1253,3450,5283,8733,2,2,0,0,7,7,14,16,2020
7/15/2020,0,0,0,526,702,1228,3705,4860,8565,3,3,0,0,7,7,15,17,2020
7/16/2020,0,0,0,691,727,1419,4864,5037,9901,4,4,0,0,7,7,16,18,2020
7/17/2020,0,0,0,629,708,1337,4426,4906,9332,5,5,1,1,7,7,17,19,2020
7/18/2020,0,0,0,613,823,1436,4311,5702,10013,6,6,1,1,7,7,18,20,2020
7/19/2020,0,0,0,603,807,1410,4246,5588,9834,7,7,1,1,7,7,19,21,2020
7/20/2020,0,0,0,546,789,1335,3840,5467,9307,1,1,0,0,7,7,20,22,2020
7/21/2020,0,0,0,574,702,1276,4036,4863,8899,2,2,0,0,7,7,21,23,2020
7/22/2020,0,0,0,575,637,1212,4045,4413,8458,3,3,0,0,7,7,22,24,2020
7/23/2020,0,0,0,714,683,1397,5027,4729,9756,4,4,0,0,7,7,23,25,2020
7/24/2020,0,0,0,677,675,1352,4761,4675,9436,5,5,1,1,7,7,24,26,2020
7/25/2020,0,0,0,643,801,1445,4527,5550,10077,6,6,1,1,7,7,25,27,2020
7/26/2020,0,0,0,611,868,1479,4299,6013,10312,7,7,1,1,7,7,26,28,2020
7/27/2020,0,0,0,553,809,1362,3894,5600,9494,1,1,0,0,7,7,27,29,2020
7/28/2020,0,0,0,581,831,1412,4089,5753,9842,2,2,0,0,7,7,28,30,2020
7/29/2020,0,0,0,585,660,1245,4118,4572,8690,3,3,0,0,7,7,29,31,2020
7/30/2020,0,0,0,632,624,1256,4444,4324,8768,4,4,0,0,7,8,30,1,2020
7/31/2020,0,0,0,599,758,1357,4214,5251,9465,5,5,1,1,7,8,31,2,2020
8/1/2020,0,0,0,590,709,1299,4202,5191,9393,6,6,1,1,8,8,1,3,2020
8/2/2020,0,0,0,538,819,1358,3835,5997,9832,7,7,1,1,8,8,2,4,2020
8/3/2020,0,0,0,443,679,1122,3155,4968,8123,1,1,0,0,8,8,3,5,2020
8/4/2020,0,0,0,485,725,1210,3454,5309,8763,2,2,0,0,8,8,4,6,2020
8/5/2020,0,0,0,465,620,1085,3315,4539,7854,3,3,0,0,8,8,5,7,2020
8/6/2020,0,0,0,579,658,1236,4121,4815,8936,4,4,0,0,8,8,6,8,2020
8/7/2020,0,0,0,532,657,1189,3789,4812,8601,5,5,1,1,8,8,7,9,2020
8/8/2020,0,0,0,520,704,1224,3703,5153,8856,6,6,1,1,8,8,8,10,2020
8/9/2020,0,0,0,470,811,1281,3348,5934,9282,7,7,1,1,8,8,9,11,2020
8/10/2020,0,0,0,373,695,1068,2657,5085,7742,1,1,0,0,8,8,10,12,2020
8/11/2020,0,0,0,409,678,1087,2912,4966,7878,2,2,0,0,8,8,11,13,2020
8/12/2020,0,0,0,402,574,975,2860,4199,7059,3,3,0,0,8,8,12,14,2020
8/13/2020,0,0,0,490,530,1020,3491,3877,7368,4,4,0,0,8,8,13,15,2020
8/14/2020,0,0,0,443,570,1013,3158,4171,7329,5,5,1,1,8,8,14,16,2020
8/15/2020,0,0,0,443,628,1071,3152,4600,7752,6,6,1,1,8,8,15,17,2020
8/16/2020,0,0,0,409,705,1114,2913,5158,8071,7,7,1,1,8,8,16,18,2020
8/17/2020,0,0,0,354,592,946,2523,4334,6857,1,1,0,0,8,8,17,19,2020
8/18/2020,0,0,0,361,545,906,2569,3990,6559,2,2,0,0,8,8,18,20,2020
8/19/2020,0,0,0,359,514,873,2556,3762,6318,3,3,0,0,8,8,19,21,2020
8/20/2020,0,0,0,463,501,964,3295,3670,6965,4,4,0,0,8,8,20,22,2020
8/21/2020,0,0,0,421,509,930,3002,3724,6726,5,5,1,1,8,8,21,23,2020
8/22/2020,0,0,0,453,536,989,3230,3923,7153,6,6,1,1,8,8,22,24,2020
8/23/2020,0,0,0,440,597,1038,3137,4374,7511,7,7,1,1,8,8,23,25,2020
8/24/2020,0,0,0,363,496,859,2589,3628,6217,1,1,0,0,8,8,24,26,2020
8/25/2020,0,0,0,357,428,785,2540,3135,5675,2,2,0,0,8,8,25,27,2020
8/26/2020,0,0,0,432,408,840,3075,2987,6062,3,3,0,0,8,8,26,28,2020
8/27/2020,0,0,0,671,409,1080,4782,2991,7773,4,4,0,0,8,8,27,29,2020
8/28/2020,0,0,0,726,396,1122,5172,2898,8070,5,5,1,1,8,8,28,30,2020
8/29/2020,0,0,0,545,467,1012,3882,3417,7299,6,6,1,1,8,8,29,31,2020
8/30/2020,0,0,0,401,537,938,2857,3931,6788,7,7,1,1,8,9,30,1,2020
8/31/2020,0,0,0,314,921,1235,2238,6739,8977,1,1,0,0,8,9,31,2,2020
9/1/2020,0,0,0,249,679,928,2044,5462,7506,2,2,0,0,9,9,1,3,2020
9/2/2020,0,0,0,252,410,662,2070,3298,5368,3,3,0,0,9,9,2,4,2020
9/3/2020,0,0,0,340,377,717,2797,3031,5828,4,4,0,0,9,9,3,5,2020
9/4/2020,0,0,0,383,397,780,3147,3191,6338,5,5,1,1,9,9,4,6,2020
9/5/2020,0,0,0,337,449,786,2770,3615,6385,6,6,1,1,9,9,5,7,2020
9/6/2020,0,0,0,339,477,816,2789,3838,6627,7,7,1,1,9,9,6,8,2020
9/7/2020,0,0,0,289,423,712,2376,3403,5779,1,1,0,0,9,9,7,9,2020
9/8/2020,0,0,0,282,391,673,2319,3148,5467,2,2,0,0,9,9,8,10,2020
9/9/2020,0,0,0,337,410,746,2766,3298,6064,3,3,0,0,9,9,9,11,2020
9/10/2020,0,0,0,372,494,866,3054,3977,7031,4,4,0,0,9,9,10,12,2020
9/11/2020,0,0,0,304,503,807,2501,4045,6546,5,5,1,1,9,9,11,13,2020
9/12/2020,0,0,0,327,502,829,2686,4042,6728,6,6,1,1,9,9,12,14,2020
9/13/2020,0,0,0,376,462,838,3090,3714,6804,7,7,1,1,9,9,13,15,2020
9/14/2020,0,0,0,432,285,717,3547,2296,5843,1,1,0,0,9,9,14,16,2020
9/15/2020,0,0,0,409,323,731,3359,2596,5955,2,2,0,0,9,9,15,17,2020
9/16/2020,0,0,0,364,374,738,2990,3012,6002,3,3,0,0,9,9,16,18,2020
9/17/2020,0,0,0,457,404,861,3759,3248,7007,4,4,0,0,9,9,17,19,2020
9/18/2020,0,0,0,463,402,864,3801,3231,7032,5,5,1,1,9,9,18,20,2020
9/19/2020,0,0,0,424,459,883,3485,3696,7181,6,6,1,1,9,9,19,21,2020
9/20/2020,0,0,0,421,523,944,3460,4209,7669,7,7,1,1,9,9,20,22,2020
9/21/2020,0,0,0,319,530,848,2619,4262,6881,1,1,0,0,9,9,21,23,2020
9/22/2020,0,0,0,331,375,706,2722,3018,5740,2,2,0,0,9,9,22,24,2020
9/23/2020,0,0,0,374,357,731,3072,2874,5946,3,3,0,0,9,9,23,25,2020
9/24/2020,0,0,0,522,416,938,4290,3346,7636,4,4,0,0,9,9,24,26,2020
9/25/2020,0,0,0,507,414,921,4166,3331,7497,5,5,1,1,9,9,25,27,2020
9/26/2020,0,0,0,441,448,889,3623,3602,7225,6,6,1,1,9,9,26,28,2020
9/27/2020,0,0,0,407,554,961,3346,4457,7803,7,7,1,1,9,9,27,29,2020
9/28/2020,0,0,0,348,535,882,2858,4302,7160,1,1,0,0,9,9,28,30,2020
9/29/2020,0,0,0,335,488,823,2754,3927,6681,2,2,0,0,9,10,29,1,2020
9/30/2020,0,0,0,333,385,718,2738,3100,5838,3,3,0,0,9,10,30,2,2020
10/1/2020,0,0,0,505,494,999,3552,3424,6976,4,4,0,0,10,10,1,3,2020
10/2/2020,0,0,0,493,443,936,3465,3070,6535,5,5,1,1,10,10,2,4,2020
10/3/2020,0,0,0,453,566,1019,3184,3922,7106,6,6,1,1,10,10,3,5,2020
10/4/2020,0,0,0,450,692,1142,3165,4798,7963,7,7,1,1,10,10,4,6,2020
10/5/2020,0,0,0,323,579,902,2273,4012,6285,1,1,0,0,10,10,5,7,2020
10/6/2020,0,0,0,366,536,903,2578,3716,6294,2,2,0,0,10,10,6,8,2020
10/7/2020,0,0,0,426,428,855,3000,2969,5969,3,3,0,0,10,10,7,9,2020
10/8/2020,0,0,0,575,477,1052,4045,3306,7351,4,4,0,0,10,10,8,10,2020
10/9/2020,0,0,0,553,464,1017,3887,3216,7103,5,5,1,1,10,10,9,11,2020
10/10/2020,0,0,0,479,595,1074,3370,4123,7493,6,6,1,1,10,10,10,12,2020
10/11/2020,0,0,0,430,687,1117,3026,4763,7789,7,7,1,1,10,10,11,13,2020
10/12/2020,0,0,0,362,655,1017,2546,4537,7083,1,1,0,0,10,10,12,14,2020
10/13/2020,0,0,0,370,544,913,2600,3769,6369,2,2,0,0,10,10,13,15,2020
10/14/2020,0,0,0,407,491,898,2862,3405,6267,3,3,0,0,10,10,14,16,2020
10/15/2020,0,0,0,600,499,1099,4218,3461,7679,4,4,0,0,10,10,15,17,2020
10/16/2020,0,0,0,521,446,967,3664,3094,6758,5,5,1,1,10,10,16,18,2020
10/17/2020,0,0,0,483,571,1054,3399,3957,7356,6,6,1,1,10,10,17,19,2020
10/18/2020,0,0,0,502,603,1105,3530,4181,7711,7,7,1,1,10,10,18,20,2020
10/19/2020,0,0,0,373,616,989,2620,4269,6889,1,1,0,0,10,10,19,21,2020
10/20/2020,0,0,0,412,518,930,2899,3589,6488,2,2,0,0,10,10,20,22,2020
10/21/2020,0,0,0,437,411,848,3072,2849,5921,3,3,0,0,10,10,21,23,2020
10/22/2020,0,0,0,608,456,1063,4276,3158,7434,4,4,0,0,10,10,22,24,2020
10/23/2020,0,0,0,566,482,1048,3985,3338,7323,5,5,1,1,10,10,23,25,2020
10/24/2020,0,0,0,500,604,1105,3520,4189,7709,6,6,1,1,10,10,24,26,2020
10/25/2020,0,0,0,446,602,1048,3140,4171,7311,7,7,1,1,10,10,25,27,2020
10/26/2020,0,0,0,428,623,1051,3013,4316,7329,1,1,0,0,10,10,26,28,2020
10/27/2020,0,0,0,435,562,997,3062,3892,6954,2,2,0,0,10,10,27,29,2020
10/28/2020,0,0,0,555,513,1068,3902,3556,7458,3,3,0,0,10,10,28,30,2020
10/29/2020,0,0,0,604,473,1077,4247,3281,7528,4,4,0,0,10,10,29,31,2020
10/30/2020,0,0,0,617,424,1041,4344,2938,7282,5,5,1,1,10,11,30,1,2020
10/31/2020,0,0,0,552,513,1064,3880,3552,7432,6,6,1,1,10,11,31,2,2020
11/1/2020,0,0,0,604,852,1455,3522,5190,8712,7,7,1,1,11,11,1,3,2020
11/2/2020,0,0,0,508,828,1335,2962,5045,8007,1,1,0,0,11,11,2,4,2020
11/3/2020,0,0,0,474,696,1171,2766,4245,7011,2,2,0,0,11,11,3,5,2020
11/4/2020,0,0,0,472,559,1030,2753,3404,6157,3,3,0,0,11,11,4,6,2020
11/5/2020,0,0,0,824,524,1348,4809,3195,8004,4,4,0,0,11,11,5,7,2020
11/6/2020,0,0,0,755,548,1303,4408,3338,7746,5,5,1,1,11,11,6,8,2020
11/7/2020,0,0,0,663,759,1422,3870,4625,8495,6,6,1,1,11,11,7,9,2020
11/8/2020,0,0,0,543,734,1277,3167,4476,7643,7,7,1,1,11,11,8,10,2020
11/9/2020,0,0,0,452,908,1360,2639,5534,8173,1,1,0,0,11,11,9,11,2020
11/10/2020,0,0,0,414,536,950,2417,3265,5682,2,2,0,0,11,11,10,12,2020
11/11/2020,0,0,0,434,670,1105,2535,4086,6621,3,3,0,0,11,11,11,13,2020
11/12/2020,0,0,0,558,832,1390,3256,5073,8329,4,4,0,0,11,11,12,14,2020
11/13/2020,0,0,0,536,888,1424,3125,5412,8537,5,5,1,1,11,11,13,15,2020
11/14/2020,0,0,0,534,799,1333,3117,4869,7986,6,6,1,1,11,11,14,16,2020
11/15/2020,0,0,0,618,788,1407,3608,4804,8412,7,7,1,1,11,11,15,17,2020
11/16/2020,0,0,0,844,509,1352,4923,3101,8024,1,1,0,0,11,11,16,18,2020
11/17/2020,0,0,0,731,549,1280,4266,3347,7613,2,2,0,0,11,11,17,19,2020
11/18/2020,0,0,0,630,517,1148,3679,3153,6832,3,3,0,0,11,11,18,20,2020
11/19/2020,0,0,0,955,541,1496,5573,3299,8872,4,4,0,0,11,11,19,21,2020
11/20/2020,0,0,0,1081,589,1670,6310,3588,9898,5,5,1,1,11,11,20,22,2020
11/21/2020,0,0,0,1188,738,1926,6935,4498,11433,6,6,1,1,11,11,21,23,2020
11/22/2020,0,0,0,819,699,1518,4782,4258,9040,7,7,1,1,11,11,22,24,2020
11/23/2020,0,0,0,722,686,1408,4214,4183,8397,1,1,0,0,11,11,23,25,2020
11/24/2020,0,0,0,750,771,1521,4377,4699,9076,2,2,0,0,11,11,24,26,2020
11/25/2020,0,0,0,903,874,1777,5270,5326,10596,3,3,0,0,11,11,25,27,2020
11/26/2020,0,0,0,844,884,1728,4926,5387,10313,4,4,0,0,11,11,26,28,2020
11/27/2020,0,0,0,671,914,1585,3918,5571,9489,5,5,1,1,11,11,27,29,2020
11/28/2020,0,0,0,720,1241,1961,4202,7565,11767,6,6,1,1,11,11,28,30,2020
11/29/2020,0,0,0,845,1321,2166,4930,8050,12980,7,7,1,1,11,12,29,1,2020
11/30/2020,0,0,0,729,1202,1931,4252,7328,11580,1,1,0,0,11,12,30,2,2020
12/1/2020,0,0,0,677,986,1663,3568,5163,8731,2,2,0,0,12,12,1,3,2020
12/2/2020,0,0,0,695,738,1433,3663,3864,7527,3,3,0,0,12,12,2,4,2020
12/3/2020,0,0,0,865,615,1480,4559,3222,7781,4,4,0,0,12,12,3,5,2020
12/4/2020,0,0,0,866,636,1502,4564,3329,7893,5,5,1,1,12,12,4,6,2020
12/5/2020,0,0,0,809,728,1537,4263,3811,8074,6,6,1,1,12,12,5,7,2020
12/6/2020,0,0,0,844,799,1643,4447,4185,8632,7,7,1,1,12,12,6,8,2020
12/7/2020,0,0,0,733,750,1483,3864,3928,7792,1,1,0,0,12,12,7,9,2020
12/8/2020,0,0,0,716,604,1320,3773,3164,6937,2,2,0,0,12,12,8,10,2020
12/9/2020,0,0,0,717,536,1253,3778,2807,6585,3,3,0,0,12,12,9,11,2020
12/10/2020,0,0,0,841,554,1395,4431,2902,7333,4,4,0,0,12,12,10,12,2020
12/11/2020,0,0,0,974,561,1535,5131,2938,8069,5,5,1,1,12,12,11,13,2020
12/12/2020,0,0,0,945,919,1864,4979,4815,9794,6,6,1,1,12,12,12,14,2020
12/13/2020,0,0,0,911,997,1908,4801,5223,10024,7,7,1,1,12,12,13,15,2020
12/14/2020,0,0,0,891,876,1767,4695,4586,9281,1,1,0,0,12,12,14,16,2020
12/15/2020,0,0,0,895,756,1651,4715,3958,8673,2,2,0,0,12,12,15,17,2020
12/16/2020,0,0,0,1072,858,1930,5649,4494,10143,3,3,0,0,12,12,16,18,2020
12/17/2020,0,0,0,1219,967,2185,6421,5063,11484,4,4,0,0,12,12,17,19,2020
12/18/2020,0,0,0,1399,1094,2493,7372,5727,13099,5,5,1,1,12,12,18,20,2020
12/19/2020,0,0,0,1492,1355,2848,7864,7098,14962,6,6,1,1,12,12,19,21,2020
12/20/2020,0,0,0,1241,1259,2500,6538,6595,13133,7,7,1,1,12,12,20,22,2020
12/21/2020,0,0,0,1123,1144,2267,5918,5993,11911,1,1,0,0,12,12,21,23,2020
12/22/2020,0,0,0,928,966,1894,4892,5058,9950,2,2,0,0,12,12,22,24,2020
12/23/2020,0,0,0,1180,1183,2363,6219,6193,12412,3,3,0,0,12,12,23,25,2020
12/24/2020,0,0,0,1393,1412,2805,7339,7396,14735,4,4,0,0,12,12,24,26,2020
12/25/2020,0,0,0,1324,1558,2882,6977,8161,15138,5,5,1,1,12,12,25,27,2020
12/26/2020,0,0,0,1229,1652,2880,6474,8650,15124,6,6,1,1,12,12,26,28,2020
12/27/2020,0,0,0,1123,1467,2590,5918,7680,13598,7,7,1,1,12,12,27,29,2020
12/28/2020,0,0,0,1056,1491,2548,5567,7809,13376,1,1,0,0,12,12,28,30,2020
12/29/2020,0,0,0,872,1353,2225,4597,7084,11681,2,2,0,0,12,12,29,31,2020
12/30/2020,0,0,0,1019,1252,2270,5367,6555,11922,3,3,0,0,12,1,30,1,2020
12/31/2020,0,0,0,1244,1333,2577,6555,6979,13534,4,4,0,0,12,1,31,2,2020
