Time,Date,SB,NB,Total,Day,Month,Year,
0,4/1/2020,29,21,50,3,4,2020,
1,4/1/2020,2,12,14,3,4,2020,
2,4/1/2020,9,15,24,3,4,2020,
3,4/1/2020,0,0,0,3,4,2020,
4,4/1/2020,1,0,1,3,4,2020,
5,4/1/2020,18,0,18,3,4,2020,
6,4/1/2020,24,0,24,3,4,2020,
7,4/1/2020,20,61,81,3,4,2020,
8,4/1/2020,15,49,64,3,4,2020,
9,4/1/2020,23,31,54,3,4,2020,
10,4/1/2020,20,21,41,3,4,2020,
11,4/1/2020,14,3,17,3,4,2020,
12,4/1/2020,10,14,24,3,4,2020,
13,4/1/2020,29,5,34,3,4,2020,
14,4/1/2020,24,77,101,3,4,2020,
15,4/1/2020,29,72,101,3,4,2020,
16,4/1/2020,23,4,27,3,4,2020,
17,4/1/2020,34,2,36,3,4,2020,
18,4/1/2020,7,21,28,3,4,2020,
19,4/1/2020,9,30,39,3,4,2020,
20,4/1/2020,12,56,68,3,4,2020,
21,4/1/2020,27,17,44,3,4,2020,
22,4/1/2020,25,36,61,3,4,2020,
23,4/1/2020,29,13,42,3,4,2020,
0,4/2/2020,17,7,24,4,4,2020,
1,4/2/2020,6,20,26,4,4,2020,
2,4/2/2020,4,0,4,4,4,2020,
3,4/2/2020,19,0,19,4,4,2020,
4,4/2/2020,11,0,11,4,4,2020,
5,4/2/2020,17,0,17,4,4,2020,
6,4/2/2020,22,0,22,4,4,2020,
7,4/2/2020,26,23,49,4,4,2020,
8,4/2/2020,9,28,37,4,4,2020,
9,4/2/2020,11,40,51,4,4,2020,
10,4/2/2020,22,2,24,4,4,2020,
11,4/2/2020,15,0,15,4,4,2020,
12,4/2/2020,5,12,17,4,4,2020,
13,4/2/2020,32,79,111,4,4,2020,
14,4/2/2020,17,27,44,4,4,2020,
15,4/2/2020,11,13,24,4,4,2020,
16,4/2/2020,16,1,17,4,4,2020,
17,4/2/2020,13,5,18,4,4,2020,
18,4/2/2020,19,40,59,4,4,2020,
19,4/2/2020,20,65,85,4,4,2020,
20,4/2/2020,29,21,50,4,4,2020,
21,4/2/2020,50,2,52,4,4,2020,
22,4/2/2020,47,26,73,4,4,2020,
23,4/2/2020,33,10,43,4,4,2020,
0,4/3/2020,15,33,48,5,4,2020,
1,4/3/2020,9,0,9,5,4,2020,
2,4/3/2020,9,0,9,5,4,2020,
3,4/3/2020,7,0,7,5,4,2020,
4,4/3/2020,10,0,10,5,4,2020,
5,4/3/2020,40,0,40,5,4,2020,
6,4/3/2020,45,0,45,5,4,2020,
7,4/3/2020,55,103,158,5,4,2020,
8,4/3/2020,28,30,58,5,4,2020,
9,4/3/2020,4,64,68,5,4,2020,
10,4/3/2020,16,65,81,5,4,2020,
11,4/3/2020,10,0,10,5,4,2020,
12,4/3/2020,11,6,17,5,4,2020,
13,4/3/2020,13,32,45,5,4,2020,
14,4/3/2020,22,0,22,5,4,2020,
15,4/3/2020,11,74,85,5,4,2020,
16,4/3/2020,8,6,14,5,4,2020,
17,4/3/2020,1,0,1,5,4,2020,
18,4/3/2020,8,8,16,5,4,2020,
19,4/3/2020,7,3,10,5,4,2020,
20,4/3/2020,19,43,62,5,4,2020,
21,4/3/2020,43,18,61,5,4,2020,
22,4/3/2020,11,65,76,5,4,2020,
23,4/3/2020,32,5,37,5,4,2020,
0,4/4/2020,26,60,86,6,4,2020,
1,4/4/2020,4,0,4,6,4,2020,
2,4/4/2020,19,0,19,6,4,2020,
3,4/4/2020,17,0,17,6,4,2020,
4,4/4/2020,6,0,6,6,4,2020,
5,4/4/2020,17,0,17,6,4,2020,
6,4/4/2020,69,0,69,6,4,2020,
7,4/4/2020,48,45,93,6,4,2020,
8,4/4/2020,21,41,62,6,4,2020,
9,4/4/2020,39,76,115,6,4,2020,
10,4/4/2020,26,7,33,6,4,2020,
11,4/4/2020,4,19,23,6,4,2020,
12,4/4/2020,13,47,60,6,4,2020,
13,4/4/2020,10,12,22,6,4,2020,
14,4/4/2020,26,1,27,6,4,2020,
15,4/4/2020,8,16,24,6,4,2020,
16,4/4/2020,7,49,56,6,4,2020,
17,4/4/2020,7,1,8,6,4,2020,
18,4/4/2020,15,6,21,6,4,2020,
19,4/4/2020,22,30,52,6,4,2020,
20,4/4/2020,20,7,27,6,4,2020,
21,4/4/2020,35,14,49,6,4,2020,
22,4/4/2020,51,27,78,6,4,2020,
23,4/4/2020,51,8,59,6,4,2020,
0,4/5/2020,29,16,45,7,4,2020,
1,4/5/2020,10,2,12,7,4,2020,
2,4/5/2020,4,1,5,7,4,2020,
3,4/5/2020,21,0,21,7,4,2020,
4,4/5/2020,24,0,24,7,4,2020,
5,4/5/2020,45,0,45,7,4,2020,
6,4/5/2020,59,57,116,7,4,2020,
7,4/5/2020,38,89,127,7,4,2020,
8,4/5/2020,18,19,37,7,4,2020,
9,4/5/2020,20,94,114,7,4,2020,
10,4/5/2020,17,15,32,7,4,2020,
11,4/5/2020,10,53,63,7,4,2020,
12,4/5/2020,9,18,27,7,4,2020,
13,4/5/2020,6,21,27,7,4,2020,
14,4/5/2020,8,36,44,7,4,2020,
15,4/5/2020,12,29,41,7,4,2020,
16,4/5/2020,22,6,28,7,4,2020,
17,4/5/2020,17,10,27,7,4,2020,
18,4/5/2020,9,51,60,7,4,2020,
19,4/5/2020,4,28,32,7,4,2020,
20,4/5/2020,23,10,33,7,4,2020,
21,4/5/2020,32,0,32,7,4,2020,
22,4/5/2020,25,3,28,7,4,2020,
23,4/5/2020,18,43,61,7,4,2020,
0,4/6/2020,14,22,36,1,4,2020,
1,4/6/2020,4,0,4,1,4,2020,
2,4/6/2020,3,0,3,1,4,2020,
3,4/6/2020,5,0,5,1,4,2020,
4,4/6/2020,22,0,22,1,4,2020,
5,4/6/2020,23,0,23,1,4,2020,
6,4/6/2020,48,18,66,1,4,2020,
7,4/6/2020,41,61,102,1,4,2020,
8,4/6/2020,9,60,69,1,4,2020,
9,4/6/2020,13,31,44,1,4,2020,
10,4/6/2020,4,0,4,1,4,2020,
11,4/6/2020,10,40,50,1,4,2020,
12,4/6/2020,10,0,10,1,4,2020,
13,4/6/2020,5,16,21,1,4,2020,
14,4/6/2020,4,18,22,1,4,2020,
15,4/6/2020,8,10,18,1,4,2020,
16,4/6/2020,16,5,21,1,4,2020,
17,4/6/2020,23,3,26,1,4,2020,
18,4/6/2020,9,36,45,1,4,2020,
19,4/6/2020,10,23,33,1,4,2020,
20,4/6/2020,24,25,49,1,4,2020,
21,4/6/2020,35,18,53,1,4,2020,
22,4/6/2020,28,10,38,1,4,2020,
23,4/6/2020,14,16,30,1,4,2020,
0,4/7/2020,16,8,24,2,4,2020,
1,4/7/2020,3,0,3,2,4,2020,
2,4/7/2020,14,0,14,2,4,2020,
3,4/7/2020,5,0,5,2,4,2020,
4,4/7/2020,2,0,2,2,4,2020,
5,4/7/2020,20,0,20,2,4,2020,
6,4/7/2020,30,12,42,2,4,2020,
7,4/7/2020,21,38,59,2,4,2020,
8,4/7/2020,11,23,34,2,4,2020,
9,4/7/2020,3,36,39,2,4,2020,
10,4/7/2020,7,0,7,2,4,2020,
11,4/7/2020,4,0,4,2,4,2020,
12,4/7/2020,15,15,30,2,4,2020,
13,4/7/2020,1,34,35,2,4,2020,
14,4/7/2020,14,16,30,2,4,2020,
15,4/7/2020,0,0,0,2,4,2020,
16,4/7/2020,4,0,4,2,4,2020,
17,4/7/2020,8,2,10,2,4,2020,
18,4/7/2020,14,39,53,2,4,2020,
19,4/7/2020,13,1,14,2,4,2020,
20,4/7/2020,11,1,12,2,4,2020,
21,4/7/2020,34,5,39,2,4,2020,
22,4/7/2020,34,1,35,2,4,2020,
23,4/7/2020,18,13,31,2,4,2020,
0,4/8/2020,25,1,26,3,4,2020,
1,4/8/2020,0,0,0,3,4,2020,
2,4/8/2020,1,0,1,3,4,2020,
3,4/8/2020,0,0,0,3,4,2020,
4,4/8/2020,5,0,5,3,4,2020,
5,4/8/2020,17,0,17,3,4,2020,
6,4/8/2020,36,40,76,3,4,2020,
7,4/8/2020,14,69,83,3,4,2020,
8,4/8/2020,26,3,29,3,4,2020,
9,4/8/2020,16,4,20,3,4,2020,
10,4/8/2020,9,28,37,3,4,2020,
11,4/8/2020,5,10,15,3,4,2020,
12,4/8/2020,4,0,4,3,4,2020,
13,4/8/2020,0,6,6,3,4,2020,
14,4/8/2020,2,32,34,3,4,2020,
15,4/8/2020,7,42,49,3,4,2020,
16,4/8/2020,12,0,12,3,4,2020,
17,4/8/2020,15,0,15,3,4,2020,
18,4/8/2020,12,44,56,3,4,2020,
19,4/8/2020,15,1,16,3,4,2020,
20,4/8/2020,19,13,32,3,4,2020,
21,4/8/2020,28,22,50,3,4,2020,
22,4/8/2020,28,3,31,3,4,2020,
23,4/8/2020,20,1,21,3,4,2020,
0,4/9/2020,23,13,36,4,4,2020,
1,4/9/2020,1,0,1,4,4,2020,
2,4/9/2020,8,0,8,4,4,2020,
3,4/9/2020,7,0,7,4,4,2020,
4,4/9/2020,3,0,3,4,4,2020,
5,4/9/2020,8,0,8,4,4,2020,
6,4/9/2020,7,2,9,4,4,2020,
7,4/9/2020,23,71,94,4,4,2020,
8,4/9/2020,15,37,52,4,4,2020,
9,4/9/2020,11,1,12,4,4,2020,
10,4/9/2020,13,4,17,4,4,2020,
11,4/9/2020,10,32,42,4,4,2020,
12,4/9/2020,2,3,5,4,4,2020,
13,4/9/2020,3,37,40,4,4,2020,
14,4/9/2020,1,0,1,4,4,2020,
15,4/9/2020,6,0,6,4,4,2020,
16,4/9/2020,7,0,7,4,4,2020,
17,4/9/2020,7,1,8,4,4,2020,
18,4/9/2020,1,69,70,4,4,2020,
19,4/9/2020,11,16,27,4,4,2020,
20,4/9/2020,28,15,43,4,4,2020,
21,4/9/2020,25,16,41,4,4,2020,
22,4/9/2020,42,0,42,4,4,2020,
23,4/9/2020,25,10,35,4,4,2020,
0,4/10/2020,18,8,26,5,4,2020,
1,4/10/2020,7,0,7,5,4,2020,
2,4/10/2020,3,0,3,5,4,2020,
3,4/10/2020,0,0,0,5,4,2020,
4,4/10/2020,1,0,1,5,4,2020,
5,4/10/2020,21,1,22,5,4,2020,
6,4/10/2020,41,50,91,5,4,2020,
7,4/10/2020,36,70,106,5,4,2020,
8,4/10/2020,18,8,26,5,4,2020,
9,4/10/2020,14,0,14,5,4,2020,
10,4/10/2020,9,6,15,5,4,2020,
11,4/10/2020,2,46,48,5,4,2020,
12,4/10/2020,4,0,4,5,4,2020,
13,4/10/2020,0,0,0,5,4,2020,
14,4/10/2020,0,36,36,5,4,2020,
15,4/10/2020,2,6,8,5,4,2020,
16,4/10/2020,4,0,4,5,4,2020,
17,4/10/2020,11,0,11,5,4,2020,
18,4/10/2020,6,28,34,5,4,2020,
19,4/10/2020,13,3,16,5,4,2020,
20,4/10/2020,29,17,46,5,4,2020,
21,4/10/2020,43,0,43,5,4,2020,
22,4/10/2020,46,1,47,5,4,2020,
23,4/10/2020,31,10,41,5,4,2020,
0,4/11/2020,9,12,21,6,4,2020,
1,4/11/2020,5,0,5,6,4,2020,
2,4/11/2020,0,0,0,6,4,2020,
3,4/11/2020,0,0,0,6,4,2020,
4,4/11/2020,0,0,0,6,4,2020,
5,4/11/2020,0,0,0,6,4,2020,
6,4/11/2020,2,30,32,6,4,2020,
7,4/11/2020,6,36,42,6,4,2020,
8,4/11/2020,12,1,13,6,4,2020,
9,4/11/2020,22,80,102,6,4,2020,
10,4/11/2020,17,6,23,6,4,2020,
11,4/11/2020,20,19,39,6,4,2020,
12,4/11/2020,8,0,8,6,4,2020,
13,4/11/2020,3,1,4,6,4,2020,
14,4/11/2020,5,5,10,6,4,2020,
15,4/11/2020,14,0,14,6,4,2020,
16,4/11/2020,3,0,3,6,4,2020,
17,4/11/2020,8,0,8,6,4,2020,
18,4/11/2020,8,99,107,6,4,2020,
19,4/11/2020,11,0,11,6,4,2020,
20,4/11/2020,6,0,6,6,4,2020,
21,4/11/2020,47,0,47,6,4,2020,
22,4/11/2020,32,0,32,6,4,2020,
23,4/11/2020,50,41,91,6,4,2020,
0,4/12/2020,14,8,22,7,4,2020,
1,4/12/2020,3,0,3,7,4,2020,
2,4/12/2020,4,0,4,7,4,2020,
3,4/12/2020,5,0,5,7,4,2020,
4,4/12/2020,14,0,14,7,4,2020,
5,4/12/2020,14,0,14,7,4,2020,
6,4/12/2020,20,14,34,7,4,2020,
7,4/12/2020,12,54,66,7,4,2020,
8,4/12/2020,16,15,31,7,4,2020,
9,4/12/2020,25,65,90,7,4,2020,
10,4/12/2020,12,55,67,7,4,2020,
11,4/12/2020,14,26,40,7,4,2020,
12,4/12/2020,10,6,16,7,4,2020,
13,4/12/2020,2,15,17,7,4,2020,
14,4/12/2020,4,26,30,7,4,2020,
15,4/12/2020,4,15,19,7,4,2020,
16,4/12/2020,7,0,7,7,4,2020,
17,4/12/2020,7,5,12,7,4,2020,
18,4/12/2020,7,82,89,7,4,2020,
19,4/12/2020,7,3,10,7,4,2020,
20,4/12/2020,21,27,48,7,4,2020,
21,4/12/2020,35,1,36,7,4,2020,
22,4/12/2020,16,19,35,7,4,2020,
23,4/12/2020,6,74,80,7,4,2020,
0,4/13/2020,7,12,19,1,4,2020,
1,4/13/2020,2,6,8,1,4,2020,
2,4/13/2020,4,0,4,1,4,2020,
3,4/13/2020,0,0,0,1,4,2020,
4,4/13/2020,1,0,1,1,4,2020,
5,4/13/2020,9,0,9,1,4,2020,
6,4/13/2020,16,0,16,1,4,2020,
7,4/13/2020,28,52,80,1,4,2020,
8,4/13/2020,5,27,32,1,4,2020,
9,4/13/2020,5,63,68,1,4,2020,
10,4/13/2020,12,1,13,1,4,2020,
11,4/13/2020,3,15,18,1,4,2020,
12,4/13/2020,7,8,15,1,4,2020,
13,4/13/2020,4,8,12,1,4,2020,
14,4/13/2020,2,10,12,1,4,2020,
15,4/13/2020,7,0,7,1,4,2020,
16,4/13/2020,16,0,16,1,4,2020,
17,4/13/2020,20,0,20,1,4,2020,
18,4/13/2020,3,58,61,1,4,2020,
19,4/13/2020,11,0,11,1,4,2020,
20,4/13/2020,19,11,30,1,4,2020,
21,4/13/2020,30,0,30,1,4,2020,
22,4/13/2020,18,0,18,1,4,2020,
23,4/13/2020,15,10,25,1,4,2020,
0,4/14/2020,11,22,33,2,4,2020,
1,4/14/2020,0,9,9,2,4,2020,
2,4/14/2020,0,0,0,2,4,2020,
3,4/14/2020,0,0,0,2,4,2020,
4,4/14/2020,10,0,10,2,4,2020,
5,4/14/2020,19,0,19,2,4,2020,
6,4/14/2020,19,64,83,2,4,2020,
7,4/14/2020,16,20,36,2,4,2020,
8,4/14/2020,7,25,32,2,4,2020,
9,4/14/2020,6,41,47,2,4,2020,
10,4/14/2020,6,7,13,2,4,2020,
11,4/14/2020,6,12,18,2,4,2020,
12,4/14/2020,3,21,24,2,4,2020,
13,4/14/2020,4,11,15,2,4,2020,
14,4/14/2020,1,0,1,2,4,2020,
15,4/14/2020,1,0,1,2,4,2020,
16,4/14/2020,3,0,3,2,4,2020,
17,4/14/2020,0,6,6,2,4,2020,
18,4/14/2020,4,14,18,2,4,2020,
19,4/14/2020,6,0,6,2,4,2020,
20,4/14/2020,33,0,33,2,4,2020,
21,4/14/2020,23,10,33,2,4,2020,
22,4/14/2020,26,0,26,2,4,2020,
23,4/14/2020,24,9,33,2,4,2020,
0,4/15/2020,23,0,23,3,4,2020,
1,4/15/2020,0,0,0,3,4,2020,
2,4/15/2020,0,0,0,3,4,2020,
3,4/15/2020,2,0,2,3,4,2020,
4,4/15/2020,2,0,2,3,4,2020,
5,4/15/2020,17,0,17,3,4,2020,
6,4/15/2020,34,14,48,3,4,2020,
7,4/15/2020,11,98,109,3,4,2020,
8,4/15/2020,9,7,16,3,4,2020,
9,4/15/2020,9,38,47,3,4,2020,
10,4/15/2020,5,4,9,3,4,2020,
11,4/15/2020,1,17,18,3,4,2020,
12,4/15/2020,2,23,25,3,4,2020,
13,4/15/2020,4,6,10,3,4,2020,
14,4/15/2020,1,0,1,3,4,2020,
15,4/15/2020,6,5,11,3,4,2020,
16,4/15/2020,11,0,11,3,4,2020,
17,4/15/2020,8,0,8,3,4,2020,
18,4/15/2020,5,32,37,3,4,2020,
19,4/15/2020,7,21,28,3,4,2020,
20,4/15/2020,24,0,24,3,4,2020,
21,4/15/2020,30,0,30,3,4,2020,
22,4/15/2020,38,2,40,3,4,2020,
23,4/15/2020,20,26,46,3,4,2020,
0,4/16/2020,14,2,16,4,4,2020,
1,4/16/2020,4,0,4,4,4,2020,
2,4/16/2020,2,0,2,4,4,2020,
3,4/16/2020,16,0,16,4,4,2020,
4,4/16/2020,8,0,8,4,4,2020,
5,4/16/2020,2,0,2,4,4,2020,
6,4/16/2020,3,43,46,4,4,2020,
7,4/16/2020,14,0,14,4,4,2020,
8,4/16/2020,12,40,52,4,4,2020,
9,4/16/2020,34,0,34,4,4,2020,
10,4/16/2020,21,8,29,4,4,2020,
11,4/16/2020,6,63,69,4,4,2020,
12,4/16/2020,14,5,19,4,4,2020,
13,4/16/2020,3,29,32,4,4,2020,
14,4/16/2020,2,4,6,4,4,2020,
15,4/16/2020,4,0,4,4,4,2020,
16,4/16/2020,9,0,9,4,4,2020,
17,4/16/2020,12,0,12,4,4,2020,
18,4/16/2020,7,19,26,4,4,2020,
19,4/16/2020,14,33,47,4,4,2020,
20,4/16/2020,20,0,20,4,4,2020,
21,4/16/2020,52,0,52,4,4,2020,
22,4/16/2020,59,2,61,4,4,2020,
23,4/16/2020,41,0,41,4,4,2020,
0,4/17/2020,8,19,27,5,4,2020,
1,4/17/2020,2,0,2,5,4,2020,
2,4/17/2020,2,0,2,5,4,2020,
3,4/17/2020,1,0,1,5,4,2020,
4,4/17/2020,5,0,5,5,4,2020,
5,4/17/2020,20,0,20,5,4,2020,
6,4/17/2020,29,0,29,5,4,2020,
7,4/17/2020,28,86,114,5,4,2020,
8,4/17/2020,21,86,107,5,4,2020,
9,4/17/2020,19,9,28,5,4,2020,
10,4/17/2020,10,52,62,5,4,2020,
11,4/17/2020,1,28,29,5,4,2020,
12,4/17/2020,0,4,4,5,4,2020,
13,4/17/2020,0,46,46,5,4,2020,
14,4/17/2020,10,29,39,5,4,2020,
15,4/17/2020,1,9,10,5,4,2020,
16,4/17/2020,15,0,15,5,4,2020,
17,4/17/2020,21,0,21,5,4,2020,
18,4/17/2020,13,25,38,5,4,2020,
19,4/17/2020,9,14,23,5,4,2020,
20,4/17/2020,28,0,28,5,4,2020,
21,4/17/2020,41,0,41,5,4,2020,
22,4/17/2020,21,3,24,5,4,2020,
23,4/17/2020,22,6,28,5,4,2020,
0,4/18/2020,10,27,37,6,4,2020,
1,4/18/2020,0,0,0,6,4,2020,
2,4/18/2020,0,0,0,6,4,2020,
3,4/18/2020,0,0,0,6,4,2020,
4,4/18/2020,0,0,0,6,4,2020,
5,4/18/2020,0,0,0,6,4,2020,
6,4/18/2020,4,41,45,6,4,2020,
7,4/18/2020,8,17,25,6,4,2020,
8,4/18/2020,28,14,42,6,4,2020,
9,4/18/2020,32,91,123,6,4,2020,
10,4/18/2020,14,8,22,6,4,2020,
11,4/18/2020,3,26,29,6,4,2020,
12,4/18/2020,0,0,0,6,4,2020,
13,4/18/2020,8,0,8,6,4,2020,
14,4/18/2020,14,0,14,6,4,2020,
15,4/18/2020,13,0,13,6,4,2020,
16,4/18/2020,5,0,5,6,4,2020,
17,4/18/2020,3,7,10,6,4,2020,
18,4/18/2020,12,36,48,6,4,2020,
19,4/18/2020,13,47,60,6,4,2020,
20,4/18/2020,31,0,31,6,4,2020,
21,4/18/2020,29,0,29,6,4,2020,
22,4/18/2020,15,0,15,6,4,2020,
23,4/18/2020,11,53,64,6,4,2020,
0,4/19/2020,5,19,24,7,4,2020,
1,4/19/2020,9,1,10,7,4,2020,
2,4/19/2020,5,0,5,7,4,2020,
3,4/19/2020,18,0,18,7,4,2020,
4,4/19/2020,19,0,19,7,4,2020,
5,4/19/2020,56,0,56,7,4,2020,
6,4/19/2020,22,11,33,7,4,2020,
7,4/19/2020,37,57,94,7,4,2020,
8,4/19/2020,16,30,46,7,4,2020,
9,4/19/2020,34,16,50,7,4,2020,
10,4/19/2020,21,29,50,7,4,2020,
11,4/19/2020,9,43,52,7,4,2020,
12,4/19/2020,11,11,22,7,4,2020,
13,4/19/2020,1,54,55,7,4,2020,
14,4/19/2020,3,39,42,7,4,2020,
15,4/19/2020,3,24,27,7,4,2020,
16,4/19/2020,20,0,20,7,4,2020,
17,4/19/2020,6,2,8,7,4,2020,
18,4/19/2020,8,27,35,7,4,2020,
19,4/19/2020,9,12,21,7,4,2020,
20,4/19/2020,20,1,21,7,4,2020,
21,4/19/2020,37,6,43,7,4,2020,
22,4/19/2020,49,75,124,7,4,2020,
23,4/19/2020,25,15,40,7,4,2020,
0,4/20/2020,5,20,25,1,4,2020,
1,4/20/2020,0,0,0,1,4,2020,
2,4/20/2020,0,0,0,1,4,2020,
3,4/20/2020,0,0,0,1,4,2020,
4,4/20/2020,1,0,1,1,4,2020,
5,4/20/2020,16,0,16,1,4,2020,
6,4/20/2020,19,39,58,1,4,2020,
7,4/20/2020,34,2,36,1,4,2020,
8,4/20/2020,12,33,45,1,4,2020,
9,4/20/2020,15,13,28,1,4,2020,
10,4/20/2020,23,10,33,1,4,2020,
11,4/20/2020,10,0,10,1,4,2020,
12,4/20/2020,2,42,44,1,4,2020,
13,4/20/2020,0,31,31,1,4,2020,
14,4/20/2020,2,5,7,1,4,2020,
15,4/20/2020,10,0,10,1,4,2020,
16,4/20/2020,9,0,9,1,4,2020,
17,4/20/2020,9,0,9,1,4,2020,
18,4/20/2020,9,66,75,1,4,2020,
19,4/20/2020,16,9,25,1,4,2020,
20,4/20/2020,6,0,6,1,4,2020,
21,4/20/2020,9,0,9,1,4,2020,
22,4/20/2020,14,1,15,1,4,2020,
23,4/20/2020,5,31,36,1,4,2020,
0,4/21/2020,14,17,31,2,4,2020,
1,4/21/2020,1,0,1,2,4,2020,
2,4/21/2020,0,0,0,2,4,2020,
3,4/21/2020,0,0,0,2,4,2020,
4,4/21/2020,1,0,1,2,4,2020,
5,4/21/2020,2,0,2,2,4,2020,
6,4/21/2020,15,0,15,2,4,2020,
7,4/21/2020,33,0,33,2,4,2020,
8,4/21/2020,14,7,21,2,4,2020,
9,4/21/2020,8,35,43,2,4,2020,
10,4/21/2020,11,13,24,2,4,2020,
11,4/21/2020,2,1,3,2,4,2020,
12,4/21/2020,16,49,65,2,4,2020,
13,4/21/2020,11,16,27,2,4,2020,
14,4/21/2020,1,0,1,2,4,2020,
15,4/21/2020,3,0,3,2,4,2020,
16,4/21/2020,6,0,6,2,4,2020,
17,4/21/2020,4,1,5,2,4,2020,
18,4/21/2020,1,25,26,2,4,2020,
19,4/21/2020,3,0,3,2,4,2020,
20,4/21/2020,21,0,21,2,4,2020,
21,4/21/2020,22,52,74,2,4,2020,
22,4/21/2020,29,0,29,2,4,2020,
23,4/21/2020,20,9,29,2,4,2020,
0,4/22/2020,7,34,41,3,4,2020,
1,4/22/2020,4,0,4,3,4,2020,
2,4/22/2020,0,0,0,3,4,2020,
3,4/22/2020,1,0,1,3,4,2020,
4,4/22/2020,6,0,6,3,4,2020,
5,4/22/2020,2,0,2,3,4,2020,
6,4/22/2020,8,0,8,3,4,2020,
7,4/22/2020,0,58,58,3,4,2020,
8,4/22/2020,8,3,11,3,4,2020,
9,4/22/2020,11,35,46,3,4,2020,
10,4/22/2020,9,41,50,3,4,2020,
11,4/22/2020,5,0,5,3,4,2020,
12,4/22/2020,0,15,15,3,4,2020,
13,4/22/2020,0,9,9,3,4,2020,
14,4/22/2020,0,0,0,3,4,2020,
15,4/22/2020,0,8,8,3,4,2020,
16,4/22/2020,1,0,1,3,4,2020,
17,4/22/2020,0,0,0,3,4,2020,
18,4/22/2020,3,0,3,3,4,2020,
19,4/22/2020,8,8,16,3,4,2020,
20,4/22/2020,31,7,38,3,4,2020,
21,4/22/2020,28,0,28,3,4,2020,
22,4/22/2020,34,0,34,3,4,2020,
23,4/22/2020,18,0,18,3,4,2020,
0,4/23/2020,13,0,13,4,4,2020,
1,4/23/2020,5,0,5,4,4,2020,
2,4/23/2020,10,0,10,4,4,2020,
3,4/23/2020,3,0,3,4,4,2020,
4,4/23/2020,9,0,9,4,4,2020,
5,4/23/2020,0,0,0,4,4,2020,
6,4/23/2020,17,48,65,4,4,2020,
7,4/23/2020,38,2,40,4,4,2020,
8,4/23/2020,12,16,28,4,4,2020,
9,4/23/2020,19,74,93,4,4,2020,
10,4/23/2020,13,14,27,4,4,2020,
11,4/23/2020,5,19,24,4,4,2020,
12,4/23/2020,5,24,29,4,4,2020,
13,4/23/2020,3,38,41,4,4,2020,
14,4/23/2020,5,0,5,4,4,2020,
15,4/23/2020,20,0,20,4,4,2020,
16,4/23/2020,3,0,3,4,4,2020,
17,4/23/2020,19,0,19,4,4,2020,
18,4/23/2020,6,12,18,4,4,2020,
19,4/23/2020,10,17,27,4,4,2020,
20,4/23/2020,25,1,26,4,4,2020,
21,4/23/2020,83,0,83,4,4,2020,
22,4/23/2020,50,0,50,4,4,2020,
23,4/23/2020,45,22,67,4,4,2020,
0,4/24/2020,7,27,34,5,4,2020,
1,4/24/2020,3,0,3,5,4,2020,
2,4/24/2020,0,0,0,5,4,2020,
3,4/24/2020,2,0,2,5,4,2020,
4,4/24/2020,0,0,0,5,4,2020,
5,4/24/2020,24,0,24,5,4,2020,
6,4/24/2020,18,33,51,5,4,2020,
7,4/24/2020,22,32,54,5,4,2020,
8,4/24/2020,25,0,25,5,4,2020,
9,4/24/2020,32,39,71,5,4,2020,
10,4/24/2020,25,69,94,5,4,2020,
11,4/24/2020,10,10,20,5,4,2020,
12,4/24/2020,3,26,29,5,4,2020,
13,4/24/2020,1,16,17,5,4,2020,
14,4/24/2020,3,51,54,5,4,2020,
15,4/24/2020,3,10,13,5,4,2020,
16,4/24/2020,8,1,9,5,4,2020,
17,4/24/2020,27,13,40,5,4,2020,
18,4/24/2020,10,86,96,5,4,2020,
19,4/24/2020,7,5,12,5,4,2020,
20,4/24/2020,23,27,50,5,4,2020,
21,4/24/2020,31,0,31,5,4,2020,
22,4/24/2020,51,0,51,5,4,2020,
23,4/24/2020,31,14,45,5,4,2020,
0,4/25/2020,13,28,41,6,4,2020,
1,4/25/2020,0,1,1,6,4,2020,
2,4/25/2020,0,0,0,6,4,2020,
3,4/25/2020,0,0,0,6,4,2020,
4,4/25/2020,0,0,0,6,4,2020,
5,4/25/2020,6,0,6,6,4,2020,
6,4/25/2020,20,0,20,6,4,2020,
7,4/25/2020,47,0,47,6,4,2020,
8,4/25/2020,7,23,30,6,4,2020,
9,4/25/2020,15,87,102,6,4,2020,
10,4/25/2020,6,19,25,6,4,2020,
11,4/25/2020,7,0,7,6,4,2020,
12,4/25/2020,0,23,23,6,4,2020,
13,4/25/2020,0,20,20,6,4,2020,
14,4/25/2020,4,0,4,6,4,2020,
15,4/25/2020,3,0,3,6,4,2020,
16,4/25/2020,2,0,2,6,4,2020,
17,4/25/2020,14,8,22,6,4,2020,
18,4/25/2020,2,42,44,6,4,2020,
19,4/25/2020,6,3,9,6,4,2020,
20,4/25/2020,8,0,8,6,4,2020,
21,4/25/2020,20,0,20,6,4,2020,
22,4/25/2020,27,4,31,6,4,2020,
23,4/25/2020,23,22,45,6,4,2020,
0,4/26/2020,4,0,4,7,4,2020,
1,4/26/2020,0,0,0,7,4,2020,
2,4/26/2020,3,0,3,7,4,2020,
3,4/26/2020,7,0,7,7,4,2020,
4,4/26/2020,5,0,5,7,4,2020,
5,4/26/2020,13,0,13,7,4,2020,
6,4/26/2020,33,0,33,7,4,2020,
7,4/26/2020,37,0,37,7,4,2020,
8,4/26/2020,26,58,84,7,4,2020,
9,4/26/2020,48,17,65,7,4,2020,
10,4/26/2020,32,11,43,7,4,2020,
11,4/26/2020,12,9,21,7,4,2020,
12,4/26/2020,5,71,76,7,4,2020,
13,4/26/2020,6,61,67,7,4,2020,
14,4/26/2020,7,50,57,7,4,2020,
15,4/26/2020,8,19,27,7,4,2020,
16,4/26/2020,20,0,20,7,4,2020,
17,4/26/2020,15,0,15,7,4,2020,
18,4/26/2020,11,50,61,7,4,2020,
19,4/26/2020,21,36,57,7,4,2020,
20,4/26/2020,33,0,33,7,4,2020,
21,4/26/2020,30,0,30,7,4,2020,
22,4/26/2020,44,7,51,7,4,2020,
23,4/26/2020,46,45,91,7,4,2020,
0,4/27/2020,8,39,47,1,4,2020,
1,4/27/2020,1,0,1,1,4,2020,
2,4/27/2020,0,0,0,1,4,2020,
3,4/27/2020,0,0,0,1,4,2020,
4,4/27/2020,2,0,2,1,4,2020,
5,4/27/2020,1,0,1,1,4,2020,
6,4/27/2020,12,0,12,1,4,2020,
7,4/27/2020,39,0,39,1,4,2020,
8,4/27/2020,21,88,109,1,4,2020,
9,4/27/2020,15,81,96,1,4,2020,
10,4/27/2020,2,6,8,1,4,2020,
11,4/27/2020,5,0,5,1,4,2020,
12,4/27/2020,4,23,27,1,4,2020,
13,4/27/2020,0,60,60,1,4,2020,
14,4/27/2020,4,0,4,1,4,2020,
15,4/27/2020,10,0,10,1,4,2020,
16,4/27/2020,16,0,16,1,4,2020,
17,4/27/2020,13,3,16,1,4,2020,
18,4/27/2020,12,73,85,1,4,2020,
19,4/27/2020,10,16,26,1,4,2020,
20,4/27/2020,10,0,10,1,4,2020,
21,4/27/2020,49,0,49,1,4,2020,
22,4/27/2020,26,3,29,1,4,2020,
23,4/27/2020,9,17,26,1,4,2020,
0,4/28/2020,0,18,18,2,4,2020,
1,4/28/2020,0,6,6,2,4,2020,
2,4/28/2020,1,0,1,2,4,2020,
3,4/28/2020,0,0,0,2,4,2020,
4,4/28/2020,1,0,1,2,4,2020,
5,4/28/2020,1,0,1,2,4,2020,
6,4/28/2020,17,0,17,2,4,2020,
7,4/28/2020,24,0,24,2,4,2020,
8,4/28/2020,8,51,59,2,4,2020,
9,4/28/2020,4,24,28,2,4,2020,
10,4/28/2020,11,6,17,2,4,2020,
11,4/28/2020,1,0,1,2,4,2020,
12,4/28/2020,3,16,19,2,4,2020,
13,4/28/2020,0,13,13,2,4,2020,
14,4/28/2020,6,0,6,2,4,2020,
15,4/28/2020,2,0,2,2,4,2020,
16,4/28/2020,11,0,11,2,4,2020,
17,4/28/2020,19,9,28,2,4,2020,
18,4/28/2020,4,36,40,2,4,2020,
19,4/28/2020,13,0,13,2,4,2020,
20,4/28/2020,13,0,13,2,4,2020,
21,4/28/2020,38,0,38,2,4,2020,
22,4/28/2020,33,6,39,2,4,2020,
23,4/28/2020,21,3,24,2,4,2020,
0,4/29/2020,1,0,1,3,4,2020,
1,4/29/2020,0,0,0,3,4,2020,
2,4/29/2020,0,0,0,3,4,2020,
3,4/29/2020,3,0,3,3,4,2020,
4,4/29/2020,0,0,0,3,4,2020,
5,4/29/2020,7,0,7,3,4,2020,
6,4/29/2020,20,0,20,3,4,2020,
7,4/29/2020,41,0,41,3,4,2020,
8,4/29/2020,15,0,15,3,4,2020,
9,4/29/2020,16,10,26,3,4,2020,
10,4/29/2020,12,137,149,3,4,2020,
11,4/29/2020,2,0,2,3,4,2020,
12,4/29/2020,0,91,91,3,4,2020,
13,4/29/2020,2,20,22,3,4,2020,
14,4/29/2020,1,2,3,3,4,2020,
15,4/29/2020,2,15,17,3,4,2020,
16,4/29/2020,6,0,6,3,4,2020,
17,4/29/2020,19,0,19,3,4,2020,
18,4/29/2020,4,49,53,3,4,2020,
19,4/29/2020,19,1,20,3,4,2020,
20,4/29/2020,38,10,48,3,4,2020,
21,4/29/2020,49,0,49,3,4,2020,
22,4/29/2020,44,11,55,3,4,2020,
23,4/29/2020,38,0,38,3,4,2020,
0,4/30/2020,18,0,18,4,4,2020,
1,4/30/2020,10,0,10,4,4,2020,
2,4/30/2020,5,0,5,4,4,2020,
3,4/30/2020,5,0,5,4,4,2020,
4,4/30/2020,10,0,10,4,4,2020,
5,4/30/2020,28,0,28,4,4,2020,
6,4/30/2020,48,0,48,4,4,2020,
7,4/30/2020,45,0,45,4,4,2020,
8,4/30/2020,20,6,26,4,4,2020,
9,4/30/2020,17,62,79,4,4,2020,
10,4/30/2020,21,171,192,4,4,2020,
11,4/30/2020,19,73,92,4,4,2020,
12,4/30/2020,15,36,51,4,4,2020,
13,4/30/2020,19,68,87,4,4,2020,
14,4/30/2020,17,0,17,4,4,2020,
15,4/30/2020,6,22,28,4,4,2020,
16,4/30/2020,43,2,45,4,4,2020,
17,4/30/2020,33,4,37,4,4,2020,
18,4/30/2020,5,79,84,4,4,2020,
19,4/30/2020,1,39,40,4,4,2020,
20,4/30/2020,9,7,16,4,4,2020,
21,4/30/2020,11,24,35,4,4,2020,
22,4/30/2020,7,3,10,4,4,2020,
23,4/30/2020,1,42,43,4,4,2020,
0,5/1/2020,0,6,6,5,5,2020,
1,5/1/2020,2,0,2,5,5,2020,
2,5/1/2020,5,0,5,5,5,2020,
3,5/1/2020,2,0,2,5,5,2020,
4,5/1/2020,2,0,2,5,5,2020,
5,5/1/2020,20,0,20,5,5,2020,
6,5/1/2020,60,0,60,5,5,2020,
7,5/1/2020,38,0,38,5,5,2020,
8,5/1/2020,10,0,10,5,5,2020,
9,5/1/2020,14,29,43,5,5,2020,
10,5/1/2020,43,25,68,5,5,2020,
11,5/1/2020,27,46,73,5,5,2020,
12,5/1/2020,38,0,38,5,5,2020,
13,5/1/2020,28,12,40,5,5,2020,
14,5/1/2020,32,19,51,5,5,2020,
15,5/1/2020,16,111,127,5,5,2020,
16,5/1/2020,16,0,16,5,5,2020,
17,5/1/2020,14,0,14,5,5,2020,
18,5/1/2020,8,8,16,5,5,2020,
19,5/1/2020,0,47,47,5,5,2020,
20,5/1/2020,6,39,45,5,5,2020,
21,5/1/2020,14,77,91,5,5,2020,
22,5/1/2020,19,3,22,5,5,2020,
23,5/1/2020,6,0,6,5,5,2020,
0,5/2/2020,7,0,7,6,5,2020,
1,5/2/2020,4,0,4,6,5,2020,
2,5/2/2020,1,0,1,6,5,2020,
3,5/2/2020,4,0,4,6,5,2020,
4,5/2/2020,9,0,9,6,5,2020,
5,5/2/2020,26,0,26,6,5,2020,
6,5/2/2020,60,0,60,6,5,2020,
7,5/2/2020,49,0,49,6,5,2020,
8,5/2/2020,21,0,21,6,5,2020,
9,5/2/2020,24,1,25,6,5,2020,
10,5/2/2020,27,18,45,6,5,2020,
11,5/2/2020,28,52,80,6,5,2020,
12,5/2/2020,71,0,71,6,5,2020,
13,5/2/2020,36,16,52,6,5,2020,
14,5/2/2020,11,70,81,6,5,2020,
15,5/2/2020,1,110,111,6,5,2020,
16,5/2/2020,0,44,44,6,5,2020,
17,5/2/2020,0,0,0,6,5,2020,
18,5/2/2020,1,0,1,6,5,2020,
19,5/2/2020,0,20,20,6,5,2020,
20,5/2/2020,3,10,13,6,5,2020,
21,5/2/2020,0,56,56,6,5,2020,
22,5/2/2020,0,0,0,6,5,2020,
23,5/2/2020,0,0,0,6,5,2020,
0,5/3/2020,0,0,0,7,5,2020,
1,5/3/2020,1,0,1,7,5,2020,
2,5/3/2020,5,0,5,7,5,2020,
3,5/3/2020,0,0,0,7,5,2020,
4,5/3/2020,1,0,1,7,5,2020,
5,5/3/2020,16,0,16,7,5,2020,
6,5/3/2020,71,0,71,7,5,2020,
7,5/3/2020,41,0,41,7,5,2020,
8,5/3/2020,24,20,44,7,5,2020,
9,5/3/2020,44,22,66,7,5,2020,
10,5/3/2020,32,31,63,7,5,2020,
11,5/3/2020,54,60,114,7,5,2020,
12,5/3/2020,57,0,57,7,5,2020,
13,5/3/2020,46,52,98,7,5,2020,
14,5/3/2020,17,41,58,7,5,2020,
15,5/3/2020,1,119,120,7,5,2020,
16,5/3/2020,2,18,20,7,5,2020,
17,5/3/2020,0,0,0,7,5,2020,
18,5/3/2020,5,67,72,7,5,2020,
19,5/3/2020,1,15,16,7,5,2020,
20,5/3/2020,1,55,56,7,5,2020,
21,5/3/2020,5,83,88,7,5,2020,
22,5/3/2020,15,0,15,7,5,2020,
23,5/3/2020,7,0,7,7,5,2020,
0,5/4/2020,1,0,1,1,5,2020,
1,5/4/2020,1,0,1,1,5,2020,
2,5/4/2020,6,0,6,1,5,2020,
3,5/4/2020,2,0,2,1,5,2020,
4,5/4/2020,8,0,8,1,5,2020,
5,5/4/2020,29,0,29,1,5,2020,
6,5/4/2020,47,0,47,1,5,2020,
7,5/4/2020,34,0,34,1,5,2020,
8,5/4/2020,21,1,22,1,5,2020,
9,5/4/2020,49,49,98,1,5,2020,
10,5/4/2020,32,32,64,1,5,2020,
11,5/4/2020,28,47,75,1,5,2020,
12,5/4/2020,47,0,47,1,5,2020,
13,5/4/2020,28,34,62,1,5,2020,
14,5/4/2020,27,29,56,1,5,2020,
15,5/4/2020,3,96,99,1,5,2020,
16,5/4/2020,0,32,32,1,5,2020,
17,5/4/2020,0,0,0,1,5,2020,
18,5/4/2020,0,27,27,1,5,2020,
19,5/4/2020,4,54,58,1,5,2020,
20,5/4/2020,4,16,20,1,5,2020,
21,5/4/2020,8,97,105,1,5,2020,
22,5/4/2020,5,6,11,1,5,2020,
23,5/4/2020,8,0,8,1,5,2020,
0,5/5/2020,2,0,2,2,5,2020,
1,5/5/2020,0,0,0,2,5,2020,
2,5/5/2020,5,0,5,2,5,2020,
3,5/5/2020,0,0,0,2,5,2020,
4,5/5/2020,17,0,17,2,5,2020,
5,5/5/2020,24,0,24,2,5,2020,
6,5/5/2020,48,0,48,2,5,2020,
7,5/5/2020,40,0,40,2,5,2020,
8,5/5/2020,10,10,20,2,5,2020,
9,5/5/2020,19,23,42,2,5,2020,
10,5/5/2020,36,18,54,2,5,2020,
11,5/5/2020,49,33,82,2,5,2020,
12,5/5/2020,79,0,79,2,5,2020,
13,5/5/2020,54,60,114,2,5,2020,
14,5/5/2020,16,13,29,2,5,2020,
15,5/5/2020,3,94,97,2,5,2020,
16,5/5/2020,1,5,6,2,5,2020,
17,5/5/2020,3,0,3,2,5,2020,
18,5/5/2020,2,12,14,2,5,2020,
19,5/5/2020,0,3,3,2,5,2020,
20,5/5/2020,0,12,12,2,5,2020,
21,5/5/2020,2,120,122,2,5,2020,
22,5/5/2020,0,0,0,2,5,2020,
23,5/5/2020,0,0,0,2,5,2020,
0,5/6/2020,2,0,2,3,5,2020,
1,5/6/2020,0,0,0,3,5,2020,
2,5/6/2020,0,0,0,3,5,2020,
3,5/6/2020,2,0,2,3,5,2020,
4,5/6/2020,0,0,0,3,5,2020,
5,5/6/2020,22,0,22,3,5,2020,
6,5/6/2020,50,0,50,3,5,2020,
7,5/6/2020,59,0,59,3,5,2020,
8,5/6/2020,7,1,8,3,5,2020,
9,5/6/2020,37,42,79,3,5,2020,
10,5/6/2020,50,12,62,3,5,2020,
11,5/6/2020,44,45,89,3,5,2020,
12,5/6/2020,61,0,61,3,5,2020,
13,5/6/2020,47,18,65,3,5,2020,
14,5/6/2020,17,36,53,3,5,2020,
15,5/6/2020,2,113,115,3,5,2020,
16,5/6/2020,0,0,0,3,5,2020,
17,5/6/2020,1,0,1,3,5,2020,
18,5/6/2020,0,0,0,3,5,2020,
19,5/6/2020,0,32,32,3,5,2020,
20,5/6/2020,0,30,30,3,5,2020,
21,5/6/2020,1,45,46,3,5,2020,
22,5/6/2020,3,0,3,3,5,2020,
23,5/6/2020,3,0,3,3,5,2020,
0,5/7/2020,3,0,3,4,5,2020,
1,5/7/2020,3,0,3,4,5,2020,
2,5/7/2020,0,0,0,4,5,2020,
3,5/7/2020,3,0,3,4,5,2020,
4,5/7/2020,9,0,9,4,5,2020,
5,5/7/2020,37,0,37,4,5,2020,
6,5/7/2020,63,0,63,4,5,2020,
7,5/7/2020,29,0,29,4,5,2020,
8,5/7/2020,23,0,23,4,5,2020,
9,5/7/2020,48,0,48,4,5,2020,
10,5/7/2020,79,61,140,4,5,2020,
11,5/7/2020,52,33,85,4,5,2020,
12,5/7/2020,94,1,95,4,5,2020,
13,5/7/2020,68,37,105,4,5,2020,
14,5/7/2020,30,32,62,4,5,2020,
15,5/7/2020,4,107,111,4,5,2020,
16,5/7/2020,0,20,20,4,5,2020,
17,5/7/2020,0,0,0,4,5,2020,
18,5/7/2020,0,46,46,4,5,2020,
19,5/7/2020,1,16,17,4,5,2020,
20,5/7/2020,7,31,38,4,5,2020,
21,5/7/2020,11,73,84,4,5,2020,
22,5/7/2020,5,0,5,4,5,2020,
23,5/7/2020,0,0,0,4,5,2020,
0,5/8/2020,0,0,0,5,5,2020,
1,5/8/2020,8,0,8,5,5,2020,
2,5/8/2020,7,0,7,5,5,2020,
3,5/8/2020,7,0,7,5,5,2020,
4,5/8/2020,16,0,16,5,5,2020,
5,5/8/2020,45,0,45,5,5,2020,
6,5/8/2020,94,0,94,5,5,2020,
7,5/8/2020,71,0,71,5,5,2020,
8,5/8/2020,34,0,34,5,5,2020,
9,5/8/2020,66,0,66,5,5,2020,
10,5/8/2020,69,69,138,5,5,2020,
11,5/8/2020,47,52,99,5,5,2020,
12,5/8/2020,58,0,58,5,5,2020,
13,5/8/2020,52,28,80,5,5,2020,
14,5/8/2020,32,26,58,5,5,2020,
15,5/8/2020,1,134,135,5,5,2020,
16,5/8/2020,1,0,1,5,5,2020,
17,5/8/2020,1,0,1,5,5,2020,
18,5/8/2020,2,43,45,5,5,2020,
19,5/8/2020,1,25,26,5,5,2020,
20,5/8/2020,9,47,56,5,5,2020,
21,5/8/2020,7,69,76,5,5,2020,
22,5/8/2020,12,0,12,5,5,2020,
23,5/8/2020,1,0,1,5,5,2020,
0,5/9/2020,7,0,7,6,5,2020,
1,5/9/2020,2,0,2,6,5,2020,
2,5/9/2020,2,0,2,6,5,2020,
3,5/9/2020,7,0,7,6,5,2020,
4,5/9/2020,10,0,10,6,5,2020,
5,5/9/2020,28,0,28,6,5,2020,
6,5/9/2020,84,0,84,6,5,2020,
7,5/9/2020,75,0,75,6,5,2020,
8,5/9/2020,21,0,21,6,5,2020,
9,5/9/2020,34,40,74,6,5,2020,
10,5/9/2020,52,45,97,6,5,2020,
11,5/9/2020,58,21,79,6,5,2020,
12,5/9/2020,77,26,103,6,5,2020,
13,5/9/2020,60,59,119,6,5,2020,
14,5/9/2020,14,35,49,6,5,2020,
15,5/9/2020,0,101,101,6,5,2020,
16,5/9/2020,0,28,28,6,5,2020,
17,5/9/2020,0,0,0,6,5,2020,
18,5/9/2020,0,0,0,6,5,2020,
19,5/9/2020,2,22,24,6,5,2020,
20,5/9/2020,0,51,51,6,5,2020,
21,5/9/2020,5,49,54,6,5,2020,
22,5/9/2020,1,0,1,6,5,2020,
23,5/9/2020,0,0,0,6,5,2020,
0,5/10/2020,1,0,1,7,5,2020,
1,5/10/2020,0,0,0,7,5,2020,
2,5/10/2020,1,0,1,7,5,2020,
3,5/10/2020,10,0,10,7,5,2020,
4,5/10/2020,5,0,5,7,5,2020,
5,5/10/2020,23,0,23,7,5,2020,
6,5/10/2020,85,0,85,7,5,2020,
7,5/10/2020,65,0,65,7,5,2020,
8,5/10/2020,32,0,32,7,5,2020,
9,5/10/2020,60,44,104,7,5,2020,
10,5/10/2020,68,23,91,7,5,2020,
11,5/10/2020,40,48,88,7,5,2020,
12,5/10/2020,83,9,92,7,5,2020,
13,5/10/2020,47,24,71,7,5,2020,
14,5/10/2020,12,43,55,7,5,2020,
15,5/10/2020,1,78,79,7,5,2020,
16,5/10/2020,1,6,7,7,5,2020,
17,5/10/2020,0,10,10,7,5,2020,
18,5/10/2020,0,57,57,7,5,2020,
19,5/10/2020,1,12,13,7,5,2020,
20,5/10/2020,0,78,78,7,5,2020,
21,5/10/2020,6,96,102,7,5,2020,
22,5/10/2020,6,1,7,7,5,2020,
23,5/10/2020,2,0,2,7,5,2020,
0,5/11/2020,0,0,0,1,5,2020,
1,5/11/2020,0,0,0,1,5,2020,
2,5/11/2020,0,0,0,1,5,2020,
3,5/11/2020,4,0,4,1,5,2020,
4,5/11/2020,5,0,5,1,5,2020,
5,5/11/2020,23,0,23,1,5,2020,
6,5/11/2020,84,0,84,1,5,2020,
7,5/11/2020,60,0,60,1,5,2020,
8,5/11/2020,25,0,25,1,5,2020,
9,5/11/2020,52,33,85,1,5,2020,
10,5/11/2020,44,22,66,1,5,2020,
11,5/11/2020,48,42,90,1,5,2020,
12,5/11/2020,41,0,41,1,5,2020,
13,5/11/2020,45,37,82,1,5,2020,
14,5/11/2020,22,35,57,1,5,2020,
15,5/11/2020,2,184,186,1,5,2020,
16,5/11/2020,0,3,3,1,5,2020,
17,5/11/2020,1,0,1,1,5,2020,
18,5/11/2020,0,49,49,1,5,2020,
19,5/11/2020,1,19,20,1,5,2020,
20,5/11/2020,2,24,26,1,5,2020,
21,5/11/2020,7,100,107,1,5,2020,
22,5/11/2020,4,0,4,1,5,2020,
23,5/11/2020,8,0,8,1,5,2020,
0,5/12/2020,0,0,0,2,5,2020,
1,5/12/2020,0,0,0,2,5,2020,
2,5/12/2020,0,0,0,2,5,2020,
3,5/12/2020,2,0,2,2,5,2020,
4,5/12/2020,3,0,3,2,5,2020,
5,5/12/2020,42,0,42,2,5,2020,
6,5/12/2020,69,0,69,2,5,2020,
7,5/12/2020,34,0,34,2,5,2020,
8,5/12/2020,18,0,18,2,5,2020,
9,5/12/2020,17,48,65,2,5,2020,
10,5/12/2020,26,30,56,2,5,2020,
11,5/12/2020,57,44,101,2,5,2020,
12,5/12/2020,47,0,47,2,5,2020,
13,5/12/2020,46,19,65,2,5,2020,
14,5/12/2020,24,78,102,2,5,2020,
15,5/12/2020,0,119,119,2,5,2020,
16,5/12/2020,0,0,0,2,5,2020,
17,5/12/2020,0,0,0,2,5,2020,
18,5/12/2020,0,68,68,2,5,2020,
19,5/12/2020,0,0,0,2,5,2020,
20,5/12/2020,0,37,37,2,5,2020,
21,5/12/2020,1,96,97,2,5,2020,
22,5/12/2020,4,0,4,2,5,2020,
23,5/12/2020,4,0,4,2,5,2020,
0,5/13/2020,3,0,3,3,5,2020,
1,5/13/2020,0,0,0,3,5,2020,
2,5/13/2020,1,0,1,3,5,2020,
3,5/13/2020,0,0,0,3,5,2020,
4,5/13/2020,7,0,7,3,5,2020,
5,5/13/2020,26,0,26,3,5,2020,
6,5/13/2020,48,0,48,3,5,2020,
7,5/13/2020,33,0,33,3,5,2020,
8,5/13/2020,20,0,20,3,5,2020,
9,5/13/2020,29,57,86,3,5,2020,
10,5/13/2020,38,8,46,3,5,2020,
11,5/13/2020,46,17,63,3,5,2020,
12,5/13/2020,47,1,48,3,5,2020,
13,5/13/2020,35,15,50,3,5,2020,
14,5/13/2020,22,27,49,3,5,2020,
15,5/13/2020,0,51,51,3,5,2020,
16,5/13/2020,0,33,33,3,5,2020,
17,5/13/2020,0,0,0,3,5,2020,
18,5/13/2020,0,37,37,3,5,2020,
19,5/13/2020,1,29,30,3,5,2020,
20,5/13/2020,0,80,80,3,5,2020,
21,5/13/2020,1,19,20,3,5,2020,
22,5/13/2020,1,0,1,3,5,2020,
23,5/13/2020,0,0,0,3,5,2020,
0,5/14/2020,4,0,4,4,5,2020,
1,5/14/2020,0,0,0,4,5,2020,
2,5/14/2020,0,0,0,4,5,2020,
3,5/14/2020,0,0,0,4,5,2020,
4,5/14/2020,3,0,3,4,5,2020,
5,5/14/2020,26,0,26,4,5,2020,
6,5/14/2020,83,0,83,4,5,2020,
7,5/14/2020,86,0,86,4,5,2020,
8,5/14/2020,34,0,34,4,5,2020,
9,5/14/2020,51,25,76,4,5,2020,
10,5/14/2020,54,57,111,4,5,2020,
11,5/14/2020,43,39,82,4,5,2020,
12,5/14/2020,65,0,65,4,5,2020,
13,5/14/2020,51,44,95,4,5,2020,
14,5/14/2020,18,24,42,4,5,2020,
15,5/14/2020,4,92,96,4,5,2020,
16,5/14/2020,0,55,55,4,5,2020,
17,5/14/2020,1,6,7,4,5,2020,
18,5/14/2020,1,25,26,4,5,2020,
19,5/14/2020,3,5,8,4,5,2020,
20,5/14/2020,3,82,85,4,5,2020,
21,5/14/2020,7,80,87,4,5,2020,
22,5/14/2020,10,1,11,4,5,2020,
23,5/14/2020,8,0,8,4,5,2020,
0,5/15/2020,6,0,6,5,5,2020,
1,5/15/2020,1,0,1,5,5,2020,
2,5/15/2020,15,0,15,5,5,2020,
3,5/15/2020,9,0,9,5,5,2020,
4,5/15/2020,4,0,4,5,5,2020,
5,5/15/2020,50,0,50,5,5,2020,
6,5/15/2020,131,0,131,5,5,2020,
7,5/15/2020,70,0,70,5,5,2020,
8,5/15/2020,59,0,59,5,5,2020,
9,5/15/2020,47,39,86,5,5,2020,
10,5/15/2020,70,5,75,5,5,2020,
11,5/15/2020,31,50,81,5,5,2020,
12,5/15/2020,22,22,44,5,5,2020,
13,5/15/2020,42,41,83,5,5,2020,
14,5/15/2020,26,18,44,5,5,2020,
15,5/15/2020,3,180,183,5,5,2020,
16,5/15/2020,3,10,13,5,5,2020,
17,5/15/2020,0,0,0,5,5,2020,
18,5/15/2020,1,15,16,5,5,2020,
19,5/15/2020,0,43,43,5,5,2020,
20,5/15/2020,1,40,41,5,5,2020,
21,5/15/2020,7,101,108,5,5,2020,
22,5/15/2020,3,0,3,5,5,2020,
23,5/15/2020,6,0,6,5,5,2020,
0,5/16/2020,0,0,0,6,5,2020,
1,5/16/2020,0,0,0,6,5,2020,
2,5/16/2020,1,0,1,6,5,2020,
3,5/16/2020,3,0,3,6,5,2020,
4,5/16/2020,9,0,9,6,5,2020,
5,5/16/2020,51,0,51,6,5,2020,
6,5/16/2020,89,0,89,6,5,2020,
7,5/16/2020,55,0,55,6,5,2020,
8,5/16/2020,57,0,57,6,5,2020,
9,5/16/2020,54,48,102,6,5,2020,
10,5/16/2020,63,25,88,6,5,2020,
11,5/16/2020,73,45,118,6,5,2020,
12,5/16/2020,65,0,65,6,5,2020,
13,5/16/2020,52,75,127,6,5,2020,
14,5/16/2020,15,75,90,6,5,2020,
15,5/16/2020,2,176,178,6,5,2020,
16,5/16/2020,5,1,6,6,5,2020,
17,5/16/2020,0,0,0,6,5,2020,
18,5/16/2020,0,0,0,6,5,2020,
19,5/16/2020,0,67,67,6,5,2020,
20,5/16/2020,3,99,102,6,5,2020,
21,5/16/2020,2,43,45,6,5,2020,
22,5/16/2020,0,0,0,6,5,2020,
23,5/16/2020,0,0,0,6,5,2020,
0,5/17/2020,0,0,0,7,5,2020,
1,5/17/2020,0,0,0,7,5,2020,
2,5/17/2020,1,0,1,7,5,2020,
3,5/17/2020,10,0,10,7,5,2020,
4,5/17/2020,4,0,4,7,5,2020,
5,5/17/2020,45,0,45,7,5,2020,
6,5/17/2020,93,0,93,7,5,2020,
7,5/17/2020,54,0,54,7,5,2020,
8,5/17/2020,36,18,54,7,5,2020,
9,5/17/2020,61,55,116,7,5,2020,
10,5/17/2020,68,27,95,7,5,2020,
11,5/17/2020,73,103,176,7,5,2020,
12,5/17/2020,79,1,80,7,5,2020,
13,5/17/2020,70,36,106,7,5,2020,
14,5/17/2020,39,74,113,7,5,2020,
15,5/17/2020,10,219,229,7,5,2020,
16,5/17/2020,4,16,20,7,5,2020,
17,5/17/2020,0,15,15,7,5,2020,
18,5/17/2020,0,31,31,7,5,2020,
19,5/17/2020,2,34,36,7,5,2020,
20,5/17/2020,7,114,121,7,5,2020,
21,5/17/2020,11,87,98,7,5,2020,
22,5/17/2020,7,0,7,7,5,2020,
23,5/17/2020,6,0,6,7,5,2020,
0,5/18/2020,0,0,0,1,5,2020,
1,5/18/2020,0,0,0,1,5,2020,
2,5/18/2020,0,0,0,1,5,2020,
3,5/18/2020,2,0,2,1,5,2020,
4,5/18/2020,9,0,9,1,5,2020,
5,5/18/2020,16,0,16,1,5,2020,
6,5/18/2020,74,0,74,1,5,2020,
7,5/18/2020,44,0,44,1,5,2020,
8,5/18/2020,55,0,55,1,5,2020,
9,5/18/2020,38,51,89,1,5,2020,
10,5/18/2020,70,24,94,1,5,2020,
11,5/18/2020,43,54,97,1,5,2020,
12,5/18/2020,38,0,38,1,5,2020,
13,5/18/2020,33,34,67,1,5,2020,
14,5/18/2020,19,33,52,1,5,2020,
15,5/18/2020,1,114,115,1,5,2020,
16,5/18/2020,1,0,1,1,5,2020,
17,5/18/2020,0,71,71,1,5,2020,
18,5/18/2020,3,66,69,1,5,2020,
19,5/18/2020,1,0,1,1,5,2020,
20,5/18/2020,5,83,88,1,5,2020,
21,5/18/2020,5,70,75,1,5,2020,
22,5/18/2020,5,0,5,1,5,2020,
23,5/18/2020,3,0,3,1,5,2020,
0,5/19/2020,2,0,2,2,5,2020,
1,5/19/2020,1,0,1,2,5,2020,
2,5/19/2020,4,0,4,2,5,2020,
3,5/19/2020,2,0,2,2,5,2020,
4,5/19/2020,8,0,8,2,5,2020,
5,5/19/2020,38,0,38,2,5,2020,
6,5/19/2020,46,0,46,2,5,2020,
7,5/19/2020,33,0,33,2,5,2020,
8,5/19/2020,52,0,52,2,5,2020,
9,5/19/2020,43,69,112,2,5,2020,
10,5/19/2020,37,13,50,2,5,2020,
11,5/19/2020,64,51,115,2,5,2020,
12,5/19/2020,40,0,40,2,5,2020,
13,5/19/2020,44,47,91,2,5,2020,
14,5/19/2020,20,52,72,2,5,2020,
15,5/19/2020,1,108,109,2,5,2020,
16,5/19/2020,0,0,0,2,5,2020,
17,5/19/2020,0,0,0,2,5,2020,
18,5/19/2020,0,30,30,2,5,2020,
19,5/19/2020,0,19,19,2,5,2020,
20,5/19/2020,21,27,48,2,5,2020,
21,5/19/2020,9,110,119,2,5,2020,
22,5/19/2020,10,0,10,2,5,2020,
23,5/19/2020,9,0,9,2,5,2020,
0,5/20/2020,2,0,2,3,5,2020,
1,5/20/2020,2,0,2,3,5,2020,
2,5/20/2020,0,0,0,3,5,2020,
3,5/20/2020,0,0,0,3,5,2020,
4,5/20/2020,8,0,8,3,5,2020,
5,5/20/2020,6,0,6,3,5,2020,
6,5/20/2020,39,0,39,3,5,2020,
7,5/20/2020,50,0,50,3,5,2020,
8,5/20/2020,54,0,54,3,5,2020,
9,5/20/2020,36,33,69,3,5,2020,
10,5/20/2020,59,33,92,3,5,2020,
11,5/20/2020,46,40,86,3,5,2020,
12,5/20/2020,58,0,58,3,5,2020,
13,5/20/2020,48,30,78,3,5,2020,
14,5/20/2020,37,31,68,3,5,2020,
15,5/20/2020,3,69,72,3,5,2020,
16,5/20/2020,0,25,25,3,5,2020,
17,5/20/2020,1,0,1,3,5,2020,
18,5/20/2020,0,22,22,3,5,2020,
19,5/20/2020,1,45,46,3,5,2020,
20,5/20/2020,5,7,12,3,5,2020,
21,5/20/2020,15,67,82,3,5,2020,
22,5/20/2020,15,0,15,3,5,2020,
23,5/20/2020,8,0,8,3,5,2020,
0,5/21/2020,0,0,0,4,5,2020,
1,5/21/2020,0,0,0,4,5,2020,
2,5/21/2020,1,0,1,4,5,2020,
3,5/21/2020,0,0,0,4,5,2020,
4,5/21/2020,10,0,10,4,5,2020,
5,5/21/2020,34,0,34,4,5,2020,
6,5/21/2020,86,0,86,4,5,2020,
7,5/21/2020,69,0,69,4,5,2020,
8,5/21/2020,59,0,59,4,5,2020,
9,5/21/2020,91,22,113,4,5,2020,
10,5/21/2020,57,52,109,4,5,2020,
11,5/21/2020,53,29,82,4,5,2020,
12,5/21/2020,94,0,94,4,5,2020,
13,5/21/2020,69,27,96,4,5,2020,
14,5/21/2020,32,42,74,4,5,2020,
15,5/21/2020,5,127,132,4,5,2020,
16,5/21/2020,0,37,37,4,5,2020,
17,5/21/2020,1,3,4,4,5,2020,
18,5/21/2020,7,36,43,4,5,2020,
19,5/21/2020,3,0,3,4,5,2020,
20,5/21/2020,17,61,78,4,5,2020,
21,5/21/2020,9,73,82,4,5,2020,
22,5/21/2020,14,0,14,4,5,2020,
23,5/21/2020,8,0,8,4,5,2020,
0,5/22/2020,16,0,16,5,5,2020,
1,5/22/2020,17,0,17,5,5,2020,
2,5/22/2020,17,0,17,5,5,2020,
3,5/22/2020,24,0,24,5,5,2020,
4,5/22/2020,16,0,16,5,5,2020,
5,5/22/2020,98,0,98,5,5,2020,
6,5/22/2020,122,0,122,5,5,2020,
7,5/22/2020,65,0,65,5,5,2020,
8,5/22/2020,53,0,53,5,5,2020,
9,5/22/2020,97,42,139,5,5,2020,
10,5/22/2020,90,10,100,5,5,2020,
11,5/22/2020,79,57,136,5,5,2020,
12,5/22/2020,61,21,82,5,5,2020,
13,5/22/2020,76,24,100,5,5,2020,
14,5/22/2020,65,32,97,5,5,2020,
15,5/22/2020,1,158,159,5,5,2020,
16,5/22/2020,0,31,31,5,5,2020,
17,5/22/2020,0,0,0,5,5,2020,
18,5/22/2020,0,38,38,5,5,2020,
19,5/22/2020,2,1,3,5,5,2020,
20,5/22/2020,1,30,31,5,5,2020,
21,5/22/2020,4,151,155,5,5,2020,
22,5/22/2020,23,0,23,5,5,2020,
23,5/22/2020,5,0,5,5,5,2020,
0,5/23/2020,3,0,3,6,5,2020,
1,5/23/2020,4,0,4,6,5,2020,
2,5/23/2020,10,0,10,6,5,2020,
3,5/23/2020,1,0,1,6,5,2020,
4,5/23/2020,7,0,7,6,5,2020,
5,5/23/2020,52,0,52,6,5,2020,
6,5/23/2020,84,0,84,6,5,2020,
7,5/23/2020,110,0,110,6,5,2020,
8,5/23/2020,71,0,71,6,5,2020,
9,5/23/2020,72,4,76,6,5,2020,
10,5/23/2020,51,88,139,6,5,2020,
11,5/23/2020,68,66,134,6,5,2020,
12,5/23/2020,88,2,90,6,5,2020,
13,5/23/2020,68,41,109,6,5,2020,
14,5/23/2020,58,53,111,6,5,2020,
15,5/23/2020,3,217,220,6,5,2020,
16,5/23/2020,2,2,4,6,5,2020,
17,5/23/2020,2,0,2,6,5,2020,
18,5/23/2020,0,69,69,6,5,2020,
19,5/23/2020,2,37,39,6,5,2020,
20,5/23/2020,12,38,50,6,5,2020,
21,5/23/2020,9,68,77,6,5,2020,
22,5/23/2020,11,0,11,6,5,2020,
23,5/23/2020,0,0,0,6,5,2020,
0,5/24/2020,1,0,1,7,5,2020,
1,5/24/2020,2,0,2,7,5,2020,
2,5/24/2020,1,0,1,7,5,2020,
3,5/24/2020,0,0,0,7,5,2020,
4,5/24/2020,14,0,14,7,5,2020,
5,5/24/2020,50,0,50,7,5,2020,
6,5/24/2020,104,0,104,7,5,2020,
7,5/24/2020,89,0,89,7,5,2020,
8,5/24/2020,71,0,71,7,5,2020,
9,5/24/2020,108,48,156,7,5,2020,
10,5/24/2020,94,17,111,7,5,2020,
11,5/24/2020,90,64,154,7,5,2020,
12,5/24/2020,102,35,137,7,5,2020,
13,5/24/2020,81,34,115,7,5,2020,
14,5/24/2020,58,100,158,7,5,2020,
15,5/24/2020,3,259,262,7,5,2020,
16,5/24/2020,0,42,42,7,5,2020,
17,5/24/2020,0,0,0,7,5,2020,
18,5/24/2020,12,66,78,7,5,2020,
19,5/24/2020,9,3,12,7,5,2020,
20,5/24/2020,3,41,44,7,5,2020,
21,5/24/2020,0,167,167,7,5,2020,
22,5/24/2020,6,0,6,7,5,2020,
23,5/24/2020,3,0,3,7,5,2020,
0,5/25/2020,0,0,0,1,5,2020,
1,5/25/2020,0,0,0,1,5,2020,
2,5/25/2020,4,0,4,1,5,2020,
3,5/25/2020,1,0,1,1,5,2020,
4,5/25/2020,11,0,11,1,5,2020,
5,5/25/2020,52,0,52,1,5,2020,
6,5/25/2020,87,0,87,1,5,2020,
7,5/25/2020,52,0,52,1,5,2020,
8,5/25/2020,52,0,52,1,5,2020,
9,5/25/2020,69,66,135,1,5,2020,
10,5/25/2020,78,26,104,1,5,2020,
11,5/25/2020,58,90,148,1,5,2020,
12,5/25/2020,39,30,69,1,5,2020,
13,5/25/2020,39,37,76,1,5,2020,
14,5/25/2020,20,56,76,1,5,2020,
15,5/25/2020,1,260,261,1,5,2020,
16,5/25/2020,1,26,27,1,5,2020,
17,5/25/2020,4,14,18,1,5,2020,
18,5/25/2020,2,67,69,1,5,2020,
19,5/25/2020,0,0,0,1,5,2020,
20,5/25/2020,3,93,96,1,5,2020,
21,5/25/2020,9,127,136,1,5,2020,
22,5/25/2020,19,0,19,1,5,2020,
23,5/25/2020,19,0,19,1,5,2020,
0,5/26/2020,1,0,1,2,5,2020,
1,5/26/2020,0,0,0,2,5,2020,
2,5/26/2020,1,0,1,2,5,2020,
3,5/26/2020,7,0,7,2,5,2020,
4,5/26/2020,18,0,18,2,5,2020,
5,5/26/2020,42,0,42,2,5,2020,
6,5/26/2020,67,0,67,2,5,2020,
7,5/26/2020,79,0,79,2,5,2020,
8,5/26/2020,55,0,55,2,5,2020,
9,5/26/2020,49,0,49,2,5,2020,
10,5/26/2020,61,93,154,2,5,2020,
11,5/26/2020,67,58,125,2,5,2020,
12,5/26/2020,55,67,122,2,5,2020,
13,5/26/2020,61,56,117,2,5,2020,
14,5/26/2020,18,47,65,2,5,2020,
15,5/26/2020,0,207,207,2,5,2020,
16,5/26/2020,0,0,0,2,5,2020,
17,5/26/2020,7,0,7,2,5,2020,
18,5/26/2020,0,33,33,2,5,2020,
19,5/26/2020,0,37,37,2,5,2020,
20,5/26/2020,6,54,60,2,5,2020,
21,5/26/2020,15,73,88,2,5,2020,
22,5/26/2020,5,0,5,2,5,2020,
23,5/26/2020,1,0,1,2,5,2020,
0,5/27/2020,0,0,0,3,5,2020,
1,5/27/2020,1,0,1,3,5,2020,
2,5/27/2020,1,0,1,3,5,2020,
3,5/27/2020,4,0,4,3,5,2020,
4,5/27/2020,21,0,21,3,5,2020,
5,5/27/2020,39,0,39,3,5,2020,
6,5/27/2020,64,0,64,3,5,2020,
7,5/27/2020,59,0,59,3,5,2020,
8,5/27/2020,51,0,51,3,5,2020,
9,5/27/2020,39,0,39,3,5,2020,
10,5/27/2020,51,64,115,3,5,2020,
11,5/27/2020,22,47,69,3,5,2020,
12,5/27/2020,39,3,42,3,5,2020,
13,5/27/2020,23,17,40,3,5,2020,
14,5/27/2020,37,6,43,3,5,2020,
15,5/27/2020,4,178,182,3,5,2020, 
16,5/27/2020,2,10,12,3,5,2020,
17,5/27/2020,0,10,10,3,5,2020,
18,5/27/2020,1,33,34,3,5,2020,
19,5/27/2020,0,70,70,3,5,2020,
20,5/27/2020,4,40,44,3,5,2020,
21,5/27/2020,7,11,18,3,5,2020,
22,5/27/2020,10,0,10,3,5,2020,
23,5/27/2020,14,0,14,3,5,2020,
0,5/28/2020,1,0,1,4,5,2020,
1,5/28/2020,0,0,0,4,5,2020,
2,5/28/2020,1,0,1,4,5,2020,
3,5/28/2020,3,0,3,4,5,2020,
4,5/28/2020,9,0,9,4,5,2020,
5,5/28/2020,78,0,78,4,5,2020,
6,5/28/2020,121,0,121,4,5,2020,
7,5/28/2020,64,0,64,4,5,2020,
8,5/28/2020,100,0,100,4,5,2020,
9,5/28/2020,69,37,106,4,5,2020,
10,5/28/2020,73,29,102,4,5,2020,
11,5/28/2020,75,34,109,4,5,2020,
12,5/28/2020,75,58,133,4,5,2020,
13,5/28/2020,52,47,99,4,5,2020,
14,5/28/2020,46,33,79,4,5,2020,
15,5/28/2020,1,126,127,4,5,2020,
16,5/28/2020,1,63,64,4,5,2020,
17,5/28/2020,2,19,21,4,5,2020,
18,5/28/2020,0,24,24,4,5,2020,
19,5/28/2020,0,21,21,4,5,2020,
20,5/28/2020,8,11,19,4,5,2020,
21,5/28/2020,7,116,123,4,5,2020,
22,5/28/2020,28,0,28,4,5,2020,
23,5/28/2020,6,0,6,4,5,2020,
0,5/29/2020,13,0,13,5,5,2020,
1,5/29/2020,16,0,16,5,5,2020,
2,5/29/2020,17,0,17,5,5,2020,
3,5/29/2020,16,0,16,5,5,2020,
4,5/29/2020,12,0,12,5,5,2020,
5,5/29/2020,60,0,60,5,5,2020,
6,5/29/2020,122,0,122,5,5,2020,
7,5/29/2020,68,0,68,5,5,2020,
8,5/29/2020,59,0,59,5,5,2020,
9,5/29/2020,56,28,84,5,5,2020,
10,5/29/2020,101,9,110,5,5,2020,
11,5/29/2020,39,70,109,5,5,2020,
12,5/29/2020,64,45,109,5,5,2020,
13,5/29/2020,47,30,77,5,5,2020,
14,5/29/2020,26,81,107,5,5,2020,
15,5/29/2020,1,117,118,5,5,2020,
16,5/29/2020,0,25,25,5,5,2020,
17,5/29/2020,0,9,9,5,5,2020,
18,5/29/2020,0,0,0,5,5,2020,
19,5/29/2020,2,85,87,5,5,2020,
20,5/29/2020,6,93,99,5,5,2020,
21,5/29/2020,12,33,45,5,5,2020,
22,5/29/2020,17,3,20,5,5,2020,
23,5/29/2020,3,0,3,5,5,2020,
0,5/30/2020,0,0,0,6,5,2020,
1,5/30/2020,0,0,0,6,5,2020,
2,5/30/2020,0,0,0,6,5,2020,
3,5/30/2020,5,0,5,6,5,2020,
4,5/30/2020,15,0,15,6,5,2020,
5,5/30/2020,41,0,41,6,5,2020,
6,5/30/2020,139,0,139,6,5,2020,
7,5/30/2020,135,0,135,6,5,2020,
8,5/30/2020,103,0,103,6,5,2020,
9,5/30/2020,96,54,150,6,5,2020,
10,5/30/2020,91,14,105,6,5,2020,
11,5/30/2020,55,58,113,6,5,2020,
12,5/30/2020,82,65,147,6,5,2020,
13,5/30/2020,70,32,102,6,5,2020,
14,5/30/2020,35,95,130,6,5,2020,
15,5/30/2020,2,192,194,6,5,2020,
16,5/30/2020,0,74,74,6,5,2020,
17,5/30/2020,2,0,2,6,5,2020,
18,5/30/2020,0,29,29,6,5,2020,
19,5/30/2020,3,77,80,6,5,2020,
20,5/30/2020,3,26,29,6,5,2020,
21,5/30/2020,11,52,63,6,5,2020,
22,5/30/2020,4,0,4,6,5,2020,
23,5/30/2020,3,0,3,6,5,2020,
0,5/31/2020,0,0,0,7,5,2020,
1,5/31/2020,0,0,0,7,5,2020,
2,5/31/2020,0,0,0,7,5,2020,
3,5/31/2020,1,0,1,7,5,2020,
4,5/31/2020,10,0,10,7,5,2020,
5,5/31/2020,57,0,57,7,5,2020,
6,5/31/2020,115,0,115,7,5,2020,
7,5/31/2020,56,0,56,7,5,2020,
8,5/31/2020,64,0,64,7,5,2020,
9,5/31/2020,87,59,146,7,5,2020,
10,5/31/2020,100,10,110,7,5,2020,
11,5/31/2020,73,67,140,7,5,2020,
12,5/31/2020,64,74,138,7,5,2020,
13,5/31/2020,66,57,123,7,5,2020,
14,5/31/2020,44,102,146,7,5,2020,
15,5/31/2020,1,200,201,7,5,2020,
16,5/31/2020,0,15,15,7,5,2020,
17,5/31/2020,7,0,7,7,5,2020,
18,5/31/2020,1,55,56,7,5,2020,
19,5/31/2020,11,114,125,7,5,2020,
20,5/31/2020,21,111,132,7,5,2020,
21,5/31/2020,13,74,87,7,5,2020,
22,5/31/2020,30,50,80,7,5,2020,
23,5/31/2020,22,4,26,7,5,2020,
0,6/1/2020,18,0,18,1,6,2020,
1,6/1/2020,17,0,17,1,6,2020,
2,6/1/2020,17,0,17,1,6,2020,
3,6/1/2020,18,0,18,1,6,2020,
4,6/1/2020,40,0,40,1,6,2020,
5,6/1/2020,110,0,110,1,6,2020,
6,6/1/2020,123,0,123,1,6,2020,
7,6/1/2020,88,0,88,1,6,2020,
8,6/1/2020,73,100,173,1,6,2020,
9,6/1/2020,115,40,155,1,6,2020,
10,6/1/2020,97,3,100,1,6,2020,
11,6/1/2020,83,98,181,1,6,2020,
12,6/1/2020,79,122,201,1,6,2020,
13,6/1/2020,65,48,113,1,6,2020,
14,6/1/2020,80,84,164,1,6,2020,
15,6/1/2020,26,213,239,1,6,2020,
16,6/1/2020,6,85,91,1,6,2020,
17,6/1/2020,1,0,1,1,6,2020,
18,6/1/2020,4,36,40,1,6,2020,
19,6/1/2020,12,59,71,1,6,2020,
20,6/1/2020,30,112,142,1,6,2020,
21,6/1/2020,23,128,151,1,6,2020,
22,6/1/2020,24,35,59,1,6,2020,
23,6/1/2020,6,1,7,1,6,2020,
0,6/2/2020,4,0,4,2,6,20202,
1,6/2/2020,5,0,5,2,6,20202,
2,6/2/2020,51,0,51,2,6,20202,
3,6/2/2020,24,0,24,2,6,20202,
4,6/2/2020,41,0,41,2,6,20202,
5,6/2/2020,123,0,123,2,6,20202,
6,6/2/2020,113,0,113,2,6,20202,
7,6/2/2020,80,0,80,2,6,20202,
8,6/2/2020,60,32,92,2,6,20202,
9,6/2/2020,64,47,111,2,6,20202,
10,6/2/2020,102,0,102,2,6,20202,
11,6/2/2020,77,90,167,2,6,20202,
12,6/2/2020,97,75,172,2,6,20202,
13,6/2/2020,87,40,127,2,6,20202,
14,6/2/2020,19,106,125,2,6,20202,
15,6/2/2020,8,138,146,2,6,20202,
16,6/2/2020,13,73,86,2,6,20202,
17,6/2/2020,6,0,6,2,6,20202,
18,6/2/2020,8,30,38,2,6,20202,
19,6/2/2020,14,84,98,2,6,20202,
20,6/2/2020,26,65,91,2,6,20202,
21,6/2/2020,40,95,135,2,6,20202,
22,6/2/2020,14,28,42,2,6,20202,
23,6/2/2020,3,30,33,2,6,20202,
