Time,Date,SB,NB,Total,Day,Month,Year,
0,1/1/2019,32,85,117,2,1,2019,
1,1/1/2019,30,47,77,2,1,2019,
2,1/1/2019,45,0,45,2,1,2019,
3,1/1/2019,65,0,65,2,1,2019,
4,1/1/2019,99,1,100,2,1,2019,
5,1/1/2019,153,0,153,2,1,2019,
6,1/1/2019,272,37,309,2,1,2019,
7,1/1/2019,328,134,462,2,1,2019,
8,1/1/2019,178,468,646,2,1,2019,
9,1/1/2019,225,354,579,2,1,2019,
10,1/1/2019,295,226,521,2,1,2019,
11,1/1/2019,306,279,585,2,1,2019,
12,1/1/2019,280,399,679,2,1,2019,
13,1/1/2019,287,523,810,2,1,2019,
14,1/1/2019,247,163,410,2,1,2019,
15,1/1/2019,286,270,556,2,1,2019,
16,1/1/2019,190,539,729,2,1,2019,
17,1/1/2019,144,490,634,2,1,2019,
18,1/1/2019,67,365,432,2,1,2019,
19,1/1/2019,73,225,298,2,1,2019,
20,1/1/2019,217,278,495,2,1,2019,
21,1/1/2019,294,312,606,2,1,2019,
22,1/1/2019,361,521,882,2,1,2019,
23,1/1/2019,317,377,694,2,1,2019,
0,1/2/2019,183,411,594,3,1,2019,
1,1/2/2019,15,273,288,3,1,2019,
2,1/2/2019,49,5,54,3,1,2019,
3,1/2/2019,94,0,94,3,1,2019,
4,1/2/2019,86,0,86,3,1,2019,
5,1/2/2019,210,0,210,3,1,2019,
6,1/2/2019,340,29,369,3,1,2019,
7,1/2/2019,215,203,418,3,1,2019,
8,1/2/2019,166,588,754,3,1,2019,
9,1/2/2019,200,121,321,3,1,2019,
10,1/2/2019,317,191,508,3,1,2019,
11,1/2/2019,341,290,631,3,1,2019,
12,1/2/2019,319,453,772,3,1,2019,
13,1/2/2019,307,173,480,3,1,2019,
14,1/2/2019,298,359,657,3,1,2019,
15,1/2/2019,313,624,937,3,1,2019,
16,1/2/2019,299,265,564,3,1,2019,
17,1/2/2019,316,285,601,3,1,2019,
18,1/2/2019,175,493,668,3,1,2019,
19,1/2/2019,78,374,452,3,1,2019,
20,1/2/2019,196,181,377,3,1,2019,
21,1/2/2019,343,223,566,3,1,2019,
22,1/2/2019,382,348,730,3,1,2019,
23,1/2/2019,435,556,991,3,1,2019,
0,1/3/2019,209,228,437,4,1,2019,
1,1/3/2019,58,314,372,4,1,2019,
2,1/3/2019,65,112,177,4,1,2019,
3,1/3/2019,105,166,271,4,1,2019,
4,1/3/2019,78,25,103,4,1,2019,
5,1/3/2019,195,10,205,4,1,2019,
6,1/3/2019,372,35,407,4,1,2019,
7,1/3/2019,438,222,660,4,1,2019,
8,1/3/2019,186,719,905,4,1,2019,
9,1/3/2019,222,255,477,4,1,2019,
10,1/3/2019,246,486,732,4,1,2019,
11,1/3/2019,314,360,674,4,1,2019,
12,1/3/2019,248,131,379,4,1,2019,
13,1/3/2019,274,337,611,4,1,2019,
14,1/3/2019,394,143,537,4,1,2019,
15,1/3/2019,306,354,660,4,1,2019,
16,1/3/2019,294,247,541,4,1,2019,
17,1/3/2019,270,530,800,4,1,2019,
18,1/3/2019,109,306,415,4,1,2019,
19,1/3/2019,129,529,658,4,1,2019,
20,1/3/2019,263,174,437,4,1,2019,
21,1/3/2019,408,303,711,4,1,2019,
22,1/3/2019,433,320,753,4,1,2019,
23,1/3/2019,346,186,532,4,1,2019,
0,1/4/2019,213,322,535,5,1,2019,
1,1/4/2019,85,574,659,5,1,2019,
2,1/4/2019,53,146,199,5,1,2019,
3,1/4/2019,76,327,403,5,1,2019,
4,1/4/2019,143,4,147,5,1,2019,
5,1/4/2019,235,68,303,5,1,2019,
6,1/4/2019,404,37,441,5,1,2019,
7,1/4/2019,301,316,617,5,1,2019,
8,1/4/2019,236,695,931,5,1,2019,
9,1/4/2019,246,420,666,5,1,2019,
10,1/4/2019,348,298,646,5,1,2019,
11,1/4/2019,389,518,907,5,1,2019,
12,1/4/2019,324,310,634,5,1,2019,
13,1/4/2019,296,398,694,5,1,2019,
14,1/4/2019,273,375,648,5,1,2019,
15,1/4/2019,374,427,801,5,1,2019,
16,1/4/2019,353,454,807,5,1,2019,
17,1/4/2019,218,278,496,5,1,2019,
18,1/4/2019,102,362,464,5,1,2019,
19,1/4/2019,105,360,465,5,1,2019,
20,1/4/2019,236,326,562,5,1,2019,
21,1/4/2019,391,477,868,5,1,2019,
22,1/4/2019,374,178,552,5,1,2019,
23,1/4/2019,349,693,1042,5,1,2019,
0,1/5/2019,228,316,544,6,1,2019,
1,1/5/2019,35,353,388,6,1,2019,
2,1/5/2019,71,197,268,6,1,2019,
3,1/5/2019,131,4,135,6,1,2019,
4,1/5/2019,139,0,139,6,1,2019,
5,1/5/2019,211,0,211,6,1,2019,
6,1/5/2019,446,161,607,6,1,2019,
7,1/5/2019,410,225,635,6,1,2019,
8,1/5/2019,304,707,1011,6,1,2019,
9,1/5/2019,216,551,767,6,1,2019,
10,1/5/2019,269,246,515,6,1,2019,
11,1/5/2019,301,392,693,6,1,2019,
12,1/5/2019,227,452,679,6,1,2019,
13,1/5/2019,262,729,991,6,1,2019,
14,1/5/2019,337,195,532,6,1,2019,
15,1/5/2019,316,407,723,6,1,2019,
16,1/5/2019,337,367,704,6,1,2019,
17,1/5/2019,361,619,980,6,1,2019,
18,1/5/2019,117,405,522,6,1,2019,
19,1/5/2019,93,697,790,6,1,2019,
20,1/5/2019,254,371,625,6,1,2019,
21,1/5/2019,483,310,793,6,1,2019,
22,1/5/2019,327,401,728,6,1,2019,
23,1/5/2019,322,559,881,6,1,2019,
0,1/6/2019,98,591,689,7,1,2019,
1,1/6/2019,28,404,432,7,1,2019,
2,1/6/2019,54,67,121,7,1,2019,
3,1/6/2019,86,35,121,7,1,2019,
4,1/6/2019,104,29,133,7,1,2019,
5,1/6/2019,144,0,144,7,1,2019,
6,1/6/2019,314,27,341,7,1,2019,
7,1/6/2019,289,375,664,7,1,2019,
8,1/6/2019,221,547,768,7,1,2019,
9,1/6/2019,124,487,611,7,1,2019,
10,1/6/2019,211,329,540,7,1,2019,
11,1/6/2019,292,418,710,7,1,2019,
12,1/6/2019,261,285,546,7,1,2019,
13,1/6/2019,370,781,1151,7,1,2019,
14,1/6/2019,288,266,554,7,1,2019,
15,1/6/2019,292,509,801,7,1,2019,
16,1/6/2019,340,425,765,7,1,2019,
17,1/6/2019,206,357,563,7,1,2019,
18,1/6/2019,88,379,467,7,1,2019,
19,1/6/2019,111,508,619,7,1,2019,
20,1/6/2019,215,373,588,7,1,2019,
21,1/6/2019,309,544,853,7,1,2019,
22,1/6/2019,366,316,682,7,1,2019,
23,1/6/2019,152,662,814,7,1,2019,
0,1/7/2019,55,630,685,1,1,2019,
1,1/7/2019,30,259,289,1,1,2019,
2,1/7/2019,19,67,86,1,1,2019,
3,1/7/2019,67,0,67,1,1,2019,
4,1/7/2019,86,0,86,1,1,2019,
5,1/7/2019,141,0,141,1,1,2019,
6,1/7/2019,215,136,351,1,1,2019,
7,1/7/2019,267,318,585,1,1,2019,
8,1/7/2019,194,608,802,1,1,2019,
9,1/7/2019,211,562,773,1,1,2019,
10,1/7/2019,207,307,514,1,1,2019,
11,1/7/2019,214,481,695,1,1,2019,
12,1/7/2019,175,242,417,1,1,2019,
13,1/7/2019,249,405,654,1,1,2019,
14,1/7/2019,186,197,383,1,1,2019,
15,1/7/2019,233,421,654,1,1,2019,
16,1/7/2019,227,186,413,1,1,2019,
17,1/7/2019,152,617,769,1,1,2019,
18,1/7/2019,54,582,636,1,1,2019,
19,1/7/2019,96,652,748,1,1,2019,
20,1/7/2019,165,303,468,1,1,2019,
21,1/7/2019,222,283,505,1,1,2019,
22,1/7/2019,273,275,548,1,1,2019,
23,1/7/2019,167,465,632,1,1,2019,
0,1/8/2019,71,412,483,2,1,2019,
1,1/8/2019,20,263,283,2,1,2019,
2,1/8/2019,57,9,66,2,1,2019,
3,1/8/2019,91,0,91,2,1,2019,
4,1/8/2019,72,0,72,2,1,2019,
5,1/8/2019,115,0,115,2,1,2019,
6,1/8/2019,235,51,286,2,1,2019,
7,1/8/2019,180,307,487,2,1,2019,
8,1/8/2019,163,398,561,2,1,2019,
9,1/8/2019,136,625,761,2,1,2019,
10,1/8/2019,178,250,428,2,1,2019,
11,1/8/2019,186,332,518,2,1,2019,
12,1/8/2019,109,424,533,2,1,2019,
13,1/8/2019,183,448,631,2,1,2019,
14,1/8/2019,165,105,270,2,1,2019,
15,1/8/2019,133,432,565,2,1,2019,
16,1/8/2019,88,299,387,2,1,2019,
17,1/8/2019,123,362,485,2,1,2019,
18,1/8/2019,32,301,333,2,1,2019,
19,1/8/2019,61,332,393,2,1,2019,
20,1/8/2019,109,232,341,2,1,2019,
21,1/8/2019,227,412,639,2,1,2019,
22,1/8/2019,233,330,563,2,1,2019,
23,1/8/2019,143,348,491,2,1,2019,
0,1/9/2019,35,225,260,3,1,2019,
1,1/9/2019,7,77,84,3,1,2019,
2,1/9/2019,26,0,26,3,1,2019,
3,1/9/2019,46,1,47,3,1,2019,
4,1/9/2019,50,0,50,3,1,2019,
5,1/9/2019,159,0,159,3,1,2019,
6,1/9/2019,175,97,272,3,1,2019,
7,1/9/2019,158,217,375,3,1,2019,
8,1/9/2019,82,569,651,3,1,2019,
9,1/9/2019,111,403,514,3,1,2019,
10,1/9/2019,125,131,256,3,1,2019,
11,1/9/2019,96,363,459,3,1,2019,
12,1/9/2019,126,326,452,3,1,2019,
13,1/9/2019,98,283,381,3,1,2019,
14,1/9/2019,180,119,299,3,1,2019,
15,1/9/2019,119,141,260,3,1,2019,
16,1/9/2019,67,193,260,3,1,2019,
17,1/9/2019,87,305,392,3,1,2019,
18,1/9/2019,16,429,445,3,1,2019,
19,1/9/2019,59,348,407,3,1,2019,
20,1/9/2019,114,188,302,3,1,2019,
21,1/9/2019,257,227,484,3,1,2019,
22,1/9/2019,265,278,543,3,1,2019,
23,1/9/2019,178,402,580,3,1,2019,
0,1/10/2019,103,249,352,4,1,2019,
1,1/10/2019,27,19,46,4,1,2019,
2,1/10/2019,13,0,13,4,1,2019,
3,1/10/2019,74,1,75,4,1,2019,
4,1/10/2019,70,0,70,4,1,2019,
5,1/10/2019,167,0,167,4,1,2019,
6,1/10/2019,239,67,306,4,1,2019,
7,1/10/2019,287,269,556,4,1,2019,
8,1/10/2019,131,432,563,4,1,2019,
9,1/10/2019,123,423,546,4,1,2019,
10,1/10/2019,185,170,355,4,1,2019,
11,1/10/2019,167,254,421,4,1,2019,
12,1/10/2019,81,307,388,4,1,2019,
13,1/10/2019,121,335,456,4,1,2019,
14,1/10/2019,117,209,326,4,1,2019,
15,1/10/2019,75,238,313,4,1,2019,
16,1/10/2019,105,212,317,4,1,2019,
17,1/10/2019,105,197,302,4,1,2019,
18,1/10/2019,26,251,277,4,1,2019,
19,1/10/2019,35,213,248,4,1,2019,
20,1/10/2019,153,292,445,4,1,2019,
21,1/10/2019,302,292,594,4,1,2019,
22,1/10/2019,277,146,423,4,1,2019,
23,1/10/2019,194,207,401,4,1,2019,
0,1/11/2019,129,257,386,5,1,2019,
1,1/11/2019,52,0,52,5,1,2019,
2,1/11/2019,25,0,25,5,1,2019,
3,1/11/2019,58,0,58,5,1,2019,
4,1/11/2019,82,0,82,5,1,2019,
5,1/11/2019,197,0,197,5,1,2019,
6,1/11/2019,279,17,296,5,1,2019,
7,1/11/2019,255,362,617,5,1,2019,
8,1/11/2019,95,518,613,5,1,2019,
9,1/11/2019,127,465,592,5,1,2019,
10,1/11/2019,168,253,421,5,1,2019,
11,1/11/2019,160,223,383,5,1,2019,
12,1/11/2019,111,179,290,5,1,2019,
13,1/11/2019,86,309,395,5,1,2019,
14,1/11/2019,96,175,271,5,1,2019,
15,1/11/2019,72,272,344,5,1,2019,
16,1/11/2019,82,217,299,5,1,2019,
17,1/11/2019,99,147,246,5,1,2019,
18,1/11/2019,45,285,330,5,1,2019,
19,1/11/2019,39,248,287,5,1,2019,
20,1/11/2019,124,217,341,5,1,2019,
21,1/11/2019,311,271,582,5,1,2019,
22,1/11/2019,249,272,521,5,1,2019,
23,1/11/2019,247,343,590,5,1,2019,
0,1/12/2019,192,260,452,6,1,2019,
1,1/12/2019,46,75,121,6,1,2019,
2,1/12/2019,28,40,68,6,1,2019,
3,1/12/2019,56,0,56,6,1,2019,
4,1/12/2019,53,0,53,6,1,2019,
5,1/12/2019,102,1,103,6,1,2019,
6,1/12/2019,258,38,296,6,1,2019,
7,1/12/2019,281,253,534,6,1,2019,
8,1/12/2019,167,492,659,6,1,2019,
9,1/12/2019,175,508,683,6,1,2019,
10,1/12/2019,158,293,451,6,1,2019,
11,1/12/2019,109,296,405,6,1,2019,
12,1/12/2019,84,337,421,6,1,2019,
13,1/12/2019,125,271,396,6,1,2019,
14,1/12/2019,130,141,271,6,1,2019,
15,1/12/2019,98,188,286,6,1,2019,
16,1/12/2019,140,502,642,6,1,2019,
17,1/12/2019,59,288,347,6,1,2019,
18,1/12/2019,26,372,398,6,1,2019,
19,1/12/2019,55,497,552,6,1,2019,
20,1/12/2019,122,62,184,6,1,2019,
21,1/12/2019,167,333,500,6,1,2019,
22,1/12/2019,204,174,378,6,1,2019,
23,1/12/2019,92,345,437,6,1,2019,
0,1/13/2019,39,191,230,7,1,2019,
1,1/13/2019,14,0,14,7,1,2019,
2,1/13/2019,21,0,21,7,1,2019,
3,1/13/2019,83,0,83,7,1,2019,
4,1/13/2019,86,0,86,7,1,2019,
5,1/13/2019,121,0,121,7,1,2019,
6,1/13/2019,224,112,336,7,1,2019,
7,1/13/2019,194,366,560,7,1,2019,
8,1/13/2019,87,536,623,7,1,2019,
9,1/13/2019,76,375,451,7,1,2019,
10,1/13/2019,156,104,260,7,1,2019,
11,1/13/2019,219,203,422,7,1,2019,
12,1/13/2019,177,291,468,7,1,2019,
13,1/13/2019,204,567,771,7,1,2019,
14,1/13/2019,143,104,247,7,1,2019,
15,1/13/2019,109,455,564,7,1,2019,
16,1/13/2019,176,269,445,7,1,2019,
17,1/13/2019,145,208,353,7,1,2019,
18,1/13/2019,70,339,409,7,1,2019,
19,1/13/2019,64,324,388,7,1,2019,
20,1/13/2019,136,300,436,7,1,2019,
21,1/13/2019,142,226,368,7,1,2019,
22,1/13/2019,174,294,468,7,1,2019,
23,1/13/2019,114,465,579,7,1,2019,
0,1/14/2019,43,218,261,1,1,2019,
1,1/14/2019,14,3,17,1,1,2019,
2,1/14/2019,18,0,18,1,1,2019,
3,1/14/2019,26,0,26,1,1,2019,
4,1/14/2019,24,0,24,1,1,2019,
5,1/14/2019,70,0,70,1,1,2019,
6,1/14/2019,138,49,187,1,1,2019,
7,1/14/2019,144,254,398,1,1,2019,
8,1/14/2019,82,527,609,1,1,2019,
9,1/14/2019,64,347,411,1,1,2019,
10,1/14/2019,95,115,210,1,1,2019,
11,1/14/2019,184,199,383,1,1,2019,
12,1/14/2019,117,171,288,1,1,2019,
13,1/14/2019,75,221,296,1,1,2019,
14,1/14/2019,62,94,156,1,1,2019,
15,1/14/2019,75,106,181,1,1,2019,
16,1/14/2019,122,132,254,1,1,2019,
17,1/14/2019,106,363,469,1,1,2019,
18,1/14/2019,27,337,364,1,1,2019,
19,1/14/2019,48,359,407,1,1,2019,
20,1/14/2019,98,207,305,1,1,2019,
21,1/14/2019,111,249,360,1,1,2019,
22,1/14/2019,124,197,321,1,1,2019,
23,1/14/2019,64,265,329,1,1,2019,
0,1/15/2019,19,162,181,2,1,2019,
1,1/15/2019,8,87,95,2,1,2019,
2,1/15/2019,26,0,26,2,1,2019,
3,1/15/2019,43,0,43,2,1,2019,
4,1/15/2019,58,0,58,2,1,2019,
5,1/15/2019,73,0,73,2,1,2019,
6,1/15/2019,138,74,212,2,1,2019,
7,1/15/2019,162,132,294,2,1,2019,
8,1/15/2019,75,471,546,2,1,2019,
9,1/15/2019,89,348,437,2,1,2019,
10,1/15/2019,112,133,245,2,1,2019,
11,1/15/2019,130,222,352,2,1,2019,
12,1/15/2019,59,227,286,2,1,2019,
13,1/15/2019,94,365,459,2,1,2019,
14,1/15/2019,70,107,177,2,1,2019,
15,1/15/2019,77,252,329,2,1,2019,
16,1/15/2019,73,205,278,2,1,2019,
17,1/15/2019,36,231,267,2,1,2019,
18,1/15/2019,26,291,317,2,1,2019,
19,1/15/2019,35,217,252,2,1,2019,
20,1/15/2019,65,62,127,2,1,2019,
21,1/15/2019,180,237,417,2,1,2019,
22,1/15/2019,270,240,510,2,1,2019,
23,1/15/2019,138,145,283,2,1,2019,
0,1/16/2019,45,186,231,3,1,2019,
1,1/16/2019,16,17,33,3,1,2019,
2,1/16/2019,4,0,4,3,1,2019,
3,1/16/2019,37,0,37,3,1,2019,
4,1/16/2019,28,0,28,3,1,2019,
5,1/16/2019,104,0,104,3,1,2019,
6,1/16/2019,187,66,253,3,1,2019,
7,1/16/2019,140,174,314,3,1,2019,
8,1/16/2019,74,422,496,3,1,2019,
9,1/16/2019,77,396,473,3,1,2019,
10,1/16/2019,96,75,171,3,1,2019,
11,1/16/2019,98,325,423,3,1,2019,
12,1/16/2019,121,105,226,3,1,2019,
13,1/16/2019,70,171,241,3,1,2019,
14,1/16/2019,60,74,134,3,1,2019,
15,1/16/2019,57,136,193,3,1,2019,
16,1/16/2019,72,230,302,3,1,2019,
17,1/16/2019,40,185,225,3,1,2019,
18,1/16/2019,27,283,310,3,1,2019,
19,1/16/2019,42,166,208,3,1,2019,
20,1/16/2019,84,94,178,3,1,2019,
21,1/16/2019,220,72,292,3,1,2019,
22,1/16/2019,296,226,522,3,1,2019,
23,1/16/2019,184,155,339,3,1,2019,
0,1/17/2019,68,106,174,4,1,2019,
1,1/17/2019,17,1,18,4,1,2019,
2,1/17/2019,17,0,17,4,1,2019,
3,1/17/2019,71,0,71,4,1,2019,
4,1/17/2019,88,0,88,4,1,2019,
5,1/17/2019,107,0,107,4,1,2019,
6,1/17/2019,237,73,310,4,1,2019,
7,1/17/2019,244,126,370,4,1,2019,
8,1/17/2019,169,364,533,4,1,2019,
9,1/17/2019,129,436,565,4,1,2019,
10,1/17/2019,181,103,284,4,1,2019,
11,1/17/2019,206,219,425,4,1,2019,
12,1/17/2019,110,231,341,4,1,2019,
13,1/17/2019,108,235,343,4,1,2019,
14,1/17/2019,120,60,180,4,1,2019,
15,1/17/2019,69,169,238,4,1,2019,
16,1/17/2019,83,175,258,4,1,2019,
17,1/17/2019,79,208,287,4,1,2019,
18,1/17/2019,42,160,202,4,1,2019,
19,1/17/2019,57,377,434,4,1,2019,
20,1/17/2019,166,120,286,4,1,2019,
21,1/17/2019,330,146,476,4,1,2019,
22,1/17/2019,316,188,504,4,1,2019,
23,1/17/2019,307,139,446,4,1,2019,
0,1/18/2019,145,164,309,5,1,2019,
1,1/18/2019,41,0,41,5,1,2019,
2,1/18/2019,39,0,39,5,1,2019,
3,1/18/2019,65,0,65,5,1,2019,
4,1/18/2019,88,0,88,5,1,2019,
5,1/18/2019,172,0,172,5,1,2019,
6,1/18/2019,374,67,441,5,1,2019,
7,1/18/2019,384,209,593,5,1,2019,
8,1/18/2019,187,262,449,5,1,2019,
9,1/18/2019,129,449,578,5,1,2019,
10,1/18/2019,196,159,355,5,1,2019,
11,1/18/2019,191,266,457,5,1,2019,
12,1/18/2019,144,192,336,5,1,2019,
13,1/18/2019,128,128,256,5,1,2019,
14,1/18/2019,131,62,193,5,1,2019,
15,1/18/2019,135,233,368,5,1,2019,
16,1/18/2019,137,236,373,5,1,2019,
17,1/18/2019,123,197,320,5,1,2019,
18,1/18/2019,33,187,220,5,1,2019,
19,1/18/2019,54,213,267,5,1,2019,
20,1/18/2019,158,110,268,5,1,2019,
21,1/18/2019,300,175,475,5,1,2019,
22,1/18/2019,246,155,401,5,1,2019,
23,1/18/2019,258,153,411,5,1,2019,
0,1/19/2019,190,220,410,6,1,2019,
1,1/19/2019,27,32,59,6,1,2019,
2,1/19/2019,34,13,47,6,1,2019,
3,1/19/2019,54,0,54,6,1,2019,
4,1/19/2019,68,0,68,6,1,2019,
5,1/19/2019,166,0,166,6,1,2019,
6,1/19/2019,314,72,386,6,1,2019,
7,1/19/2019,287,186,473,6,1,2019,
8,1/19/2019,176,402,578,6,1,2019,
9,1/19/2019,170,444,614,6,1,2019,
10,1/19/2019,148,171,319,6,1,2019,
11,1/19/2019,163,256,419,6,1,2019,
12,1/19/2019,121,295,416,6,1,2019,
13,1/19/2019,93,118,211,6,1,2019,
14,1/19/2019,120,136,256,6,1,2019,
15,1/19/2019,85,248,333,6,1,2019,
16,1/19/2019,81,260,341,6,1,2019,
17,1/19/2019,64,306,370,6,1,2019,
18,1/19/2019,26,279,305,6,1,2019,
19,1/19/2019,32,217,249,6,1,2019,
20,1/19/2019,85,77,162,6,1,2019,
21,1/19/2019,174,234,408,6,1,2019,
22,1/19/2019,180,171,351,6,1,2019,
23,1/19/2019,114,156,270,6,1,2019,
0,1/20/2019,52,115,167,7,1,2019,
1,1/20/2019,41,0,41,7,1,2019,
2,1/20/2019,16,0,16,7,1,2019,
3,1/20/2019,58,0,58,7,1,2019,
4,1/20/2019,57,0,57,7,1,2019,
5,1/20/2019,96,0,96,7,1,2019,
6,1/20/2019,219,87,306,7,1,2019,
7,1/20/2019,182,236,418,7,1,2019,
8,1/20/2019,50,577,627,7,1,2019,
9,1/20/2019,70,270,340,7,1,2019,
10,1/20/2019,118,124,242,7,1,2019,
11,1/20/2019,149,77,226,7,1,2019,
12,1/20/2019,104,376,480,7,1,2019,
13,1/20/2019,148,370,518,7,1,2019,
14,1/20/2019,120,213,333,7,1,2019,
15,1/20/2019,104,330,434,7,1,2019,
16,1/20/2019,93,217,310,7,1,2019,
17,1/20/2019,148,127,275,7,1,2019,
18,1/20/2019,58,402,460,7,1,2019,
19,1/20/2019,57,263,320,7,1,2019,
20,1/20/2019,78,103,181,7,1,2019,
21,1/20/2019,161,152,313,7,1,2019,
22,1/20/2019,181,345,526,7,1,2019,
23,1/20/2019,79,208,287,7,1,2019,
0,1/21/2019,31,181,212,1,1,2019,
1,1/21/2019,23,0,23,1,1,2019,
2,1/21/2019,13,0,13,1,1,2019,
3,1/21/2019,17,0,17,1,1,2019,
4,1/21/2019,31,0,31,1,1,2019,
5,1/21/2019,63,0,63,1,1,2019,
6,1/21/2019,134,92,226,1,1,2019,
7,1/21/2019,146,269,415,1,1,2019,
8,1/21/2019,72,375,447,1,1,2019,
9,1/21/2019,57,292,349,1,1,2019,
10,1/21/2019,52,169,221,1,1,2019,
11,1/21/2019,92,232,324,1,1,2019,
12,1/21/2019,84,144,228,1,1,2019,
13,1/21/2019,58,327,385,1,1,2019,
14,1/21/2019,112,81,193,1,1,2019,
15,1/21/2019,97,280,377,1,1,2019,
16,1/21/2019,112,212,324,1,1,2019,
17,1/21/2019,91,414,505,1,1,2019,
18,1/21/2019,17,399,416,1,1,2019,
19,1/21/2019,20,422,442,1,1,2019,
20,1/21/2019,84,292,376,1,1,2019,
21,1/21/2019,127,216,343,1,1,2019,
22,1/21/2019,163,183,346,1,1,2019,
23,1/21/2019,55,228,283,1,1,2019,
0,1/22/2019,37,254,291,2,1,2019,
1,1/22/2019,15,19,34,2,1,2019,
2,1/22/2019,33,0,33,2,1,2019,
3,1/22/2019,44,0,44,2,1,2019,
4,1/22/2019,43,0,43,2,1,2019,
5,1/22/2019,60,0,60,2,1,2019,
6,1/22/2019,141,68,209,2,1,2019,
7,1/22/2019,124,105,229,2,1,2019,
8,1/22/2019,75,398,473,2,1,2019,
9,1/22/2019,100,337,437,2,1,2019,
10,1/22/2019,71,134,205,2,1,2019,
11,1/22/2019,70,160,230,2,1,2019,
12,1/22/2019,73,175,248,2,1,2019,
13,1/22/2019,77,279,356,2,1,2019,
14,1/22/2019,57,148,205,2,1,2019,
15,1/22/2019,88,244,332,2,1,2019,
16,1/22/2019,69,213,282,2,1,2019,
17,1/22/2019,78,309,387,2,1,2019,
18,1/22/2019,31,273,304,2,1,2019,
19,1/22/2019,16,199,215,2,1,2019,
20,1/22/2019,68,75,143,2,1,2019,
21,1/22/2019,186,165,351,2,1,2019,
22,1/22/2019,178,233,411,2,1,2019,
23,1/22/2019,110,195,305,2,1,2019,
0,1/23/2019,33,80,113,3,1,2019,
1,1/23/2019,2,3,5,3,1,2019,
2,1/23/2019,17,0,17,3,1,2019,
3,1/23/2019,28,0,28,3,1,2019,
4,1/23/2019,29,0,29,3,1,2019,
5,1/23/2019,101,0,101,3,1,2019,
6,1/23/2019,172,53,225,3,1,2019,
7,1/23/2019,117,170,287,3,1,2019,
8,1/23/2019,69,246,315,3,1,2019,
9,1/23/2019,87,232,319,3,1,2019,
10,1/23/2019,97,81,178,3,1,2019,
11,1/23/2019,88,232,320,3,1,2019,
12,1/23/2019,52,222,274,3,1,2019,
13,1/23/2019,71,246,317,3,1,2019,
14,1/23/2019,82,96,178,3,1,2019,
15,1/23/2019,78,176,254,3,1,2019,
16,1/23/2019,60,140,200,3,1,2019,
17,1/23/2019,75,273,348,3,1,2019,
18,1/23/2019,20,205,225,3,1,2019,
19,1/23/2019,31,153,184,3,1,2019,
20,1/23/2019,94,161,255,3,1,2019,
21,1/23/2019,246,146,392,3,1,2019,
22,1/23/2019,273,250,523,3,1,2019,
23,1/23/2019,152,84,236,3,1,2019,
0,1/24/2019,71,78,149,4,1,2019,
1,1/24/2019,6,8,14,4,1,2019,
2,1/24/2019,42,0,42,4,1,2019,
3,1/24/2019,49,0,49,4,1,2019,
4,1/24/2019,66,0,66,4,1,2019,
5,1/24/2019,117,0,117,4,1,2019,
6,1/24/2019,232,68,300,4,1,2019,
7,1/24/2019,212,91,303,4,1,2019,
8,1/24/2019,102,316,418,4,1,2019,
9,1/24/2019,106,480,586,4,1,2019,
10,1/24/2019,142,37,179,4,1,2019,
11,1/24/2019,144,299,443,4,1,2019,
12,1/24/2019,105,162,267,4,1,2019,
13,1/24/2019,91,198,289,4,1,2019,
14,1/24/2019,138,68,206,4,1,2019,
15,1/24/2019,82,225,307,4,1,2019,
16,1/24/2019,108,93,201,4,1,2019,
17,1/24/2019,91,246,337,4,1,2019,
18,1/24/2019,56,202,258,4,1,2019,
19,1/24/2019,27,225,252,4,1,2019,
20,1/24/2019,132,165,297,4,1,2019,
21,1/24/2019,291,126,417,4,1,2019,
22,1/24/2019,268,162,430,4,1,2019,
23,1/24/2019,240,144,384,4,1,2019,
0,1/25/2019,167,97,264,5,1,2019,
1,1/25/2019,35,0,35,5,1,2019,
2,1/25/2019,30,0,30,5,1,2019,
3,1/25/2019,47,0,47,5,1,2019,
4,1/25/2019,64,0,64,5,1,2019,
5,1/25/2019,204,0,204,5,1,2019,
6,1/25/2019,343,40,383,5,1,2019,
7,1/25/2019,217,104,321,5,1,2019,
8,1/25/2019,114,361,475,5,1,2019,
9,1/25/2019,120,409,529,5,1,2019,
10,1/25/2019,150,99,249,5,1,2019,
11,1/25/2019,141,252,393,5,1,2019,
12,1/25/2019,112,198,310,5,1,2019,
13,1/25/2019,112,150,262,5,1,2019,
14,1/25/2019,117,79,196,5,1,2019,
15,1/25/2019,86,195,281,5,1,2019,
16,1/25/2019,166,173,339,5,1,2019,
17,1/25/2019,117,128,245,5,1,2019,
18,1/25/2019,48,222,270,5,1,2019,
19,1/25/2019,35,150,185,5,1,2019,
20,1/25/2019,104,126,230,5,1,2019,
21,1/25/2019,290,121,411,5,1,2019,
22,1/25/2019,265,168,433,5,1,2019,
23,1/25/2019,200,141,341,5,1,2019,
0,1/26/2019,116,182,298,6,1,2019,
1,1/26/2019,46,46,92,6,1,2019,
2,1/26/2019,14,1,15,6,1,2019,
3,1/26/2019,53,12,65,6,1,2019,
4,1/26/2019,59,0,59,6,1,2019,
5,1/26/2019,94,2,96,6,1,2019,
6,1/26/2019,293,8,301,6,1,2019,
7,1/26/2019,244,159,403,6,1,2019,
8,1/26/2019,98,338,436,6,1,2019,
9,1/26/2019,142,335,477,6,1,2019,
10,1/26/2019,111,266,377,6,1,2019,
11,1/26/2019,77,275,352,6,1,2019,
12,1/26/2019,67,39,106,6,1,2019,
13,1/26/2019,116,183,299,6,1,2019,
14,1/26/2019,139,107,246,6,1,2019,
15,1/26/2019,108,212,320,6,1,2019,
16,1/26/2019,84,282,366,6,1,2019,
17,1/26/2019,58,263,321,6,1,2019,
18,1/26/2019,16,381,397,6,1,2019,
19,1/26/2019,23,193,216,6,1,2019,
20,1/26/2019,91,182,273,6,1,2019,
21,1/26/2019,167,56,223,6,1,2019,
22,1/26/2019,174,155,329,6,1,2019,
23,1/26/2019,82,211,293,6,1,2019,
0,1/27/2019,34,124,158,7,1,2019,
1,1/27/2019,4,26,30,7,1,2019,
2,1/27/2019,9,0,9,7,1,2019,
3,1/27/2019,59,0,59,7,1,2019,
4,1/27/2019,55,0,55,7,1,2019,
5,1/27/2019,113,0,113,7,1,2019,
6,1/27/2019,155,33,188,7,1,2019,
7,1/27/2019,180,289,469,7,1,2019,
8,1/27/2019,88,370,458,7,1,2019,
9,1/27/2019,59,361,420,7,1,2019,
10,1/27/2019,92,145,237,7,1,2019,
11,1/27/2019,176,137,313,7,1,2019,
12,1/27/2019,136,171,307,7,1,2019,
13,1/27/2019,155,479,634,7,1,2019,
14,1/27/2019,118,105,223,7,1,2019,
15,1/27/2019,112,399,511,7,1,2019,
16,1/27/2019,145,137,282,7,1,2019,
17,1/27/2019,112,251,363,7,1,2019,
18,1/27/2019,39,232,271,7,1,2019,
19,1/27/2019,40,275,315,7,1,2019,
20,1/27/2019,82,166,248,7,1,2019,
21,1/27/2019,175,63,238,7,1,2019,
22,1/27/2019,204,210,414,7,1,2019,
23,1/27/2019,111,266,377,7,1,2019,
0,1/28/2019,38,135,173,1,1,2019,
1,1/28/2019,8,99,107,1,1,2019,
2,1/28/2019,12,227,239,1,1,2019,
3,1/28/2019,30,0,30,1,1,2019,
4,1/28/2019,41,0,41,1,1,2019,
5,1/28/2019,45,0,45,1,1,2019,
6,1/28/2019,112,49,161,1,1,2019,
7,1/28/2019,145,270,415,1,1,2019,
8,1/28/2019,105,241,346,1,1,2019,
9,1/28/2019,64,270,334,1,1,2019,
10,1/28/2019,90,121,211,1,1,2019,
11,1/28/2019,91,210,301,1,1,2019,
12,1/28/2019,107,163,270,1,1,2019,
13,1/28/2019,90,192,282,1,1,2019,
14,1/28/2019,102,167,269,1,1,2019,
15,1/28/2019,112,170,282,1,1,2019,
16,1/28/2019,94,130,224,1,1,2019,
17,1/28/2019,85,356,441,1,1,2019,
18,1/28/2019,20,303,323,1,1,2019,
19,1/28/2019,15,314,329,1,1,2019,
20,1/28/2019,38,75,113,1,1,2019,
21,1/28/2019,132,160,292,1,1,2019,
22,1/28/2019,170,143,313,1,1,2019,
23,1/28/2019,55,157,212,1,1,2019,
0,1/29/2019,25,120,145,2,1,2019,
1,1/29/2019,15,57,72,2,1,2019,
2,1/29/2019,12,11,23,2,1,2019,
3,1/29/2019,54,0,54,2,1,2019,
4,1/29/2019,41,0,41,2,1,2019,
5,1/29/2019,60,1,61,2,1,2019,
6,1/29/2019,142,0,142,2,1,2019,
7,1/29/2019,115,199,314,2,1,2019,
8,1/29/2019,98,299,397,2,1,2019,
9,1/29/2019,36,267,303,2,1,2019,
10,1/29/2019,52,123,175,2,1,2019,
11,1/29/2019,97,198,295,2,1,2019,
12,1/29/2019,102,135,237,2,1,2019,
13,1/29/2019,59,136,195,2,1,2019,
14,1/29/2019,106,130,236,2,1,2019,
15,1/29/2019,61,163,224,2,1,2019,
16,1/29/2019,66,214,280,2,1,2019,
17,1/29/2019,96,204,300,2,1,2019,
18,1/29/2019,15,225,240,2,1,2019,
19,1/29/2019,15,199,214,2,1,2019,
20,1/29/2019,66,44,110,2,1,2019,
21,1/29/2019,127,217,344,2,1,2019,
22,1/29/2019,192,99,291,2,1,2019,
23,1/29/2019,109,71,180,2,1,2019,
0,1/30/2019,58,106,164,3,1,2019,
1,1/30/2019,8,5,13,3,1,2019,
2,1/30/2019,19,10,29,3,1,2019,
3,1/30/2019,34,0,34,3,1,2019,
4,1/30/2019,38,0,38,3,1,2019,
5,1/30/2019,98,0,98,3,1,2019,
6,1/30/2019,189,23,212,3,1,2019,
7,1/30/2019,129,187,316,3,1,2019,
8,1/30/2019,64,352,416,3,1,2019,
9,1/30/2019,91,318,409,3,1,2019,
10,1/30/2019,91,92,183,3,1,2019,
11,1/30/2019,79,293,372,3,1,2019,
12,1/30/2019,77,91,168,3,1,2019,
13,1/30/2019,96,139,235,3,1,2019,
14,1/30/2019,137,61,198,3,1,2019,
15,1/30/2019,58,144,202,3,1,2019,
16,1/30/2019,83,145,228,3,1,2019,
17,1/30/2019,93,147,240,3,1,2019,
18,1/30/2019,29,187,216,3,1,2019,
19,1/30/2019,30,192,222,3,1,2019,
20,1/30/2019,122,119,241,3,1,2019,
21,1/30/2019,228,221,449,3,1,2019,
22,1/30/2019,262,96,358,3,1,2019,
23,1/30/2019,162,129,291,3,1,2019,
0,1/31/2019,120,74,194,4,1,2019,
1,1/31/2019,23,17,40,4,1,2019,
2,1/31/2019,41,32,73,4,1,2019,
3,1/31/2019,94,0,94,4,1,2019,
4,1/31/2019,111,0,111,4,1,2019,
5,1/31/2019,139,0,139,4,1,2019,
6,1/31/2019,197,8,205,4,1,2019,
7,1/31/2019,239,257,496,4,1,2019,
8,1/31/2019,174,381,555,4,1,2019,
9,1/31/2019,119,332,451,4,1,2019,
10,1/31/2019,137,73,210,4,1,2019,
11,1/31/2019,165,246,411,4,1,2019,
12,1/31/2019,91,364,455,4,1,2019,
13,1/31/2019,98,340,438,4,1,2019,
14,1/31/2019,137,103,240,4,1,2019,
15,1/31/2019,45,194,239,4,1,2019,
16,1/31/2019,78,176,254,4,1,2019,
17,1/31/2019,76,158,234,4,1,2019,
18,1/31/2019,45,313,358,4,1,2019,
19,1/31/2019,28,220,248,4,1,2019,
20,1/31/2019,128,160,288,4,1,2019,
21,1/31/2019,278,167,445,4,1,2019,
22,1/31/2019,300,170,470,4,1,2019,
23,1/31/2019,210,236,446,4,1,2019,
0,2/1/2019,123,198,321,5,2,2019,
1,2/1/2019,18,59,77,5,2,2019,
2,2/1/2019,29,4,33,5,2,2019,
3,2/1/2019,49,120,169,5,2,2019,
4,2/1/2019,80,0,80,5,2,2019,
5,2/1/2019,150,0,150,5,2,2019,
6,2/1/2019,245,15,260,5,2,2019,
7,2/1/2019,199,246,445,5,2,2019,
8,2/1/2019,94,343,437,5,2,2019,
9,2/1/2019,107,521,628,5,2,2019,
10,2/1/2019,167,25,192,5,2,2019,
11,2/1/2019,113,337,450,5,2,2019,
12,2/1/2019,87,186,273,5,2,2019,
13,2/1/2019,96,190,286,5,2,2019,
14,2/1/2019,86,102,188,5,2,2019,
15,2/1/2019,57,209,266,5,2,2019,
16,2/1/2019,130,322,452,5,2,2019,
17,2/1/2019,94,193,287,5,2,2019,
18,2/1/2019,28,293,321,5,2,2019,
19,2/1/2019,36,384,420,5,2,2019,
20,2/1/2019,108,105,213,5,2,2019,
21,2/1/2019,198,232,430,5,2,2019,
22,2/1/2019,195,203,398,5,2,2019,
23,2/1/2019,168,212,380,5,2,2019,
0,2/2/2019,77,175,252,6,2,2019,
1,2/2/2019,22,85,107,6,2,2019,
2,2/2/2019,24,25,49,6,2,2019,
3,2/2/2019,47,0,47,6,2,2019,
4,2/2/2019,55,0,55,6,2,2019,
5,2/2/2019,114,1,115,6,2,2019,
6,2/2/2019,254,61,315,6,2,2019,
7,2/2/2019,176,149,325,6,2,2019,
8,2/2/2019,140,474,614,6,2,2019,
9,2/2/2019,128,457,585,6,2,2019,
10,2/2/2019,126,26,152,6,2,2019,
11,2/2/2019,83,231,314,6,2,2019,
12,2/2/2019,89,176,265,6,2,2019,
13,2/2/2019,138,219,357,6,2,2019,
14,2/2/2019,113,132,245,6,2,2019,
15,2/2/2019,114,185,299,6,2,2019,
16,2/2/2019,69,197,266,6,2,2019,
17,2/2/2019,37,280,317,6,2,2019,
18,2/2/2019,16,319,335,6,2,2019,
19,2/2/2019,47,183,230,6,2,2019,
20,2/2/2019,73,83,156,6,2,2019,
21,2/2/2019,109,172,281,6,2,2019,
22,2/2/2019,132,181,313,6,2,2019,
23,2/2/2019,90,62,152,6,2,2019,
0,2/3/2019,34,166,200,7,2,2019,
1,2/3/2019,10,12,22,7,2,2019,
2,2/3/2019,10,0,10,7,2,2019,
3,2/3/2019,47,0,47,7,2,2019,
4,2/3/2019,60,0,60,7,2,2019,
5,2/3/2019,76,0,76,7,2,2019,
6,2/3/2019,183,103,286,7,2,2019,
7,2/3/2019,166,196,362,7,2,2019,
8,2/3/2019,48,267,315,7,2,2019,
9,2/3/2019,102,386,488,7,2,2019,
10,2/3/2019,177,112,289,7,2,2019,
11,2/3/2019,124,115,239,7,2,2019,
12,2/3/2019,111,173,284,7,2,2019,
13,2/3/2019,81,449,530,7,2,2019,
14,2/3/2019,94,175,269,7,2,2019,
15,2/3/2019,125,330,455,7,2,2019,
16,2/3/2019,63,74,137,7,2,2019,
17,2/3/2019,72,319,391,7,2,2019,
18,2/3/2019,18,190,208,7,2,2019,
19,2/3/2019,40,178,218,7,2,2019,
20,2/3/2019,74,194,268,7,2,2019,
21,2/3/2019,148,246,394,7,2,2019,
22,2/3/2019,183,199,382,7,2,2019,
23,2/3/2019,115,265,380,7,2,2019,
0,2/4/2019,41,246,287,1,2,2019,
1,2/4/2019,14,3,17,1,2,2019,
2,2/4/2019,19,75,94,1,2,2019,
3,2/4/2019,35,0,35,1,2,2019,
4,2/4/2019,29,0,29,1,2,2019,
5,2/4/2019,65,0,65,1,2,2019,
6,2/4/2019,170,26,196,1,2,2019,
7,2/4/2019,257,162,419,1,2,2019,
8,2/4/2019,104,293,397,1,2,2019,
9,2/4/2019,199,326,525,1,2,2019,
10,2/4/2019,169,40,209,1,2,2019,
11,2/4/2019,127,290,417,1,2,2019,
12,2/4/2019,221,105,326,1,2,2019,
13,2/4/2019,202,170,372,1,2,2019,
14,2/4/2019,261,132,393,1,2,2019,
15,2/4/2019,263,160,423,1,2,2019,
16,2/4/2019,292,125,417,1,2,2019,
17,2/4/2019,300,197,497,1,2,2019,
18,2/4/2019,125,199,324,1,2,2019,
19,2/4/2019,31,186,217,1,2,2019,
20,2/4/2019,74,147,221,1,2,2019,
21,2/4/2019,208,117,325,1,2,2019,
22,2/4/2019,293,86,379,1,2,2019,
23,2/4/2019,151,67,218,1,2,2019,
0,2/5/2019,61,178,239,2,2,2019,
1,2/5/2019,26,15,41,2,2,2019,
2,2/5/2019,7,6,13,2,2,2019,
3,2/5/2019,70,0,70,2,2,2019,
4,2/5/2019,75,0,75,2,2,2019,
5,2/5/2019,85,1,86,2,2,2019,
6,2/5/2019,153,28,181,2,2,2019,
7,2/5/2019,204,177,381,2,2,2019,
8,2/5/2019,126,264,390,2,2,2019,
9,2/5/2019,132,211,343,2,2,2019,
10,2/5/2019,137,39,176,2,2,2019,
11,2/5/2019,110,175,285,2,2,2019,
12,2/5/2019,200,117,317,2,2,2019,
13,2/5/2019,159,221,380,2,2,2019,
14,2/5/2019,174,107,281,2,2,2019,
15,2/5/2019,230,138,368,2,2,2019,
16,2/5/2019,188,128,316,2,2,2019,
17,2/5/2019,185,159,344,2,2,2019,
18,2/5/2019,12,176,188,2,2,2019,
19,2/5/2019,18,104,122,2,2,2019,
20,2/5/2019,64,26,90,2,2,2019,
21,2/5/2019,191,263,454,2,2,2019,
22,2/5/2019,207,143,350,2,2,2019,
23,2/5/2019,138,78,216,2,2,2019,
0,2/6/2019,49,96,145,3,2,2019,
1,2/6/2019,6,0,6,3,2,2019,
2,2/6/2019,21,0,21,3,2,2019,
3,2/6/2019,37,0,37,3,2,2019,
4,2/6/2019,22,0,22,3,2,2019,
5,2/6/2019,97,1,98,3,2,2019,
6,2/6/2019,167,50,217,3,2,2019,
7,2/6/2019,142,202,344,3,2,2019,
8,2/6/2019,90,317,407,3,2,2019,
9,2/6/2019,115,262,377,3,2,2019,
10,2/6/2019,137,28,165,3,2,2019,
11,2/6/2019,104,240,344,3,2,2019,
12,2/6/2019,69,159,228,3,2,2019,
13,2/6/2019,116,124,240,3,2,2019,
14,2/6/2019,105,33,138,3,2,2019,
15,2/6/2019,144,106,250,3,2,2019,
16,2/6/2019,146,216,362,3,2,2019,
17,2/6/2019,66,149,215,3,2,2019,
18,2/6/2019,36,181,217,3,2,2019,
19,2/6/2019,15,186,201,3,2,2019,
20,2/6/2019,63,43,106,3,2,2019,
21,2/6/2019,192,173,365,3,2,2019,
22,2/6/2019,214,79,293,3,2,2019,
23,2/6/2019,136,122,258,3,2,2019,
0,2/7/2019,62,79,141,4,2,2019,
1,2/7/2019,1,0,1,4,2,2019,
2,2/7/2019,32,0,32,4,2,2019,
3,2/7/2019,34,0,34,4,2,2019,
4,2/7/2019,74,0,74,4,2,2019,
5,2/7/2019,92,0,92,4,2,2019,
6,2/7/2019,233,25,258,4,2,2019,
7,2/7/2019,223,208,431,4,2,2019,
8,2/7/2019,158,272,430,4,2,2019,
9,2/7/2019,112,257,369,4,2,2019,
10,2/7/2019,180,111,291,4,2,2019,
11,2/7/2019,168,201,369,4,2,2019,
12,2/7/2019,87,113,200,4,2,2019,
13,2/7/2019,107,183,290,4,2,2019,
14,2/7/2019,83,60,143,4,2,2019,
15,2/7/2019,52,137,189,4,2,2019,
16,2/7/2019,70,119,189,4,2,2019,
17,2/7/2019,51,70,121,4,2,2019,
18,2/7/2019,25,198,223,4,2,2019,
19,2/7/2019,9,39,48,4,2,2019,
20,2/7/2019,106,78,184,4,2,2019,
21,2/7/2019,251,166,417,4,2,2019,
22,2/7/2019,300,95,395,4,2,2019,
23,2/7/2019,270,85,355,4,2,2019,
0,2/8/2019,91,76,167,5,2,2019,
1,2/8/2019,28,43,71,5,2,2019,
2,2/8/2019,37,5,42,5,2,2019,
3,2/8/2019,56,0,56,5,2,2019,
4,2/8/2019,63,0,63,5,2,2019,
5,2/8/2019,167,0,167,5,2,2019,
6,2/8/2019,291,22,313,5,2,2019,
7,2/8/2019,241,165,406,5,2,2019,
8,2/8/2019,13,300,313,5,2,2019,
9,2/8/2019,46,317,363,5,2,2019,
10,2/8/2019,140,112,252,5,2,2019,
11,2/8/2019,173,167,340,5,2,2019,
12,2/8/2019,116,175,291,5,2,2019,
13,2/8/2019,67,189,256,5,2,2019,
14,2/8/2019,126,57,183,5,2,2019,
15,2/8/2019,129,216,345,5,2,2019,
16,2/8/2019,119,144,263,5,2,2019,
17,2/8/2019,139,162,301,5,2,2019,
18,2/8/2019,22,143,165,5,2,2019,
19,2/8/2019,26,226,252,5,2,2019,
20,2/8/2019,139,33,172,5,2,2019,
21,2/8/2019,268,227,495,5,2,2019,
22,2/8/2019,244,87,331,5,2,2019,
23,2/8/2019,242,115,357,5,2,2019,
0,2/9/2019,154,104,258,6,2,2019,
1,2/9/2019,29,22,51,6,2,2019,
2,2/9/2019,25,13,38,6,2,2019,
3,2/9/2019,86,0,86,6,2,2019,
4,2/9/2019,58,0,58,6,2,2019,
5,2/9/2019,132,1,133,6,2,2019,
6,2/9/2019,285,20,305,6,2,2019,
7,2/9/2019,260,200,460,6,2,2019,
8,2/9/2019,163,317,480,6,2,2019,
9,2/9/2019,122,446,568,6,2,2019,
10,2/9/2019,53,100,153,6,2,2019,
11,2/9/2019,92,182,274,6,2,2019,
12,2/9/2019,78,146,224,6,2,2019,
13,2/9/2019,102,209,311,6,2,2019,
14,2/9/2019,151,90,241,6,2,2019,
15,2/9/2019,154,201,355,6,2,2019,
16,2/9/2019,129,218,347,6,2,2019,
17,2/9/2019,41,204,245,6,2,2019,
18,2/9/2019,6,218,224,6,2,2019,
19,2/9/2019,45,152,197,6,2,2019,
20,2/9/2019,62,58,120,6,2,2019,
21,2/9/2019,120,152,272,6,2,2019,
22,2/9/2019,153,76,229,6,2,2019,
23,2/9/2019,88,159,247,6,2,2019,
0,2/10/2019,44,45,89,7,2,2019,
1,2/10/2019,26,0,26,7,2,2019,
2,2/10/2019,23,0,23,7,2,2019,
3,2/10/2019,62,0,62,7,2,2019,
4,2/10/2019,50,0,50,7,2,2019,
5,2/10/2019,159,0,159,7,2,2019,
6,2/10/2019,173,24,197,7,2,2019,
7,2/10/2019,207,257,464,7,2,2019,
8,2/10/2019,88,382,470,7,2,2019,
9,2/10/2019,55,296,351,7,2,2019,
10,2/10/2019,133,1,134,7,2,2019,
11,2/10/2019,169,162,331,7,2,2019,
12,2/10/2019,142,173,315,7,2,2019,
13,2/10/2019,160,297,457,7,2,2019,
14,2/10/2019,125,65,190,7,2,2019,
15,2/10/2019,140,304,444,7,2,2019,
16,2/10/2019,149,179,328,7,2,2019,
17,2/10/2019,144,220,364,7,2,2019,
18,2/10/2019,41,168,209,7,2,2019,
19,2/10/2019,25,196,221,7,2,2019,
20,2/10/2019,72,196,268,7,2,2019,
21,2/10/2019,171,145,316,7,2,2019,
22,2/10/2019,154,190,344,7,2,2019,
23,2/10/2019,76,185,261,7,2,2019,
0,2/11/2019,67,190,257,1,2,2019,
1,2/11/2019,27,11,38,1,2,2019,
2,2/11/2019,8,0,8,1,2,2019,
3,2/11/2019,18,0,18,1,2,2019,
4,2/11/2019,50,0,50,1,2,2019,
5,2/11/2019,81,0,81,1,2,2019,
6,2/11/2019,98,6,104,1,2,2019,
7,2/11/2019,124,148,272,1,2,2019,
8,2/11/2019,69,309,378,1,2,2019,
9,2/11/2019,71,244,315,1,2,2019,
10,2/11/2019,122,78,200,1,2,2019,
11,2/11/2019,94,220,314,1,2,2019,
12,2/11/2019,85,133,218,1,2,2019,
13,2/11/2019,81,288,369,1,2,2019,
14,2/11/2019,99,101,200,1,2,2019,
15,2/11/2019,75,220,295,1,2,2019,
16,2/11/2019,108,181,289,1,2,2019,
17,2/11/2019,88,161,249,1,2,2019,
18,2/11/2019,24,235,259,1,2,2019,
19,2/11/2019,15,365,380,1,2,2019,
20,2/11/2019,57,172,229,1,2,2019,
21,2/11/2019,107,165,272,1,2,2019,
22,2/11/2019,119,170,289,1,2,2019,
23,2/11/2019,65,56,121,1,2,2019,
0,2/12/2019,34,159,193,2,2,2019,
1,2/12/2019,14,19,33,2,2,2019,
2,2/12/2019,22,0,22,2,2,2019,
3,2/12/2019,57,0,57,2,2,2019,
4,2/12/2019,52,0,52,2,2,2019,
5,2/12/2019,59,1,60,2,2,2019,
6,2/12/2019,166,44,210,2,2,2019,
7,2/12/2019,131,52,183,2,2,2019,
8,2/12/2019,91,226,317,2,2,2019,
9,2/12/2019,73,211,284,2,2,2019,
10,2/12/2019,92,91,183,2,2,2019,
11,2/12/2019,73,207,280,2,2,2019,
12,2/12/2019,94,63,157,2,2,2019,
13,2/12/2019,96,241,337,2,2,2019,
14,2/12/2019,80,4,84,2,2,2019,
15,2/12/2019,61,290,351,2,2,2019,
16,2/12/2019,81,125,206,2,2,2019,
17,2/12/2019,87,192,279,2,2,2019,
18,2/12/2019,21,237,258,2,2,2019,
19,2/12/2019,13,171,184,2,2,2019,
20,2/12/2019,50,35,85,2,2,2019,
21,2/12/2019,202,177,379,2,2,2019,
22,2/12/2019,201,92,293,2,2,2019,
23,2/12/2019,152,97,249,2,2,2019,
0,2/13/2019,7,35,42,3,2,2019,
1,2/13/2019,0,0,0,3,2,2019,
2,2/13/2019,9,0,9,3,2,2019,
3,2/13/2019,37,31,68,3,2,2019,
4,2/13/2019,28,2,30,3,2,2019,
5,2/13/2019,137,0,137,3,2,2019,
6,2/13/2019,280,34,314,3,2,2019,
7,2/13/2019,192,158,350,3,2,2019,
8,2/13/2019,85,228,313,3,2,2019,
9,2/13/2019,105,241,346,3,2,2019,
10,2/13/2019,126,31,157,3,2,2019,
11,2/13/2019,123,227,350,3,2,2019,
12,2/13/2019,72,83,155,3,2,2019,
13,2/13/2019,123,69,192,3,2,2019,
14,2/13/2019,84,84,168,3,2,2019,
15,2/13/2019,76,125,201,3,2,2019,
16,2/13/2019,106,144,250,3,2,2019,
17,2/13/2019,115,72,187,3,2,2019,
18,2/13/2019,39,157,196,3,2,2019,
19,2/13/2019,19,128,147,3,2,2019,
20,2/13/2019,64,60,124,3,2,2019,
21,2/13/2019,255,128,383,3,2,2019,
22,2/13/2019,341,135,476,3,2,2019,
23,2/13/2019,231,103,334,3,2,2019,
0,2/14/2019,132,84,216,4,2,2019,
1,2/14/2019,21,2,23,4,2,2019,
2,2/14/2019,27,3,30,4,2,2019,
3,2/14/2019,96,0,96,4,2,2019,
4,2/14/2019,106,0,106,4,2,2019,
5,2/14/2019,158,0,158,4,2,2019,
6,2/14/2019,313,9,322,4,2,2019,
7,2/14/2019,369,75,444,4,2,2019,
8,2/14/2019,176,261,437,4,2,2019,
9,2/14/2019,117,234,351,4,2,2019,
10,2/14/2019,225,87,312,4,2,2019,
11,2/14/2019,289,102,391,4,2,2019,
12,2/14/2019,169,168,337,4,2,2019,
13,2/14/2019,138,28,166,4,2,2019,
14,2/14/2019,155,250,405,4,2,2019,
15,2/14/2019,161,108,269,4,2,2019,
16,2/14/2019,134,94,228,4,2,2019,
17,2/14/2019,218,212,430,4,2,2019,
18,2/14/2019,65,139,204,4,2,2019,
19,2/14/2019,53,132,185,4,2,2019,
20,2/14/2019,151,131,282,4,2,2019,
21,2/14/2019,343,97,440,4,2,2019,
22,2/14/2019,369,125,494,4,2,2019,
23,2/14/2019,284,88,372,4,2,2019,
0,2/15/2019,200,104,304,5,2,2019,
1,2/15/2019,66,63,129,5,2,2019,
2,2/15/2019,59,3,62,5,2,2019,
3,2/15/2019,82,0,82,5,2,2019,
4,2/15/2019,109,0,109,5,2,2019,
5,2/15/2019,244,1,245,5,2,2019,
6,2/15/2019,468,39,507,5,2,2019,
7,2/15/2019,494,106,600,5,2,2019,
8,2/15/2019,195,315,510,5,2,2019,
9,2/15/2019,192,313,505,5,2,2019,
10,2/15/2019,218,137,355,5,2,2019,
11,2/15/2019,277,189,466,5,2,2019,
12,2/15/2019,131,83,214,5,2,2019,
13,2/15/2019,142,197,339,5,2,2019,
14,2/15/2019,157,72,229,5,2,2019,
15,2/15/2019,168,169,337,5,2,2019,
16,2/15/2019,181,216,397,5,2,2019,
17,2/15/2019,224,153,377,5,2,2019,
18,2/15/2019,50,115,165,5,2,2019,
19,2/15/2019,28,161,189,5,2,2019,
20,2/15/2019,94,101,195,5,2,2019,
21,2/15/2019,327,234,561,5,2,2019,
22,2/15/2019,234,87,321,5,2,2019,
23,2/15/2019,143,162,305,5,2,2019,
0,2/16/2019,81,105,186,6,2,2019,
1,2/16/2019,17,11,28,6,2,2019,
2,2/16/2019,10,13,23,6,2,2019,
3,2/16/2019,83,0,83,6,2,2019,
4,2/16/2019,83,0,83,6,2,2019,
5,2/16/2019,78,1,79,6,2,2019,
6,2/16/2019,200,26,226,6,2,2019,
7,2/16/2019,422,157,579,6,2,2019,
8,2/16/2019,267,337,604,6,2,2019,
9,2/16/2019,258,388,646,6,2,2019,
10,2/16/2019,245,23,268,6,2,2019,
11,2/16/2019,165,224,389,6,2,2019,
12,2/16/2019,112,210,322,6,2,2019,
13,2/16/2019,107,149,256,6,2,2019,
14,2/16/2019,107,107,214,6,2,2019,
15,2/16/2019,155,248,403,6,2,2019,
16,2/16/2019,88,204,292,6,2,2019,
17,2/16/2019,104,202,306,6,2,2019,
18,2/16/2019,16,246,262,6,2,2019,
19,2/16/2019,22,130,152,6,2,2019,
20,2/16/2019,105,204,309,6,2,2019,
21,2/16/2019,217,175,392,6,2,2019,
22,2/16/2019,221,46,267,6,2,2019,
23,2/16/2019,89,191,280,6,2,2019,
0,2/17/2019,53,59,112,7,2,2019,
1,2/17/2019,16,1,17,7,2,2019,
2,2/17/2019,20,0,20,7,2,2019,
3,2/17/2019,54,0,54,7,2,2019,
4,2/17/2019,72,0,72,7,2,2019,
5,2/17/2019,131,0,131,7,2,2019,
6,2/17/2019,279,68,347,7,2,2019,
7,2/17/2019,261,163,424,7,2,2019,
8,2/17/2019,117,404,521,7,2,2019,
9,2/17/2019,83,333,416,7,2,2019,
10,2/17/2019,199,0,199,7,2,2019,
11,2/17/2019,191,86,277,7,2,2019,
12,2/17/2019,127,280,407,7,2,2019,
13,2/17/2019,125,353,478,7,2,2019,
14,2/17/2019,162,137,299,7,2,2019,
15,2/17/2019,115,301,416,7,2,2019,
16,2/17/2019,133,99,232,7,2,2019,
17,2/17/2019,130,292,422,7,2,2019,
18,2/17/2019,62,297,359,7,2,2019,
19,2/17/2019,46,309,355,7,2,2019,
20,2/17/2019,86,148,234,7,2,2019,
21,2/17/2019,202,92,294,7,2,2019,
22,2/17/2019,166,218,384,7,2,2019,
23,2/17/2019,95,266,361,7,2,2019,
0,2/18/2019,58,224,282,1,2,2019,
1,2/18/2019,15,57,72,1,2,2019,
2,2/18/2019,27,141,168,1,2,2019,
3,2/18/2019,24,0,24,1,2,2019,
4,2/18/2019,27,0,27,1,2,2019,
5,2/18/2019,51,0,51,1,2,2019,
6,2/18/2019,143,74,217,1,2,2019,
7,2/18/2019,137,186,323,1,2,2019,
8,2/18/2019,81,364,445,1,2,2019,
9,2/18/2019,153,412,565,1,2,2019,
10,2/18/2019,69,215,284,1,2,2019,
11,2/18/2019,103,265,368,1,2,2019,
12,2/18/2019,95,305,400,1,2,2019,
13,2/18/2019,97,238,335,1,2,2019,
14,2/18/2019,132,223,355,1,2,2019,
15,2/18/2019,122,255,377,1,2,2019,
16,2/18/2019,124,284,408,1,2,2019,
17,2/18/2019,102,348,450,1,2,2019,
18,2/18/2019,17,521,538,1,2,2019,
19,2/18/2019,28,499,527,1,2,2019,
20,2/18/2019,65,419,484,1,2,2019,
21,2/18/2019,135,299,434,1,2,2019,
22,2/18/2019,103,294,397,1,2,2019,
23,2/18/2019,88,358,446,1,2,2019,
0,2/19/2019,46,330,376,2,2,2019,
1,2/19/2019,10,13,23,2,2,2019,
2,2/19/2019,18,0,18,2,2,2019,
3,2/19/2019,57,0,57,2,2,2019,
4,2/19/2019,32,0,32,2,2,2019,
5,2/19/2019,58,1,59,2,2,2019,
6,2/19/2019,150,55,205,2,2,2019,
7,2/19/2019,139,217,356,2,2,2019,
8,2/19/2019,87,285,372,2,2,2019,
9,2/19/2019,86,367,453,2,2,2019,
10,2/19/2019,111,46,157,2,2,2019,
11,2/19/2019,76,292,368,2,2,2019,
12,2/19/2019,85,140,225,2,2,2019,
13,2/19/2019,90,234,324,2,2,2019,
14,2/19/2019,67,200,267,2,2,2019,
15,2/19/2019,74,394,468,2,2,2019,
16,2/19/2019,77,145,222,2,2,2019,
17,2/19/2019,105,234,339,2,2,2019,
18,2/19/2019,36,283,319,2,2,2019,
19,2/19/2019,16,281,297,2,2,2019,
20,2/19/2019,39,130,169,2,2,2019,
21,2/19/2019,214,327,541,2,2,2019,
22,2/19/2019,154,121,275,2,2,2019,
23,2/19/2019,107,135,242,2,2,2019,
0,2/20/2019,98,135,233,3,2,2019,
1,2/20/2019,21,0,21,3,2,2019,
2,2/20/2019,8,0,8,3,2,2019,
3,2/20/2019,49,0,49,3,2,2019,
4,2/20/2019,27,0,27,3,2,2019,
5,2/20/2019,87,0,87,3,2,2019,
6,2/20/2019,172,47,219,3,2,2019,
7,2/20/2019,175,140,315,3,2,2019,
8,2/20/2019,78,329,407,3,2,2019,
9,2/20/2019,86,234,320,3,2,2019,
10,2/20/2019,125,35,160,3,2,2019,
11,2/20/2019,61,254,315,3,2,2019,
12,2/20/2019,84,73,157,3,2,2019,
13,2/20/2019,60,226,286,3,2,2019,
14,2/20/2019,87,94,181,3,2,2019,
15,2/20/2019,103,199,302,3,2,2019,
16,2/20/2019,100,167,267,3,2,2019,
17,2/20/2019,66,114,180,3,2,2019,
18,2/20/2019,22,207,229,3,2,2019,
19,2/20/2019,14,212,226,3,2,2019,
20,2/20/2019,66,151,217,3,2,2019,
21,2/20/2019,151,147,298,3,2,2019,
22,2/20/2019,247,135,382,3,2,2019,
23,2/20/2019,181,146,327,3,2,2019,
0,2/21/2019,89,100,189,4,2,2019,
1,2/21/2019,16,0,16,4,2,2019,
2,2/21/2019,36,0,36,4,2,2019,
3,2/21/2019,67,0,67,4,2,2019,
4,2/21/2019,81,0,81,4,2,2019,
5,2/21/2019,213,0,213,4,2,2019,
6,2/21/2019,245,18,263,4,2,2019,
7,2/21/2019,279,219,498,4,2,2019,
8,2/21/2019,169,269,438,4,2,2019,
9,2/21/2019,128,330,458,4,2,2019,
10,2/21/2019,212,7,219,4,2,2019,
11,2/21/2019,172,191,363,4,2,2019,
12,2/21/2019,121,279,400,4,2,2019,
13,2/21/2019,126,227,353,4,2,2019,
14,2/21/2019,119,92,211,4,2,2019,
15,2/21/2019,63,227,290,4,2,2019,
16,2/21/2019,74,84,158,4,2,2019,
17,2/21/2019,96,166,262,4,2,2019,
18,2/21/2019,40,190,230,4,2,2019,
19,2/21/2019,15,141,156,4,2,2019,
20,2/21/2019,107,150,257,4,2,2019,
21,2/21/2019,270,166,436,4,2,2019,
22,2/21/2019,354,203,557,4,2,2019,
23,2/21/2019,230,54,284,4,2,2019,
0,2/22/2019,134,88,222,5,2,2019,
1,2/22/2019,61,45,106,5,2,2019,
2,2/22/2019,28,1,29,5,2,2019,
3,2/22/2019,54,0,54,5,2,2019,
4,2/22/2019,58,0,58,5,2,2019,
5,2/22/2019,203,0,203,5,2,2019,
6,2/22/2019,345,2,347,5,2,2019,
7,2/22/2019,279,116,395,5,2,2019,
8,2/22/2019,139,376,515,5,2,2019,
9,2/22/2019,145,395,540,5,2,2019,
10,2/22/2019,179,62,241,5,2,2019,
11,2/22/2019,163,246,409,5,2,2019,
12,2/22/2019,103,167,270,5,2,2019,
13,2/22/2019,105,154,259,5,2,2019,
14,2/22/2019,118,76,194,5,2,2019,
15,2/22/2019,104,260,364,5,2,2019,
16,2/22/2019,78,155,233,5,2,2019,
17,2/22/2019,117,170,287,5,2,2019,
18,2/22/2019,58,120,178,5,2,2019,
19,2/22/2019,33,298,331,5,2,2019,
20,2/22/2019,148,170,318,5,2,2019,
21,2/22/2019,255,169,424,5,2,2019,
22,2/22/2019,291,96,387,5,2,2019,
23,2/22/2019,191,185,376,5,2,2019,
0,2/23/2019,88,88,176,6,2,2019,
1,2/23/2019,27,21,48,6,2,2019,
2,2/23/2019,19,13,32,6,2,2019,
3,2/23/2019,62,0,62,6,2,2019,
4,2/23/2019,43,0,43,6,2,2019,
5,2/23/2019,123,2,125,6,2,2019,
6,2/23/2019,313,74,387,6,2,2019,
7,2/23/2019,255,159,414,6,2,2019,
8,2/23/2019,155,411,566,6,2,2019,
9,2/23/2019,130,271,401,6,2,2019,
10,2/23/2019,119,139,258,6,2,2019,
11,2/23/2019,104,195,299,6,2,2019,
12,2/23/2019,61,196,257,6,2,2019,
13,2/23/2019,127,272,399,6,2,2019,
14,2/23/2019,127,73,200,6,2,2019,
15,2/23/2019,112,369,481,6,2,2019,
16,2/23/2019,110,251,361,6,2,2019,
17,2/23/2019,59,341,400,6,2,2019,
18,2/23/2019,14,295,309,6,2,2019,
19,2/23/2019,19,141,160,6,2,2019,
20,2/23/2019,64,174,238,6,2,2019,
21,2/23/2019,144,172,316,6,2,2019,
22,2/23/2019,151,131,282,6,2,2019,
23,2/23/2019,96,185,281,6,2,2019,
0,2/24/2019,63,59,122,7,2,2019,
1,2/24/2019,26,0,26,7,2,2019,
2,2/24/2019,37,0,37,7,2,2019,
3,2/24/2019,51,0,51,7,2,2019,
4,2/24/2019,60,0,60,7,2,2019,
5,2/24/2019,108,0,108,7,2,2019,
6,2/24/2019,186,81,267,7,2,2019,
7,2/24/2019,196,253,449,7,2,2019,
8,2/24/2019,99,479,578,7,2,2019,
9,2/24/2019,65,163,228,7,2,2019,
10,2/24/2019,136,1,137,7,2,2019,
11,2/24/2019,141,232,373,7,2,2019,
12,2/24/2019,146,248,394,7,2,2019,
13,2/24/2019,146,361,507,7,2,2019,
14,2/24/2019,141,183,324,7,2,2019,
15,2/24/2019,136,375,511,7,2,2019,
16,2/24/2019,153,256,409,7,2,2019,
17,2/24/2019,207,284,491,7,2,2019,
18,2/24/2019,81,349,430,7,2,2019,
19,2/24/2019,45,174,219,7,2,2019,
20,2/24/2019,88,114,202,7,2,2019,
21,2/24/2019,157,216,373,7,2,2019,
22,2/24/2019,160,458,618,7,2,2019,
23,2/24/2019,113,330,443,7,2,2019,
0,2/25/2019,75,149,224,1,2,2019,
1,2/25/2019,8,0,8,1,2,2019,
2,2/25/2019,11,1,12,1,2,2019,
3,2/25/2019,59,0,59,1,2,2019,
4,2/25/2019,51,0,51,1,2,2019,
5,2/25/2019,68,0,68,1,2,2019,
6,2/25/2019,158,76,234,1,2,2019,
7,2/25/2019,157,232,389,1,2,2019,
8,2/25/2019,119,272,391,1,2,2019,
9,2/25/2019,80,238,318,1,2,2019,
10,2/25/2019,95,124,219,1,2,2019,
11,2/25/2019,82,230,312,1,2,2019,
12,2/25/2019,97,124,221,1,2,2019,
13,2/25/2019,96,217,313,1,2,2019,
14,2/25/2019,116,67,183,1,2,2019,
15,2/25/2019,161,272,433,1,2,2019,
16,2/25/2019,183,266,449,1,2,2019,
17,2/25/2019,124,215,339,1,2,2019,
18,2/25/2019,43,188,231,1,2,2019,
19,2/25/2019,13,394,407,1,2,2019,
20,2/25/2019,50,45,95,1,2,2019,
21,2/25/2019,142,185,327,1,2,2019,
22,2/25/2019,96,141,237,1,2,2019,
23,2/25/2019,104,132,236,1,2,2019,
0,2/26/2019,29,111,140,2,2,2019,
1,2/26/2019,21,13,34,2,2,2019,
2,2/26/2019,21,0,21,2,2,2019,
3,2/26/2019,81,0,81,2,2,2019,
4,2/26/2019,43,0,43,2,2,2019,
5,2/26/2019,114,1,115,2,2,2019,
6,2/26/2019,242,22,264,2,2,2019,
7,2/26/2019,162,116,278,2,2,2019,
8,2/26/2019,93,272,365,2,2,2019,
9,2/26/2019,92,337,429,2,2,2019,
10,2/26/2019,111,35,146,2,2,2019,
11,2/26/2019,111,194,305,2,2,2019,
12,2/26/2019,97,122,219,2,2,2019,
13,2/26/2019,95,186,281,2,2,2019,
14,2/26/2019,109,101,210,2,2,2019,
15,2/26/2019,70,237,307,2,2,2019, 
16,2/26/2019,101,112,213,2,2,2019,
17,2/26/2019,91,219,310,2,2,2019,
18,2/26/2019,23,212,235,2,2,2019,
19,2/26/2019,27,251,278,2,2,2019,
20,2/26/2019,64,0,64,2,2,2019,
21,2/26/2019,201,206,407,2,2,2019,
22,2/26/2019,170,168,338,2,2,2019,
23,2/26/2019,99,101,200,2,2,2019,
0,2/27/2019,61,66,127,3,2,2019,
1,2/27/2019,9,0,9,3,2,2019,
2,2/27/2019,10,0,10,3,2,2019,
3,2/27/2019,27,0,27,3,2,2019,
4,2/27/2019,32,0,32,3,2,2019,
5,2/27/2019,151,0,151,3,2,2019,
6,2/27/2019,231,23,254,3,2,2019,
7,2/27/2019,199,113,312,3,2,2019,
8,2/27/2019,100,272,372,3,2,2019,
9,2/27/2019,144,250,394,3,2,2019,
10,2/27/2019,116,56,172,3,2,2019,
11,2/27/2019,76,295,371,3,2,2019,
12,2/27/2019,67,118,185,3,2,2019,
13,2/27/2019,82,145,227,3,2,2019,
14,2/27/2019,124,43,167,3,2,2019,
15,2/27/2019,103,164,267,3,2,2019,
16,2/27/2019,97,157,254,3,2,2019,
17,2/27/2019,142,197,339,3,2,2019,
18,2/27/2019,37,187,224,3,2,2019,
19,2/27/2019,18,224,242,3,2,2019,
20,2/27/2019,64,48,112,3,2,2019,
21,2/27/2019,250,89,339,3,2,2019,
22,2/27/2019,223,154,377,3,2,2019,
23,2/27/2019,197,86,283,3,2,2019,
0,2/28/2019,118,34,152,4,2,2019,
1,2/28/2019,36,0,36,4,2,2019,
2,2/28/2019,36,0,36,4,2,2019,
3,2/28/2019,94,0,94,4,2,2019,
4,2/28/2019,109,0,109,4,2,2019,
5,2/28/2019,160,0,160,4,2,2019,
6,2/28/2019,269,58,327,4,2,2019,
7,2/28/2019,278,107,385,4,2,2019,
8,2/28/2019,246,310,556,4,2,2019,
9,2/28/2019,155,312,467,4,2,2019,
10,2/28/2019,218,55,273,4,2,2019,
11,2/28/2019,263,194,457,4,2,2019,
12,2/28/2019,83,219,302,4,2,2019,
13,2/28/2019,136,256,392,4,2,2019,
14,2/28/2019,137,153,290,4,2,2019,
15,2/28/2019,107,215,322,4,2,2019,
16,2/28/2019,115,122,237,4,2,2019,
17,2/28/2019,127,145,272,4,2,2019,
18,2/28/2019,48,216,264,4,2,2019,
19,2/28/2019,25,212,237,4,2,2019,
20,2/28/2019,132,79,211,4,2,2019,
21,2/28/2019,308,181,489,4,2,2019,
22,2/28/2019,329,146,475,4,2,2019,
23,2/28/2019,258,53,311,4,2,2019,
0,3/1/2019,140,105,245,5,3,2019,
1,3/1/2019,37,1,38,5,3,2019,
2,3/1/2019,24,0,24,5,3,2019,
3,3/1/2019,58,0,58,5,3,2019,
4,3/1/2019,91,0,91,5,3,2019,
5,3/1/2019,199,0,199,5,3,2019,
6,3/1/2019,365,27,392,5,3,2019,
7,3/1/2019,321,80,401,5,3,2019,
8,3/1/2019,188,223,411,5,3,2019,
9,3/1/2019,211,271,482,5,3,2019,
10,3/1/2019,197,160,357,5,3,2019,
11,3/1/2019,148,181,329,5,3,2019,
12,3/1/2019,137,136,273,5,3,2019,
13,3/1/2019,104,175,279,5,3,2019,
14,3/1/2019,177,116,293,5,3,2019,
15,3/1/2019,168,226,394,5,3,2019,
16,3/1/2019,137,166,303,5,3,2019,
17,3/1/2019,169,184,353,5,3,2019,
18,3/1/2019,56,214,270,5,3,2019,
19,3/1/2019,38,92,130,5,3,2019,
20,3/1/2019,110,105,215,5,3,2019,
21,3/1/2019,290,208,498,5,3,2019,
22,3/1/2019,212,163,375,5,3,2019,
23,3/1/2019,269,194,463,5,3,2019,
0,3/2/2019,139,124,263,6,3,2019,
1,3/2/2019,29,8,37,6,3,2019,
2,3/2/2019,29,13,42,6,3,2019,
3,3/2/2019,96,0,96,6,3,2019,
4,3/2/2019,34,0,34,6,3,2019,
5,3/2/2019,169,1,170,6,3,2019,
6,3/2/2019,340,47,387,6,3,2019,
7,3/2/2019,359,193,552,6,3,2019,
8,3/2/2019,212,350,562,6,3,2019,
9,3/2/2019,151,377,528,6,3,2019,
10,3/2/2019,254,70,324,6,3,2019,
11,3/2/2019,83,240,323,6,3,2019,
12,3/2/2019,126,170,296,6,3,2019,
13,3/2/2019,113,168,281,6,3,2019,
14,3/2/2019,132,155,287,6,3,2019,
15,3/2/2019,143,159,302,6,3,2019,
16,3/2/2019,96,192,288,6,3,2019,
17,3/2/2019,65,334,399,6,3,2019,
18,3/2/2019,38,228,266,6,3,2019,
19,3/2/2019,52,157,209,6,3,2019,
20,3/2/2019,96,85,181,6,3,2019,
21,3/2/2019,157,166,323,6,3,2019,
22,3/2/2019,178,71,249,6,3,2019,
23,3/2/2019,103,72,175,6,3,2019,
0,3/3/2019,57,57,114,7,3,2019,
1,3/3/2019,15,2,17,7,3,2019,
2,3/3/2019,30,0,30,7,3,2019,
3,3/3/2019,57,0,57,7,3,2019,
4,3/3/2019,78,0,78,7,3,2019,
5,3/3/2019,158,0,158,7,3,2019,
6,3/3/2019,202,39,241,7,3,2019,
7,3/3/2019,236,166,402,7,3,2019,
8,3/3/2019,91,411,502,7,3,2019,
9,3/3/2019,97,273,370,7,3,2019,
10,3/3/2019,168,72,240,7,3,2019,
11,3/3/2019,171,153,324,7,3,2019,
12,3/3/2019,170,169,339,7,3,2019,
13,3/3/2019,163,361,524,7,3,2019,
14,3/3/2019,147,117,264,7,3,2019,
15,3/3/2019,160,393,553,7,3,2019,
16,3/3/2019,143,183,326,7,3,2019,
17,3/3/2019,148,226,374,7,3,2019,
18,3/3/2019,44,299,343,7,3,2019,
19,3/3/2019,40,249,289,7,3,2019,
20,3/3/2019,88,46,134,7,3,2019,
21,3/3/2019,177,237,414,7,3,2019,
22,3/3/2019,185,242,427,7,3,2019,
23,3/3/2019,111,245,356,7,3,2019,
0,3/4/2019,62,182,244,1,3,2019,
1,3/4/2019,27,2,29,1,3,2019,
2,3/4/2019,6,2,8,1,3,2019,
3,3/4/2019,12,0,12,1,3,2019,
4,3/4/2019,29,0,29,1,3,2019,
5,3/4/2019,95,0,95,1,3,2019,
6,3/4/2019,125,47,172,1,3,2019,
7,3/4/2019,181,137,318,1,3,2019,
8,3/4/2019,122,306,428,1,3,2019,
9,3/4/2019,68,239,307,1,3,2019,
10,3/4/2019,108,55,163,1,3,2019,
11,3/4/2019,106,225,331,1,3,2019,
12,3/4/2019,133,83,216,1,3,2019,
13,3/4/2019,92,293,385,1,3,2019,
14,3/4/2019,145,176,321,1,3,2019,
15,3/4/2019,151,212,363,1,3,2019,
16,3/4/2019,113,208,321,1,3,2019,
17,3/4/2019,80,252,332,1,3,2019,
18,3/4/2019,24,282,306,1,3,2019,
19,3/4/2019,17,292,309,1,3,2019,
20,3/4/2019,59,95,154,1,3,2019,
21,3/4/2019,118,111,229,1,3,2019,
22,3/4/2019,116,161,277,1,3,2019,
23,3/4/2019,62,143,205,1,3,2019,
0,3/5/2019,44,157,201,2,3,2019,
1,3/5/2019,4,23,27,2,3,2019,
2,3/5/2019,25,0,25,2,3,2019,
3,3/5/2019,56,0,56,2,3,2019,
4,3/5/2019,38,1,39,2,3,2019,
5,3/5/2019,77,0,77,2,3,2019,
6,3/5/2019,213,44,257,2,3,2019,
7,3/5/2019,168,201,369,2,3,2019,
8,3/5/2019,100,291,391,2,3,2019,
9,3/5/2019,105,278,383,2,3,2019,
10,3/5/2019,127,10,137,2,3,2019,
11,3/5/2019,119,277,396,2,3,2019,
12,3/5/2019,73,176,249,2,3,2019,
13,3/5/2019,89,211,300,2,3,2019,
14,3/5/2019,67,222,289,2,3,2019,
15,3/5/2019,83,139,222,2,3,2019,
16,3/5/2019,95,221,316,2,3,2019,
17,3/5/2019,100,140,240,2,3,2019,
18,3/5/2019,9,286,295,2,3,2019,
19,3/5/2019,18,132,150,2,3,2019,
20,3/5/2019,87,63,150,2,3,2019,
21,3/5/2019,152,186,338,2,3,2019,
22,3/5/2019,214,193,407,2,3,2019,
23,3/5/2019,104,123,227,2,3,2019,
0,3/6/2019,48,72,120,3,3,2019,
1,3/6/2019,16,48,64,3,3,2019,
2,3/6/2019,8,0,8,3,3,2019,
3,3/6/2019,56,0,56,3,3,2019,
4,3/6/2019,60,0,60,3,3,2019,
5,3/6/2019,97,0,97,3,3,2019,
6,3/6/2019,220,53,273,3,3,2019,
7,3/6/2019,148,142,290,3,3,2019,
8,3/6/2019,98,361,459,3,3,2019,
9,3/6/2019,130,234,364,3,3,2019,
10,3/6/2019,127,2,129,3,3,2019,
11,3/6/2019,98,284,382,3,3,2019,
12,3/6/2019,72,186,258,3,3,2019,
13,3/6/2019,105,115,220,3,3,2019,
14,3/6/2019,92,102,194,3,3,2019,
15,3/6/2019,98,125,223,3,3,2019,
16,3/6/2019,95,174,269,3,3,2019,
17,3/6/2019,58,126,184,3,3,2019,
18,3/6/2019,37,318,355,3,3,2019,
19,3/6/2019,13,150,163,3,3,2019,
20,3/6/2019,71,100,171,3,3,2019,
21,3/6/2019,142,120,262,3,3,2019,
22,3/6/2019,237,111,348,3,3,2019,
23,3/6/2019,157,241,398,3,3,2019,
0,3/7/2019,79,96,175,4,3,2019,
1,3/7/2019,11,0,11,4,3,2019,
2,3/7/2019,18,0,18,4,3,2019,
3,3/7/2019,90,0,90,4,3,2019,
4,3/7/2019,74,0,74,4,3,2019,
5,3/7/2019,116,0,116,4,3,2019,
6,3/7/2019,244,1,245,4,3,2019,
7,3/7/2019,260,175,435,4,3,2019,
8,3/7/2019,123,366,489,4,3,2019,
9,3/7/2019,123,371,494,4,3,2019,
10,3/7/2019,149,9,158,4,3,2019,
11,3/7/2019,199,296,495,4,3,2019,
12,3/7/2019,89,247,336,4,3,2019,
13,3/7/2019,77,182,259,4,3,2019,
14,3/7/2019,120,48,168,4,3,2019,
15,3/7/2019,100,193,293,4,3,2019,
16,3/7/2019,125,161,286,4,3,2019,
17,3/7/2019,126,250,376,4,3,2019,
18,3/7/2019,21,145,166,4,3,2019,
19,3/7/2019,25,243,268,4,3,2019,
20,3/7/2019,110,126,236,4,3,2019,
21,3/7/2019,238,225,463,4,3,2019,
22,3/7/2019,357,124,481,4,3,2019,
23,3/7/2019,218,84,302,4,3,2019,
0,3/8/2019,161,90,251,5,3,2019,
1,3/8/2019,50,5,55,5,3,2019,
2,3/8/2019,32,14,46,5,3,2019,
3,3/8/2019,82,0,82,5,3,2019,
4,3/8/2019,70,0,70,5,3,2019,
5,3/8/2019,161,0,161,5,3,2019,
6,3/8/2019,359,53,412,5,3,2019,
7,3/8/2019,330,84,414,5,3,2019,
8,3/8/2019,185,442,627,5,3,2019,
9,3/8/2019,174,355,529,5,3,2019, 
10,3/8/2019,164,144,308,5,3,2019,
11,3/8/2019,131,80,211,5,3,2019,
12,3/8/2019,76,218,294,5,3,2019,
13,3/8/2019,88,214,302,5,3,2019,
14,3/8/2019,131,73,204,5,3,2019,
15,3/8/2019,139,226,365,5,3,2019,
16,3/8/2019,134,127,261,5,3,2019,
17,3/8/2019,130,186,316,5,3,2019,
18,3/8/2019,42,122,164,5,3,2019,
19,3/8/2019,23,344,367,5,3,2019,
20,3/8/2019,65,97,162,5,3,2019,
21,3/8/2019,300,156,456,5,3,2019,
22,3/8/2019,239,188,427,5,3,2019,
23,3/8/2019,187,193,380,5,3,2019,
0,3/9/2019,113,127,240,6,3,2019,
1,3/9/2019,27,27,54,6,3,2019,
2,3/9/2019,28,13,41,6,3,2019,
3,3/9/2019,66,0,66,6,3,2019,
4,3/9/2019,57,0,57,6,3,2019,
5,3/9/2019,127,1,128,6,3,2019,
6,3/9/2019,344,72,416,6,3,2019,
7,3/9/2019,289,155,444,6,3,2019,
8,3/9/2019,207,357,564,6,3,2019,
9,3/9/2019,160,438,598,6,3,2019,
10,3/9/2019,132,49,181,6,3,2019,
11,3/9/2019,77,284,361,6,3,2019,
12,3/9/2019,84,219,303,6,3,2019,
13,3/9/2019,88,176,264,6,3,2019,
14,3/9/2019,124,151,275,6,3,2019,
15,3/9/2019,105,290,395,6,3,2019,
16,3/9/2019,91,257,348,6,3,2019,
17,3/9/2019,56,319,375,6,3,2019,
18,3/9/2019,49,250,299,6,3,2019,
19,3/9/2019,14,126,140,6,3,2019,
20,3/9/2019,90,213,303,6,3,2019,
21,3/9/2019,148,230,378,6,3,2019,
22,3/9/2019,180,132,312,6,3,2019,
23,3/9/2019,84,78,162,6,3,2019,
0,3/10/2019,35,85,120,7,3,2019,
1,3/10/2019,10,0,10,7,3,2019,
2,3/10/2019,0,0,0,7,3,2019,
3,3/10/2019,21,0,21,7,3,2019,
4,3/10/2019,46,0,46,7,3,2019,
5,3/10/2019,108,0,108,7,3,2019,
6,3/10/2019,139,0,139,7,3,2019,
7,3/10/2019,263,78,341,7,3,2019,
8,3/10/2019,200,275,475,7,3,2019,
9,3/10/2019,84,418,502,7,3,2019,
10,3/10/2019,98,262,360,7,3,2019,
11,3/10/2019,136,42,178,7,3,2019,
12,3/10/2019,167,155,322,7,3,2019,
13,3/10/2019,131,254,385,7,3,2019,
14,3/10/2019,143,309,452,7,3,2019,
15,3/10/2019,153,119,272,7,3,2019,
16,3/10/2019,113,455,568,7,3,2019,
17,3/10/2019,155,186,341,7,3,2019,
18,3/10/2019,192,167,359,7,3,2019,
19,3/10/2019,38,298,336,7,3,2019,
20,3/10/2019,52,297,349,7,3,2019,
21,3/10/2019,85,162,247,7,3,2019,
22,3/10/2019,160,173,333,7,3,2019,
23,3/10/2019,173,286,459,7,3,2019,
0,3/11/2019,99,245,344,1,3,2019,
1,3/11/2019,33,157,190,1,3,2019,
2,3/11/2019,26,6,32,1,3,2019,
3,3/11/2019,5,0,5,1,3,2019,
4,3/11/2019,33,0,33,1,3,2019,
5,3/11/2019,42,0,42,1,3,2019,
6,3/11/2019,92,0,92,1,3,2019,
7,3/11/2019,160,54,214,1,3,2019,
8,3/11/2019,161,281,442,1,3,2019,
9,3/11/2019,83,281,364,1,3,2019,
10,3/11/2019,117,308,425,1,3,2019,
11,3/11/2019,148,77,225,1,3,2019,
12,3/11/2019,118,254,372,1,3,2019,
13,3/11/2019,111,181,292,1,3,2019,
14,3/11/2019,122,183,305,1,3,2019,
15,3/11/2019,119,71,190,1,3,2019,
16,3/11/2019,170,234,404,1,3,2019,
17,3/11/2019,114,316,430,1,3,2019,
18,3/11/2019,168,391,559,1,3,2019,
19,3/11/2019,59,270,329,1,3,2019,
20,3/11/2019,31,339,370,1,3,2019,
21,3/11/2019,79,77,156,1,3,2019,
22,3/11/2019,148,155,303,1,3,2019,
23,3/11/2019,106,213,319,1,3,2019,
0,43536,67,140,207,2,3,2019,
1,43536,27,90,117,2,3,2019,
2,43536,11,13,24,2,3,2019,
3,43536,21,0,21,2,3,2019,
4,43536,70,0,70,2,3,2019,
5,43536,55,0,55,2,3,2019,
6,43536,97,1,98,2,3,2019,
7,43536,191,27,218,2,3,2019,
8,43536,189,126,315,2,3,2019,
9,43536,118,406,524,2,3,2019,
10,43536,84,274,358,2,3,2019,
11,43536,159,13,172,2,3,2019,
12,43536,100,252,352,2,3,2019,
13,43536,81,255,336,2,3,2019,
14,43536,104,203,307,2,3,2019,
15,43536,73,223,296,2,3,2019,
16,43536,128,154,282,2,3,2019,
17,43536,87,169,256,2,3,2019,
18,43536,61,243,304,2,3,2019,
19,43536,67,157,224,2,3,2019,
20,43536,27,155,182,2,3,2019,
21,43536,111,71,182,2,3,2019,
22,43536,184,219,403,2,3,2019,
23,43536,168,149,317,2,3,2019,
0,43537,155,46,201,3,3,2019,
1,43537,59,110,169,3,3,2019,
2,43537,8,1,9,3,3,2019,
3,43537,13,0,13,3,3,2019,
4,43537,47,0,47,3,3,2019,
5,43537,80,0,80,3,3,2019,
6,43537,125,1,126,3,3,2019,
7,43537,226,33,259,3,3,2019,
8,43537,165,143,308,3,3,2019,
9,43537,104,293,397,3,3,2019,
10,43537,95,267,362,3,3,2019,
11,43537,159,8,167,3,3,2019,
12,43537,153,261,414,3,3,2019,
13,43537,82,164,246,3,3,2019,
14,43537,92,96,188,3,3,2019,
15,43537,103,161,264,3,3,2019,
16,43537,73,180,253,3,3,2019,
17,43537,114,92,206,3,3,2019,
18,43537,76,170,246,3,3,2019,
19,43537,70,226,296,3,3,2019,
20,43537,55,122,177,3,3,2019,
21,43537,141,149,290,3,3,2019,
22,43537,208,128,336,3,3,2019,
23,43537,272,177,449,3,3,2019,
0,43538,220,170,390,4,3,2019,
1,43538,106,37,143,4,3,2019,
2,43538,12,2,14,4,3,2019,
3,43538,42,0,42,4,3,2019,
4,43538,87,0,87,4,3,2019,
5,43538,114,0,114,4,3,2019,
6,43538,201,0,201,4,3,2019,
7,43538,245,7,252,4,3,2019,
8,43538,332,244,576,4,3,2019,
9,43538,169,379,548,4,3,2019,
10,43538,160,406,566,4,3,2019,
11,43538,173,13,186,4,3,2019,
12,43538,202,231,433,4,3,2019,
13,43538,119,212,331,4,3,2019,
14,43538,95,260,355,4,3,2019,
15,43538,84,35,119,4,3,2019,
16,43538,129,124,253,4,3,2019,
17,43538,123,327,450,4,3,2019,
18,43538,96,220,316,4,3,2019,
19,43538,72,347,419,4,3,2019,
20,43538,34,211,245,4,3,2019,
21,43538,135,115,250,4,3,2019,
22,43538,267,214,481,4,3,2019,
23,43538,306,241,547,4,3,2019,
0,43539,216,109,325,5,3,2019,
1,43539,135,183,318,5,3,2019,
2,43539,60,10,70,5,3,2019,
3,43539,27,2,29,5,3,2019,
4,43539,86,0,86,5,3,2019,
5,43539,110,0,110,5,3,2019,
6,43539,241,0,241,5,3,2019,
7,43539,354,83,437,5,3,2019,
8,43539,294,184,478,5,3,2019,
9,43539,148,402,550,5,3,2019,
10,43539,202,296,498,5,3,2019,
11,43539,167,108,275,5,3,2019,
12,43539,140,234,374,5,3,2019,
13,43539,123,217,340,5,3,2019,
14,43539,103,139,242,5,3,2019,
15,43539,94,114,208,5,3,2019,
16,43539,120,279,399,5,3,2019,
17,43539,148,224,372,5,3,2019,
18,43539,115,188,303,5,3,2019,
19,43539,79,292,371,5,3,2019,
20,43539,58,457,515,5,3,2019,
21,43539,155,85,240,5,3,2019,
22,43539,295,354,649,5,3,2019,
23,43539,331,112,443,5,3,2019,
0,43540,228,152,380,6,3,2019,
1,43540,84,251,335,6,3,2019,
2,43540,34,56,90,6,3,2019,
3,43540,24,28,52,6,3,2019,
4,43540,81,15,96,6,3,2019,
5,43540,75,0,75,6,3,2019,
6,43540,156,1,157,6,3,2019,
7,43540,409,58,467,6,3,2019,
8,43540,419,201,620,6,3,2019,
9,43540,189,566,755,6,3,2019,
10,43540,196,394,590,6,3,2019,
11,43540,218,206,424,6,3,2019,
12,43540,201,322,523,6,3,2019,
13,43540,119,264,383,6,3,2019,
14,43540,224,219,443,6,3,2019,
15,43540,133,118,251,6,3,2019,
16,43540,179,324,503,6,3,2019,
17,43540,135,201,336,6,3,2019,
18,43540,88,287,375,6,3,2019,
19,43540,52,358,410,6,3,2019,
20,43540,47,143,190,6,3,2019,
21,43540,114,162,276,6,3,2019,
22,43540,241,209,450,6,3,2019,
23,43540,247,80,327,6,3,2019,
0,43541,140,203,343,7,3,2019,
1,43541,78,40,118,7,3,2019,
2,43541,21,55,76,7,3,2019,
3,43541,50,0,50,7,3,2019,
4,43541,114,0,114,7,3,2019,
5,43541,130,0,130,7,3,2019,
6,43541,227,0,227,7,3,2019,
7,43541,353,92,445,7,3,2019,
8,43541,199,256,455,7,3,2019,
9,43541,140,499,639,7,3,2019,
10,43541,103,236,339,7,3,2019,
11,43541,222,35,257,7,3,2019,
12,43541,159,263,422,7,3,2019,
13,43541,134,275,409,7,3,2019,
14,43541,122,352,474,7,3,2019,
15,43541,149,143,292,7,3,2019,
16,43541,111,422,533,7,3,2019,
17,43541,146,286,432,7,3,2019,
18,43541,88,174,262,7,3,2019,
19,43541,53,281,334,7,3,2019,
20,43541,71,359,430,7,3,2019,
21,43541,82,147,229,7,3,2019,
22,43541,207,144,351,7,3,2019,
23,43541,211,241,452,7,3,2019,
0,43542,126,279,405,1,3,2019,
1,43542,63,165,228,1,3,2019,
2,43542,21,7,28,1,3,2019,
3,43542,52,1,53,1,3,2019,
4,43542,70,0,70,1,3,2019,
5,43542,45,0,45,1,3,2019,
6,43542,145,0,145,1,3,2019,
7,43542,270,49,319,1,3,2019,
8,43542,204,139,343,1,3,2019,
9,43542,134,301,435,1,3,2019,
10,43542,182,256,438,1,3,2019,
11,43542,291,76,367,1,3,2019,
12,43542,231,259,490,1,3,2019,
13,43542,126,279,405,1,3,2019,
14,43542,213,121,334,1,3,2019,
15,43542,245,64,309,1,3,2019,
16,43542,323,250,573,1,3,2019,
17,43542,322,141,463,1,3,2019,
18,43542,348,198,546,1,3,2019,
19,43542,126,211,337,1,3,2019,
20,43542,69,212,281,1,3,2019,
21,43542,109,61,170,1,3,2019,
22,43542,275,90,365,1,3,2019,
23,43542,214,132,346,1,3,2019,
0,43543,136,80,216,2,3,2019,
1,43543,62,87,149,2,3,2019,
2,43543,10,14,24,2,3,2019,
3,43543,41,0,41,2,3,2019,
4,43543,86,0,86,2,3,2019,
5,43543,72,0,72,2,3,2019,
6,43543,117,1,118,2,3,2019,
7,43543,282,40,322,2,3,2019,
8,43543,247,142,389,2,3,2019,
9,43543,127,299,426,2,3,2019,
10,43543,153,227,380,2,3,2019,
11,43543,229,39,268,2,3,2019,
12,43543,205,130,335,2,3,2019,
13,43543,132,312,444,2,3,2019,
14,43543,161,164,325,2,3,2019,
15,43543,176,140,316,2,3,2019,
16,43543,132,242,374,2,3,2019,
17,43543,156,171,327,2,3,2019,
18,43543,162,219,381,2,3,2019,
19,43543,42,124,166,2,3,2019,
20,43543,41,127,168,2,3,2019,
21,43543,140,60,200,2,3,2019,
22,43543,199,188,387,2,3,2019,
23,43543,168,119,287,2,3,2019,
0,43544,132,131,263,3,3,2019,
1,43544,59,68,127,3,3,2019,
2,43544,6,0,6,3,3,2019,
3,43544,16,0,16,3,3,2019,
4,43544,34,0,34,3,3,2019,
5,43544,109,0,109,3,3,2019,
6,43544,175,0,175,3,3,2019,
7,43544,251,3,254,3,3,2019,
8,43544,211,195,406,3,3,2019,
9,43544,110,374,484,3,3,2019,
10,43544,111,165,276,3,3,2019,
11,43544,206,45,251,3,3,2019,
12,43544,153,222,375,3,3,2019,
13,43544,97,261,358,3,3,2019,
14,43544,111,88,199,3,3,2019,
15,43544,135,102,237,3,3,2019,
16,43544,99,149,248,3,3,2019,
17,43544,133,96,229,3,3,2019,
18,43544,85,226,311,3,3,2019,
19,43544,88,202,290,3,3,2019,
20,43544,44,170,214,3,3,2019,
21,43544,105,155,260,3,3,2019,
22,43544,220,168,388,3,3,2019,
23,43544,255,115,370,3,3,2019,
0,43545,134,150,284,4,3,2019,
1,43545,112,53,165,4,3,2019,
2,43545,22,38,60,4,3,2019,
3,43545,36,0,36,4,3,2019,
4,43545,98,0,98,4,3,2019,
5,43545,79,0,79,4,3,2019,
6,43545,201,0,201,4,3,2019,
7,43545,267,42,309,4,3,2019,
8,43545,331,238,569,4,3,2019,
9,43545,148,370,518,4,3,2019,
10,43545,155,377,532,4,3,2019,
11,43545,243,2,245,4,3,2019,
12,43545,279,238,517,4,3,2019,
13,43545,94,193,287,4,3,2019,
14,43545,123,183,306,4,3,2019,
15,43545,109,96,205,4,3,2019,
16,43545,137,113,250,4,3,2019,
17,43545,141,200,341,4,3,2019,
18,43545,156,218,374,4,3,2019,
19,43545,100,247,347,4,3,2019,
20,43545,61,188,249,4,3,2019,
21,43545,177,104,281,4,3,2019,
22,43545,318,156,474,4,3,2019,
23,43545,284,165,449,4,3,2019,
0,43546,239,135,374,5,3,2019,
1,43546,139,60,199,5,3,2019,
2,43546,54,2,56,5,3,2019,
3,43546,14,0,14,5,3,2019,
4,43546,70,0,70,5,3,2019,
5,43546,106,1,107,5,3,2019,
6,43546,266,0,266,5,3,2019,
7,43546,445,56,501,5,3,2019,
8,43546,412,214,626,5,3,2019,
9,43546,190,408,598,5,3,2019,
10,43546,247,352,599,5,3,2019,
11,43546,299,44,343,5,3,2019,
12,43546,160,323,483,5,3,2019,
13,43546,145,194,339,5,3,2019,
14,43546,151,115,266,5,3,2019,
15,43546,148,112,260,5,3,2019,
16,43546,165,241,406,5,3,2019,
17,43546,165,192,357,5,3,2019,
18,43546,171,127,298,5,3,2019,
19,43546,101,248,349,5,3,2019,
20,43546,98,241,339,5,3,2019,
21,43546,184,142,326,5,3,2019,
22,43546,276,183,459,5,3,2019,
23,43546,404,216,620,5,3,2019,
0,43547,298,170,468,6,3,2019,
1,43547,69,93,162,6,3,2019,
2,43547,29,54,83,6,3,2019,
3,43547,61,15,76,6,3,2019,
4,43547,126,0,126,6,3,2019,
5,43547,125,0,125,6,3,2019,
6,43547,276,1,277,6,3,2019,
7,43547,437,21,458,6,3,2019,
8,43547,510,142,652,6,3,2019,
9,43547,304,589,893,6,3,2019,
10,43547,284,472,756,6,3,2019,
11,43547,317,25,342,6,3,2019,
12,43547,216,214,430,6,3,2019,
13,43547,148,280,428,6,3,2019,
14,43547,179,166,345,6,3,2019,
15,43547,205,218,423,6,3,2019,
16,43547,189,263,452,6,3,2019,
17,43547,156,247,403,6,3,2019,
18,43547,76,359,435,6,3,2019,
19,43547,58,250,308,6,3,2019,
20,43547,45,249,294,6,3,2019,
21,43547,141,165,306,6,3,2019,
22,43547,244,229,473,6,3,2019,
23,43547,209,186,395,6,3,2019,
0,43548,154,126,280,7,3,2019,
1,43548,95,88,183,7,3,2019,
2,43548,19,0,19,7,3,2019,
3,43548,18,0,18,7,3,2019,
4,43548,88,0,88,7,3,2019,
5,43548,139,0,139,7,3,2019,
6,43548,234,0,234,7,3,2019,
7,43548,335,82,417,7,3,2019,
8,43548,265,218,483,7,3,2019,
9,43548,158,649,807,7,3,2019,
10,43548,141,340,481,7,3,2019,
11,43548,232,1,233,7,3,2019,
12,43548,282,225,507,7,3,2019,
13,43548,158,403,561,7,3,2019,
14,43548,173,347,520,7,3,2019,
15,43548,142,108,250,7,3,2019,
16,43548,122,565,687,7,3,2019,
17,43548,112,257,369,7,3,2019,
18,43548,110,154,264,7,3,2019,
19,43548,122,210,332,7,3,2019,
20,43548,99,329,428,7,3,2019,
21,43548,123,354,477,7,3,2019,
22,43548,224,156,380,7,3,2019,
23,43548,192,213,405,7,3,2019,
0,43549,115,364,479,1,3,2019,
1,43549,82,112,194,1,3,2019,
2,43549,46,2,48,1,3,2019,
3,43549,17,0,17,1,3,2019,
4,43549,61,0,61,1,3,2019,
5,43549,56,0,56,1,3,2019,
6,43549,150,0,150,1,3,2019,
7,43549,257,69,326,1,3,2019,
8,43549,248,143,391,1,3,2019,
9,43549,169,329,498,1,3,2019,
10,43549,157,230,387,1,3,2019,
11,43549,206,166,372,1,3,2019,
12,43549,173,295,468,1,3,2019,
13,43549,131,228,359,1,3,2019,
14,43549,96,252,348,1,3,2019,
15,43549,103,128,231,1,3,2019,
16,43549,119,143,262,1,3,2019,
17,43549,121,251,372,1,3,2019,
18,43549,73,341,414,1,3,2019,
19,43549,30,288,318,1,3,2019,
20,43549,33,226,259,1,3,2019,
21,43549,79,220,299,1,3,2019,
22,43549,159,151,310,1,3,2019,
23,43549,128,87,215,1,3,2019,
0,43550,76,227,303,2,3,2019,
1,43550,47,149,196,2,3,2019,
2,43550,4,4,8,2,3,2019,
3,43550,19,13,32,2,3,2019,
4,43550,68,0,68,2,3,2019,
5,43550,63,0,63,2,3,2019,
6,43550,158,1,159,2,3,2019,
7,43550,274,0,274,2,3,2019,
8,43550,267,0,267,2,3,2019,
9,43550,132,173,305,2,3,2019,
10,43550,133,391,524,2,3,2019,
11,43550,175,193,368,2,3,2019,
12,43550,142,457,599,2,3,2019,
13,43550,83,203,286,2,3,2019,
14,43550,70,247,317,2,3,2019,
15,43550,78,145,223,2,3,2019,
16,43550,94,191,285,2,3,2019,
17,43550,63,194,257,2,3,2019,
18,43550,67,238,305,2,3,2019,
19,43550,18,190,208,2,3,2019,
20,43550,31,236,267,2,3,2019,
21,43550,87,78,165,2,3,2019,
22,43550,184,299,483,2,3,2019,
23,43550,143,168,311,2,3,2019,
0,43551,116,88,204,3,3,2019,
1,43551,94,124,218,3,3,2019,
2,43551,32,0,32,3,3,2019,
3,43551,24,0,24,3,3,2019,
4,43551,28,0,28,3,3,2019,
5,43551,90,0,90,3,3,2019,
6,43551,123,0,123,3,3,2019,
7,43551,240,76,316,3,3,2019,
8,43551,238,180,418,3,3,2019,
9,43551,135,363,498,3,3,2019,
10,43551,108,301,409,3,3,2019,
11,43551,166,5,171,3,3,2019,
12,43551,121,313,434,3,3,2019,
13,43551,55,160,215,3,3,2019,
14,43551,120,154,274,3,3,2019,
15,43551,113,73,186,3,3,2019,
16,43551,93,295,388,3,3,2019,
17,43551,106,238,344,3,3,2019,
18,43551,96,162,258,3,3,2019,
19,43551,62,256,318,3,3,2019,
20,43551,47,126,173,3,3,2019,
21,43551,126,238,364,3,3,2019,
22,43551,196,89,285,3,3,2019,
23,43551,242,217,459,3,3,2019,
0,43552,162,169,331,4,3,2019,
1,43552,110,113,223,4,3,2019,
2,43552,22,0,22,4,3,2019,
3,43552,34,0,34,4,3,2019,
4,43552,85,0,85,4,3,2019,
5,43552,124,0,124,4,3,2019,
6,43552,222,0,222,4,3,2019,
7,43552,296,70,366,4,3,2019,
8,43552,331,219,550,4,3,2019,
9,43552,165,272,437,4,3,2019,
10,43552,118,407,525,4,3,2019,
11,43552,251,43,294,4,3,2019,
12,43552,212,156,368,4,3,2019,
13,43552,144,223,367,4,3,2019,
14,43552,130,268,398,4,3,2019,
15,43552,139,200,339,4,3,2019,
16,43552,87,208,295,4,3,2019,
17,43552,146,256,402,4,3,2019,
18,43552,144,244,388,4,3,2019,
19,43552,46,261,307,4,3,2019,
20,43552,37,206,243,4,3,2019,
21,43552,168,185,353,4,3,2019,
22,43552,281,209,490,4,3,2019,
23,43552,298,164,462,4,3,2019,
0,43553,199,251,450,5,3,2019,
1,43553,127,91,218,5,3,2019,
2,43553,100,0,100,5,3,2019,
3,43553,39,0,39,5,3,2019,
4,43553,88,0,88,5,3,2019,
5,43553,151,2,153,5,3,2019,
6,43553,318,0,318,5,3,2019,
7,43553,337,47,384,5,3,2019,
8,43553,417,191,608,5,3,2019,
9,43553,211,357,568,5,3,2019,
10,43553,258,360,618,5,3,2019,
11,43553,221,112,333,5,3,2019,
12,43553,179,227,406,5,3,2019,
13,43553,92,235,327,5,3,2019,
14,43553,124,185,309,5,3,2019,
15,43553,127,174,301,5,3,2019,
16,43553,146,375,521,5,3,2019,
17,43553,109,239,348,5,3,2019,
18,43553,101,248,349,5,3,2019,
19,43553,78,316,394,5,3,2019,
20,43553,34,165,199,5,3,2019,
21,43553,171,124,295,5,3,2019,
22,43553,416,265,681,5,3,2019,
23,43553,293,214,507,5,3,2019,
0,43554,252,284,536,6,3,2019,
1,43554,152,210,362,6,3,2019,
2,43554,46,2,48,6,3,2019,
3,43554,48,13,61,6,3,2019,
4,43554,112,0,112,6,3,2019,
5,43554,100,0,100,6,3,2019,
6,43554,222,1,223,6,3,2019,
7,43554,348,2,350,6,3,2019,
8,43554,390,292,682,6,3,2019,
9,43554,244,422,666,6,3,2019,
10,43554,277,393,670,6,3,2019,
11,43554,291,183,474,6,3,2019,
12,43554,195,337,532,6,3,2019,
13,43554,79,214,293,6,3,2019,
14,43554,162,326,488,6,3,2019,
15,43554,129,232,361,6,3,2019,
16,43554,199,460,659,6,3,2019,
17,43554,89,401,490,6,3,2019,
18,43554,98,534,632,6,3,2019,
19,43554,51,303,354,6,3,2019,
20,43554,33,147,180,6,3,2019,
21,43554,136,215,351,6,3,2019,
22,43554,257,334,591,6,3,2019,
23,43554,202,331,533,6,3,2019,
0,43555,132,331,463,7,3,2019,
1,43555,91,86,177,7,3,2019,
2,43555,14,0,14,7,3,2019,
3,43555,32,0,32,7,3,2019,
4,43555,110,0,110,7,3,2019,
5,43555,110,0,110,7,3,2019,
6,43555,228,2,230,7,3,2019,
7,43555,292,78,370,7,3,2019,
8,43555,300,255,555,7,3,2019,
9,43555,182,548,730,7,3,2019,
10,43555,150,346,496,7,3,2019,
11,43555,252,0,252,7,3,2019,
12,43555,202,315,517,7,3,2019,
13,43555,218,263,481,7,3,2019,
14,43555,176,361,537,7,3,2019,
15,43555,148,200,348,7,3,2019,
16,43555,141,489,630,7,3,2019,
17,43555,133,383,516,7,3,2019,
18,43555,122,57,179,7,3,2019,
19,43555,61,487,548,7,3,2019,
20,43555,46,383,429,7,3,2019,
21,43555,110,168,278,7,3,2019,
22,43555,193,163,356,7,3,2019,
23,43555,136,402,538,7,3,2019,
0,43556,65,436,501,1,4,2019,
1,43556,65,122,187,1,4,2019,
2,43556,18,29,47,1,4,2019,
3,43556,29,39,68,1,4,2019,
4,43556,34,33,67,1,4,2019,
5,43556,83,0,83,1,4,2019,
6,43556,149,1,150,1,4,2019,
7,43556,249,145,394,1,4,2019,
8,43556,324,171,495,1,4,2019,
9,43556,189,433,622,1,4,2019,
10,43556,78,272,350,1,4,2019,
11,43556,149,173,322,1,4,2019,
12,43556,92,258,350,1,4,2019,
13,43556,96,181,277,1,4,2019,
14,43556,121,246,367,1,4,2019,
15,43556,159,436,595,1,4,2019,
16,43556,139,163,302,1,4,2019,
17,43556,145,143,288,1,4,2019,
18,43556,77,295,372,1,4,2019,
19,43556,28,191,219,1,4,2019,
20,43556,33,377,410,1,4,2019,
21,43556,89,296,385,1,4,2019,
22,43556,148,231,379,1,4,2019,
23,43556,114,249,363,1,4,2019,
0,43557,37,228,265,2,4,2019,
1,43557,31,251,282,2,4,2019,
2,43557,23,0,23,2,4,2019,
3,43557,59,1,60,2,4,2019,
4,43557,17,0,17,2,4,2019,
5,43557,42,0,42,2,4,2019,
6,43557,154,0,154,2,4,2019,
7,43557,225,81,306,2,4,2019,
8,43557,290,238,528,2,4,2019,
9,43557,144,326,470,2,4,2019,
10,43557,99,379,478,2,4,2019,
11,43557,97,103,200,2,4,2019,
12,43557,123,132,255,2,4,2019,
13,43557,82,235,317,2,4,2019,
14,43557,104,198,302,2,4,2019,
15,43557,101,432,533,2,4,2019,
16,43557,84,31,115,2,4,2019,
17,43557,65,164,229,2,4,2019,
18,43557,42,223,265,2,4,2019,
19,43557,22,290,312,2,4,2019,
20,43557,38,149,187,2,4,2019,
21,43557,102,178,280,2,4,2019,
22,43557,155,186,341,2,4,2019,
23,43557,194,208,402,2,4,2019,
0,43558,76,162,238,3,4,2019,
1,43558,18,183,201,3,4,2019,
2,43558,27,3,30,3,4,2019,
3,43558,30,21,51,3,4,2019,
4,43558,25,0,25,3,4,2019,
5,43558,64,0,64,3,4,2019,
6,43558,134,0,134,3,4,2019,
7,43558,249,5,254,3,4,2019,
8,43558,248,234,482,3,4,2019,
9,43558,180,320,500,3,4,2019,
10,43558,118,265,383,3,4,2019,
11,43558,129,110,239,3,4,2019,
12,43558,98,149,247,3,4,2019,
13,43558,48,197,245,3,4,2019,
14,43558,82,202,284,3,4,2019,
15,43558,94,310,404,3,4,2019,
16,43558,105,141,246,3,4,2019,
17,43558,78,102,180,3,4,2019,
18,43558,76,282,358,3,4,2019,
19,43558,22,186,208,3,4,2019,
20,43558,46,205,251,3,4,2019,
21,43558,130,189,319,3,4,2019,
22,43558,220,72,292,3,4,2019,
23,43558,180,155,335,3,4,2019,
0,43559,69,307,376,4,4,2019,
1,43559,50,118,168,4,4,2019,
2,43559,54,0,54,4,4,2019,
3,43559,64,0,64,4,4,2019,
4,43559,49,0,49,4,4,2019,
5,43559,57,1,58,4,4,2019,
6,43559,169,0,169,4,4,2019,
7,43559,280,55,335,4,4,2019,
8,43559,343,220,563,4,4,2019,
9,43559,130,411,541,4,4,2019,
10,43559,97,298,395,4,4,2019,
11,43559,243,124,367,4,4,2019,
12,43559,236,186,422,4,4,2019,
13,43559,115,242,357,4,4,2019,
14,43559,115,94,209,4,4,2019,
15,43559,124,231,355,4,4,2019,
16,43559,124,177,301,4,4,2019,
17,43559,154,85,239,4,4,2019,
18,43559,149,324,473,4,4,2019,
19,43559,24,251,275,4,4,2019,
20,43559,49,141,190,4,4,2019,
21,43559,191,205,396,4,4,2019,
22,43559,233,79,312,4,4,2019,
23,43559,302,211,513,4,4,2019,
0,43560,223,161,384,5,4,2019,
1,43560,77,271,348,5,4,2019,
2,43560,33,27,60,5,4,2019,
3,43560,63,0,63,5,4,2019,
4,43560,60,0,60,5,4,2019,
5,43560,97,0,97,5,4,2019,
6,43560,238,0,238,5,4,2019,
7,43560,361,123,484,5,4,2019,
8,43560,330,205,535,5,4,2019,
9,43560,187,323,510,5,4,2019,
10,43560,127,341,468,5,4,2019,
11,43560,117,172,289,5,4,2019,
12,43560,181,68,249,5,4,2019,
13,43560,105,198,303,5,4,2019,
14,43560,99,115,214,5,4,2019,
15,43560,112,213,325,5,4,2019,
16,43560,81,327,408,5,4,2019,
17,43560,118,159,277,5,4,2019,
18,43560,130,181,311,5,4,2019,
19,43560,48,256,304,5,4,2019,
20,43560,93,123,216,5,4,2019,
21,43560,201,211,412,5,4,2019,
22,43560,191,149,340,5,4,2019,
23,43560,236,222,458,5,4,2019,
0,43561,132,118,250,6,4,2019,
1,43561,65,126,191,6,4,2019,
2,43561,64,150,214,6,4,2019,
3,43561,71,8,79,6,4,2019,
4,43561,18,0,18,6,4,2019,
5,43561,66,0,66,6,4,2019,
6,43561,192,0,192,6,4,2019,
7,43561,305,0,305,6,4,2019,
8,43561,445,185,630,6,4,2019,
9,43561,213,449,662,6,4,2019,
10,43561,130,540,670,6,4,2019,
11,43561,123,88,211,6,4,2019,
12,43561,167,182,349,6,4,2019,
13,43561,71,220,291,6,4,2019,
14,43561,88,269,357,6,4,2019,
15,43561,86,270,356,6,4,2019,
16,43561,133,284,417,6,4,2019,
17,43561,89,136,225,6,4,2019,
18,43561,65,311,376,6,4,2019,
19,43561,27,405,432,6,4,2019,
20,43561,56,133,189,6,4,2019,
21,43561,130,300,430,6,4,2019,
22,43561,218,203,421,6,4,2019,
23,43561,116,301,417,6,4,2019,
0,43562,77,223,300,7,4,2019,
1,43562,33,134,167,7,4,2019,
2,43562,42,62,104,7,4,2019,
3,43562,73,1,74,7,4,2019,
4,43562,59,0,59,7,4,2019,
5,43562,142,0,142,7,4,2019,
6,43562,253,51,304,7,4,2019,
7,43562,192,217,409,7,4,2019,
8,43562,183,535,718,7,4,2019,
9,43562,151,417,568,7,4,2019,
10,43562,120,79,199,7,4,2019,
11,43562,128,203,331,7,4,2019,
12,43562,187,272,459,7,4,2019,
13,43562,151,339,490,7,4,2019,
14,43562,128,343,471,7,4,2019,
15,43562,132,451,583,7,4,2019,
16,43562,123,177,300,7,4,2019,
17,43562,133,167,300,7,4,2019,
18,43562,36,375,411,7,4,2019,
19,43562,37,378,415,7,4,2019,
20,43562,96,142,238,7,4,2019,
21,43562,150,127,277,7,4,2019,
22,43562,159,269,428,7,4,2019,
23,43562,102,325,427,7,4,2019,
0,43563,63,314,377,1,4,2019,
1,43563,29,282,311,1,4,2019,
2,43563,9,118,127,1,4,2019,
3,43563,33,6,39,1,4,2019,
4,43563,20,0,20,1,4,2019,
5,43563,88,0,88,1,4,2019,
6,43563,195,94,289,1,4,2019,
7,43563,163,76,239,1,4,2019,
8,43563,166,480,646,1,4,2019,
9,43563,104,345,449,1,4,2019,
10,43563,107,195,302,1,4,2019,
11,43563,66,206,272,1,4,2019,
12,43563,68,151,219,1,4,2019,
13,43563,131,68,199,1,4,2019,
14,43563,137,245,382,1,4,2019,
15,43563,143,245,388,1,4,2019,
16,43563,152,258,410,1,4,2019,
17,43563,85,381,466,1,4,2019,
18,43563,20,214,234,1,4,2019,
19,43563,26,239,265,1,4,2019,
20,43563,63,218,281,1,4,2019,
21,43563,91,144,235,1,4,2019,
22,43563,121,96,217,1,4,2019,
23,43563,48,136,184,1,4,2019,
0,43564,26,345,371,2,4,2019,
1,43564,30,77,107,2,4,2019,
2,43564,40,0,40,2,4,2019,
3,43564,37,0,37,2,4,2019,
4,43564,44,1,45,2,4,2019,
5,43564,85,0,85,2,4,2019,
6,43564,168,55,223,2,4,2019,
7,43564,175,187,362,2,4,2019,
8,43564,173,259,432,2,4,2019,
9,43564,84,399,483,2,4,2019,
10,43564,103,113,216,2,4,2019,
11,43564,95,151,246,2,4,2019,
12,43564,72,166,238,2,4,2019,
13,43564,124,189,313,2,4,2019,
14,43564,103,103,206,2,4,2019,
15,43564,105,336,441,2,4,2019,
16,43564,68,108,176,2,4,2019,
17,43564,57,392,449,2,4,2019,
18,43564,22,65,87,2,4,2019,
19,43564,29,205,234,2,4,2019,
20,43564,80,28,108,2,4,2019,
21,43564,163,227,390,2,4,2019,
22,43564,129,214,343,2,4,2019,
23,43564,70,244,314,2,4,2019,
0,43565,52,131,183,3,4,2019,
1,43565,11,103,114,3,4,2019,
2,43565,19,1,20,3,4,2019,
3,43565,52,1,53,3,4,2019,
4,43565,29,0,29,3,4,2019,
5,43565,146,0,146,3,4,2019,
6,43565,274,0,274,3,4,2019,
7,43565,125,116,241,3,4,2019,
8,43565,126,329,455,3,4,2019,
9,43565,107,397,504,3,4,2019,
10,43565,134,106,240,3,4,2019,
11,43565,78,178,256,3,4,2019,
12,43565,93,290,383,3,4,2019,
13,43565,131,66,197,3,4,2019,
14,43565,121,165,286,3,4,2019,
15,43565,100,310,410,3,4,2019,
16,43565,112,51,163,3,4,2019,
17,43565,59,285,344,3,4,2019,
18,43565,35,151,186,3,4,2019,
19,43565,33,272,305,3,4,2019,
20,43565,100,62,162,3,4,2019,
21,43565,206,213,419,3,4,2019,
22,43565,205,94,299,3,4,2019,
23,43565,163,229,392,3,4,2019,
0,43566,106,200,306,4,4,2019,
1,43566,55,63,118,4,4,2019,
2,43566,45,0,45,4,4,2019,
3,43566,72,0,72,4,4,2019,
4,43566,63,1,64,4,4,2019,
5,43566,159,0,159,4,4,2019,
6,43566,294,101,395,4,4,2019,
7,43566,301,70,371,4,4,2019,
8,43566,215,489,704,4,4,2019,
9,43566,140,396,536,4,4,2019,
10,43566,195,237,432,4,4,2019,
11,43566,106,173,279,4,4,2019,
12,43566,130,312,442,4,4,2019,
13,43566,140,193,333,4,4,2019,
14,43566,203,198,401,4,4,2019,
15,43566,137,215,352,4,4,2019,
16,43566,143,201,344,4,4,2019,
17,43566,107,386,493,4,4,2019,
18,43566,80,191,271,4,4,2019,
19,43566,31,304,335,4,4,2019,
20,43566,106,254,360,4,4,2019,
21,43566,284,179,463,4,4,2019,
22,43566,327,173,500,4,4,2019,
23,43566,237,223,460,4,4,2019,
0,43567,197,261,458,5,4,2019,
1,43567,52,407,459,5,4,2019,
2,43567,40,29,69,5,4,2019,
3,43567,91,0,91,5,4,2019,
4,43567,83,0,83,5,4,2019,
5,43567,244,0,244,5,4,2019,
6,43567,357,0,357,5,4,2019,
7,43567,271,189,460,5,4,2019,
8,43567,134,460,594,5,4,2019,
9,43567,151,394,545,5,4,2019,
10,43567,182,161,343,5,4,2019,
11,43567,93,217,310,5,4,2019,
12,43567,130,431,561,5,4,2019,
13,43567,111,242,353,5,4,2019,
14,43567,129,239,368,5,4,2019,
15,43567,114,247,361,5,4,2019,
16,43567,125,204,329,5,4,2019,
17,43567,100,368,468,5,4,2019,
18,43567,42,376,418,5,4,2019,
19,43567,87,400,487,5,4,2019,
20,43567,105,280,385,5,4,2019,
21,43567,260,396,656,5,4,2019,
22,43567,246,166,412,5,4,2019,
23,43567,228,295,523,5,4,2019,
0,43568,224,186,410,6,4,2019,
1,43568,57,368,425,6,4,2019,
2,43568,42,20,62,6,4,2019,
3,43568,74,10,84,6,4,2019,
4,43568,150,1,151,6,4,2019,
5,43568,211,0,211,6,4,2019,
6,43568,336,89,425,6,4,2019,
7,43568,270,271,541,6,4,2019,
8,43568,218,597,815,6,4,2019,
9,43568,177,596,773,6,4,2019,
10,43568,124,434,558,6,4,2019,
11,43568,38,344,382,6,4,2019,
12,43568,77,239,316,6,4,2019,
13,43568,121,135,256,6,4,2019,
14,43568,87,369,456,6,4,2019,
15,43568,118,622,740,6,4,2019,
16,43568,82,206,288,6,4,2019,
17,43568,75,560,635,6,4,2019,
18,43568,36,325,361,6,4,2019,
19,43568,35,459,494,6,4,2019,
20,43568,88,169,257,6,4,2019,
21,43568,217,366,583,6,4,2019,
22,43568,182,423,605,6,4,2019,
23,43568,122,290,412,6,4,2019,
0,43569,78,335,413,7,4,2019,
1,43569,22,40,62,7,4,2019,
2,43569,46,0,46,7,4,2019,
3,43569,58,32,90,7,4,2019,
4,43569,56,0,56,7,4,2019,
5,43569,132,0,132,7,4,2019,
6,43569,164,113,277,7,4,2019,
7,43569,210,392,602,7,4,2019,
8,43569,108,630,738,7,4,2019,
9,43569,116,367,483,7,4,2019,
10,43569,194,128,322,7,4,2019,
11,43569,133,219,352,7,4,2019,
12,43569,88,424,512,7,4,2019,
13,43569,117,475,592,7,4,2019,
14,43569,104,337,441,7,4,2019,
15,43569,62,432,494,7,4,2019,
16,43569,80,93,173,7,4,2019,
17,43569,119,274,393,7,4,2019,
18,43569,33,357,390,7,4,2019,
19,43569,22,242,264,7,4,2019,
20,43569,57,315,372,7,4,2019,
21,43569,150,220,370,7,4,2019,
22,43569,172,166,338,7,4,2019,
23,43569,110,375,485,7,4,2019,
0,43570,46,322,368,1,4,2019,
1,43570,21,83,104,1,4,2019,
2,43570,30,67,97,1,4,2019,
3,43570,21,8,29,1,4,2019,
4,43570,55,0,55,1,4,2019,
5,43570,164,0,164,1,4,2019,
6,43570,183,0,183,1,4,2019,
7,43570,197,37,234,1,4,2019,
8,43570,120,608,728,1,4,2019,
9,43570,92,658,750,1,4,2019,
10,43570,102,366,468,1,4,2019,
11,43570,68,383,451,1,4,2019,
12,43570,110,209,319,1,4,2019,
13,43570,90,158,248,1,4,2019,
14,43570,107,285,392,1,4,2019,
15,43570,122,289,411,1,4,2019,
16,43570,141,166,307,1,4,2019,
17,43570,102,290,392,1,4,2019,
18,43570,26,236,262,1,4,2019,
19,43570,32,291,323,1,4,2019,
20,43570,91,107,198,1,4,2019,
21,43570,155,291,446,1,4,2019,
22,43570,171,276,447,1,4,2019,
23,43570,74,285,359,1,4,2019,
0,43571,37,229,266,2,4,2019,
1,43571,28,65,93,2,4,2019,
2,43571,31,8,39,2,4,2019,
3,43571,44,0,44,2,4,2019,
4,43571,71,1,72,2,4,2019,
5,43571,92,0,92,2,4,2019,
6,43571,184,145,329,2,4,2019,
7,43571,150,210,360,2,4,2019,
8,43571,117,557,674,2,4,2019,
9,43571,99,465,564,2,4,2019,
10,43571,82,239,321,2,4,2019,
11,43571,76,212,288,2,4,2019,
12,43571,133,321,454,2,4,2019,
13,43571,127,75,202,2,4,2019,
14,43571,104,334,438,2,4,2019,
15,43571,131,250,381,2,4,2019,
16,43571,97,138,235,2,4,2019,
17,43571,66,459,525,2,4,2019,
18,43571,32,262,294,2,4,2019,
19,43571,24,109,133,2,4,2019,
20,43571,67,134,201,2,4,2019,
21,43571,201,481,682,2,4,2019,
22,43571,262,249,511,2,4,2019,
23,43571,162,158,320,2,4,2019,
0,43572,58,229,287,3,4,2019,
1,43572,32,60,92,3,4,2019,
2,43572,18,0,18,3,4,2019,
3,43572,61,3,64,3,4,2019,
4,43572,56,0,56,3,4,2019,
5,43572,140,0,140,3,4,2019,
6,43572,268,0,268,3,4,2019,
7,43572,236,248,484,3,4,2019,
8,43572,134,455,589,3,4,2019,
9,43572,112,459,571,3,4,2019,
10,43572,137,134,271,3,4,2019,
11,43572,78,413,491,3,4,2019,
12,43572,82,255,337,3,4,2019,
13,43572,130,199,329,3,4,2019,
14,43572,163,188,351,3,4,2019,
15,43572,102,274,376,3,4,2019,
16,43572,116,254,370,3,4,2019,
17,43572,84,253,337,3,4,2019,
18,43572,29,240,269,3,4,2019,
19,43572,46,262,308,3,4,2019,
20,43572,107,165,272,3,4,2019,
21,43572,251,299,550,3,4,2019,
22,43572,243,184,427,3,4,2019,
23,43572,199,462,661,3,4,2019,
0,43573,126,281,407,4,4,2019,
1,43573,51,22,73,4,4,2019,
2,43573,62,0,62,4,4,2019,
3,43573,78,0,78,4,4,2019,
4,43573,64,0,64,4,4,2019,
5,43573,199,0,199,4,4,2019,
6,43573,349,79,428,4,4,2019,
7,43573,382,140,522,4,4,2019,
8,43573,156,663,819,4,4,2019,
9,43573,58,590,648,4,4,2019,
10,43573,136,188,324,4,4,2019,
11,43573,111,355,466,4,4,2019,
12,43573,162,220,382,4,4,2019,
13,43573,179,72,251,4,4,2019,
14,43573,148,254,402,4,4,2019,
15,43573,167,269,436,4,4,2019,
16,43573,155,93,248,4,4,2019,
17,43573,164,274,438,4,4,2019,
18,43573,92,280,372,4,4,2019,
19,43573,58,258,316,4,4,2019,
20,43573,93,115,208,4,4,2019,
21,43573,274,173,447,4,4,2019,
22,43573,344,229,573,4,4,2019,
23,43573,247,250,497,4,4,2019,
0,43574,194,172,366,5,4,2019,
1,43574,85,81,166,5,4,2019,
2,43574,36,25,61,5,4,2019,
3,43574,47,0,47,5,4,2019,
4,43574,127,0,127,5,4,2019,
5,43574,218,0,218,5,4,2019,
6,43574,409,0,409,5,4,2019,
7,43574,274,223,497,5,4,2019,
8,43574,195,489,684,5,4,2019,
9,43574,188,317,505,5,4,2019,
10,43574,208,146,354,5,4,2019,
11,43574,121,298,419,5,4,2019,
12,43574,193,134,327,5,4,2019,
13,43574,196,157,353,5,4,2019,
14,43574,173,215,388,5,4,2019,
15,43574,172,320,492,5,4,2019,
16,43574,246,86,332,5,4,2019,
17,43574,196,145,341,5,4,2019,
18,43574,87,251,338,5,4,2019,
19,43574,125,114,239,5,4,2019,
20,43574,164,58,222,5,4,2019,
21,43574,338,239,577,5,4,2019,
22,43574,299,173,472,5,4,2019,
23,43574,286,211,497,5,4,2019,
0,43575,153,86,239,6,4,2019,
1,43575,53,14,67,6,4,2019,
2,43575,56,6,62,6,4,2019,
3,43575,71,1,72,6,4,2019,
4,43575,96,0,96,6,4,2019,
5,43575,175,0,175,6,4,2019,
6,43575,324,80,404,6,4,2019,
7,43575,352,253,605,6,4,2019,
8,43575,200,427,627,6,4,2019,
9,43575,262,264,526,6,4,2019,
10,43575,305,127,432,6,4,2019,
11,43575,112,302,414,6,4,2019,
12,43575,175,174,349,6,4,2019,
13,43575,261,71,332,6,4,2019,
14,43575,249,284,533,6,4,2019,
15,43575,333,212,545,6,4,2019,
16,43575,346,253,599,6,4,2019,
17,43575,230,259,489,6,4,2019,
18,43575,54,125,179,6,4,2019,
19,43575,86,262,348,6,4,2019,
20,43575,202,65,267,6,4,2019,
21,43575,316,233,549,6,4,2019,
22,43575,226,151,377,6,4,2019,
23,43575,183,182,365,6,4,2019,
0,43576,108,112,220,7,4,2019,
1,43576,27,25,52,7,4,2019,
2,43576,58,0,58,7,4,2019,
3,43576,93,0,93,7,4,2019,
4,43576,104,0,104,7,4,2019,
5,43576,176,0,176,7,4,2019,
6,43576,313,70,383,7,4,2019,
7,43576,353,275,628,7,4,2019,
8,43576,140,629,769,7,4,2019,
9,43576,220,243,463,7,4,2019,
10,43576,319,46,365,7,4,2019,
11,43576,214,292,506,7,4,2019,
12,43576,205,202,407,7,4,2019,
13,43576,265,142,407,7,4,2019,
14,43576,283,365,648,7,4,2019,
15,43576,211,270,481,7,4,2019,
16,43576,336,90,426,7,4,2019,
17,43576,304,136,440,7,4,2019,
18,43576,79,183,262,7,4,2019,
19,43576,97,234,331,7,4,2019,
20,43576,165,86,251,7,4,2019,
21,43576,276,199,475,7,4,2019,
22,43576,328,216,544,7,4,2019,
23,43576,243,243,486,7,4,2019,
0,43577,116,156,272,1,4,2019,
1,43577,46,39,85,1,4,2019,
2,43577,21,16,37,1,4,2019,
3,43577,61,0,61,1,4,2019,
4,43577,67,0,67,1,4,2019,
5,43577,164,0,164,1,4,2019,
6,43577,331,61,392,1,4,2019,
7,43577,354,264,618,1,4,2019,
8,43577,153,497,650,1,4,2019,
9,43577,153,248,401,1,4,2019,
10,43577,263,158,421,1,4,2019,
11,43577,176,285,461,1,4,2019,
12,43577,152,165,317,1,4,2019,
13,43577,206,108,314,1,4,2019,
14,43577,323,144,467,1,4,2019,
15,43577,251,333,584,1,4,2019,
16,43577,371,263,634,1,4,2019,
17,43577,158,262,420,1,4,2019,
18,43577,81,156,237,1,4,2019,
19,43577,94,208,302,1,4,2019,
20,43577,146,111,257,1,4,2019,
21,43577,223,162,385,1,4,2019,
22,43577,237,193,430,1,4,2019,
23,43577,166,329,495,1,4,2019,
0,43578,91,213,304,2,4,2019,
1,43578,31,62,93,2,4,2019,
2,43578,26,47,73,2,4,2019,
3,43578,72,27,99,2,4,2019,
4,43578,77,1,78,2,4,2019,
5,43578,181,0,181,2,4,2019,
6,43578,341,73,414,2,4,2019,
7,43578,248,173,421,2,4,2019,
8,43578,184,498,682,2,4,2019,
9,43578,154,355,509,2,4,2019,
10,43578,225,148,373,2,4,2019,
11,43578,128,194,322,2,4,2019,
12,43578,194,287,481,2,4,2019,
13,43578,277,109,386,2,4,2019,
14,43578,203,204,407,2,4,2019,
15,43578,202,293,495,2,4,2019,
16,43578,162,199,361,2,4,2019,
17,43578,112,313,425,2,4,2019,
18,43578,68,139,207,2,4,2019,
19,43578,39,167,206,2,4,2019,
20,43578,91,62,153,2,4,2019,
21,43578,225,292,517,2,4,2019,
22,43578,277,189,466,2,4,2019,
23,43578,220,124,344,2,4,2019,
0,43579,112,164,276,3,4,2019,
1,43579,20,109,129,3,4,2019,
2,43579,16,0,16,3,4,2019,
3,43579,49,0,49,3,4,2019,
4,43579,84,0,84,3,4,2019,
5,43579,182,0,182,3,4,2019,
6,43579,319,0,319,3,4,2019,
7,43579,218,0,218,3,4,2019,
8,43579,173,0,173,3,4,2019,
9,43579,166,448,614,3,4,2019,
10,43579,215,285,500,3,4,2019,
11,43579,121,363,484,3,4,2019,
12,43579,174,455,629,3,4,2019,
13,43579,199,87,286,3,4,2019,
14,43579,197,93,290,3,4,2019,
15,43579,237,119,356,3,4,2019,
16,43579,212,82,294,3,4,2019,
17,43579,173,419,592,3,4,2019,
18,43579,49,189,238,3,4,2019,
19,43579,23,188,211,3,4,2019,
20,43579,109,90,199,3,4,2019,
21,43579,244,139,383,3,4,2019,
22,43579,352,180,532,3,4,2019,
23,43579,238,252,490,3,4,2019,
0,43580,179,78,257,4,4,2019,
1,43580,51,36,87,4,4,2019,
2,43580,57,36,93,4,4,2019,
3,43580,71,0,71,4,4,2019,
4,43580,82,0,82,4,4,2019,
5,43580,239,0,239,4,4,2019,
6,43580,474,56,530,4,4,2019,
7,43580,356,156,512,4,4,2019,
8,43580,261,517,778,4,4,2019,
9,43580,168,365,533,4,4,2019,
10,43580,207,56,263,4,4,2019,
11,43580,151,170,321,4,4,2019,
12,43580,154,176,330,4,4,2019,
13,43580,204,63,267,4,4,2019,
14,43580,244,226,470,4,4,2019,
15,43580,219,304,523,4,4,2019,
16,43580,231,162,393,4,4,2019,
17,43580,193,209,402,4,4,2019,
18,43580,87,207,294,4,4,2019,
19,43580,21,137,158,4,4,2019,
20,43580,89,100,189,4,4,2019,
21,43580,270,169,439,4,4,2019,
22,43580,345,129,474,4,4,2019,
23,43580,340,130,470,4,4,2019,
0,43581,253,83,336,5,4,2019,
1,43581,133,67,200,5,4,2019,
2,43581,42,1,43,5,4,2019,
3,43581,88,0,88,5,4,2019,
4,43581,89,0,89,5,4,2019,
5,43581,258,0,258,5,4,2019,
6,43581,446,42,488,5,4,2019,
7,43581,379,245,624,5,4,2019,
8,43581,256,319,575,5,4,2019,
9,43581,181,285,466,5,4,2019,
10,43581,248,178,426,5,4,2019,
11,43581,186,75,261,5,4,2019,
12,43581,179,161,340,5,4,2019,
13,43581,221,95,316,5,4,2019,
14,43581,209,173,382,5,4,2019,
15,43581,209,266,475,5,4,2019,
16,43581,216,112,328,5,4,2019,
17,43581,172,146,318,5,4,2019,
18,43581,71,141,212,5,4,2019,
19,43581,54,146,200,5,4,2019,
20,43581,147,65,212,5,4,2019,
21,43581,287,183,470,5,4,2019,
22,43581,312,132,444,5,4,2019,
23,43581,329,167,496,5,4,2019,
0,43582,194,75,269,6,4,2019,
1,43582,39,57,96,6,4,2019,
2,43582,62,28,90,6,4,2019,
3,43582,74,5,79,6,4,2019,
4,43582,45,0,45,6,4,2019,
5,43582,216,2,218,6,4,2019,
6,43582,406,47,453,6,4,2019,
7,43582,330,245,575,6,4,2019,
8,43582,310,487,797,6,4,2019,
9,43582,199,399,598,6,4,2019,
10,43582,252,99,351,6,4,2019,
11,43582,98,270,368,6,4,2019,
12,43582,171,129,300,6,4,2019,
13,43582,264,103,367,6,4,2019,
14,43582,219,170,389,6,4,2019,
15,43582,305,231,536,6,4,2019,
16,43582,237,247,484,6,4,2019,
17,43582,158,326,484,6,4,2019,
18,43582,65,83,148,6,4,2019,
19,43582,58,214,272,6,4,2019,
20,43582,157,94,251,6,4,2019,
21,43582,269,144,413,6,4,2019,
22,43582,237,197,434,6,4,2019,
23,43582,208,201,409,6,4,2019,
0,43583,165,152,317,7,4,2019,
1,43583,47,20,67,7,4,2019,
2,43583,47,0,47,7,4,2019,
3,43583,92,0,92,7,4,2019,
4,43583,92,0,92,7,4,2019,
5,43583,179,0,179,7,4,2019,
6,43583,387,69,456,7,4,2019,
7,43583,329,369,698,7,4,2019,
8,43583,118,493,611,7,4,2019,
9,43583,191,233,424,7,4,2019,
10,43583,335,134,469,7,4,2019,
11,43583,177,285,462,7,4,2019,
12,43583,201,181,382,7,4,2019,
13,43583,215,247,462,7,4,2019,
14,43583,216,319,535,7,4,2019,
15,43583,210,324,534,7,4,2019,
16,43583,245,152,397,7,4,2019,
17,43583,208,301,509,7,4,2019,
18,43583,64,243,307,7,4,2019,
19,43583,54,212,266,7,4,2019,
20,43583,95,111,206,7,4,2019,
21,43583,200,137,337,7,4,2019,
22,43583,242,328,570,7,4,2019,
23,43583,153,312,465,7,4,2019,
0,43584,87,297,384,1,4,2019,
1,43584,76,5,81,1,4,2019,
2,43584,36,6,42,1,4,2019,
3,43584,47,1,48,1,4,2019,
4,43584,56,2,58,1,4,2019,
5,43584,118,2,120,1,4,2019,
6,43584,237,71,308,1,4,2019,
7,43584,265,311,576,1,4,2019,
8,43584,101,433,534,1,4,2019,
9,43584,104,284,388,1,4,2019,
10,43584,135,177,312,1,4,2019,
11,43584,117,196,313,1,4,2019,
12,43584,108,157,265,1,4,2019,
13,43584,182,166,348,1,4,2019,
14,43584,209,248,457,1,4,2019,
15,43584,172,355,527,1,4,2019,
16,43584,155,265,420,1,4,2019,
17,43584,79,232,311,1,4,2019,
18,43584,25,215,240,1,4,2019,
19,43584,54,184,238,1,4,2019,
20,43584,82,106,188,1,4,2019,
21,43584,213,314,527,1,4,2019,
22,43584,175,208,383,1,4,2019,
23,43584,131,328,459,1,4,2019,
0,43585,64,245,309,2,4,2019,
1,43585,44,3,47,2,4,2019,
2,43585,34,0,34,2,4,2019,
3,43585,42,0,42,2,4,2019,
4,43585,59,1,60,2,4,2019,
5,43585,116,0,116,2,4,2019,
6,43585,263,56,319,2,4,2019,
7,43585,240,204,444,2,4,2019,
8,43585,115,218,333,2,4,2019,
9,43585,92,314,406,2,4,2019,
10,43585,175,121,296,2,4,2019,
11,43585,161,272,433,2,4,2019,
12,43585,152,132,284,2,4,2019,
13,43585,110,171,281,2,4,2019,
14,43585,141,178,319,2,4,2019,
15,43585,89,205,294,2,4,2019,
16,43585,109,108,217,2,4,2019,
17,43585,49,332,381,2,4,2019,
18,43585,31,193,224,2,4,2019,
19,43585,42,154,196,2,4,2019,
20,43585,82,106,188,2,4,2019,
21,43585,209,274,483,2,4,2019,
22,43585,197,298,495,2,4,2019,
23,43585,183,94,277,2,4,2019,
0,43586,93,134,227,3,5,2019,
1,43586,23,70,93,3,5,2019,
2,43586,26,29,55,3,5,2019,
3,43586,80,15,95,3,5,2019,
4,43586,94,0,94,3,5,2019,
5,43586,178,0,178,3,5,2019,
6,43586,257,32,289,3,5,2019,
7,43586,135,164,299,3,5,2019,
8,43586,130,524,654,3,5,2019,
9,43586,139,278,417,3,5,2019,
10,43586,189,66,255,3,5,2019,
11,43586,112,273,385,3,5,2019,
12,43586,121,244,365,3,5,2019,
13,43586,148,61,209,3,5,2019,
14,43586,245,180,425,3,5,2019,
15,43586,152,257,409,3,5,2019,
16,43586,159,99,258,3,5,2019,
17,43586,115,293,408,3,5,2019,
18,43586,37,196,233,3,5,2019,
19,43586,26,128,154,3,5,2019,
20,43586,106,75,181,3,5,2019,
21,43586,233,132,365,3,5,2019,
22,43586,306,121,427,3,5,2019,
23,43586,206,211,417,3,5,2019,
0,43587,149,196,345,4,5,2019,
1,43587,38,1,39,4,5,2019,
2,43587,34,0,34,4,5,2019,
3,43587,108,0,108,4,5,2019,
4,43587,113,0,113,4,5,2019,
5,43587,173,0,173,4,5,2019,
6,43587,399,52,451,4,5,2019,
7,43587,392,178,570,4,5,2019,
8,43587,222,402,624,4,5,2019,
9,43587,126,252,378,4,5,2019,
10,43587,254,75,329,4,5,2019,
11,43587,204,205,409,4,5,2019,
12,43587,160,148,308,4,5,2019,
13,43587,243,125,368,4,5,2019,
14,43587,123,136,259,4,5,2019,
15,43587,184,234,418,4,5,2019,
16,43587,187,119,306,4,5,2019,
17,43587,212,269,481,4,5,2019,
18,43587,74,152,226,4,5,2019,
19,43587,58,139,197,4,5,2019,
20,43587,117,166,283,4,5,2019,
21,43587,286,95,381,4,5,2019,
22,43587,347,192,539,4,5,2019,
23,43587,267,148,415,4,5,2019,
0,43588,213,234,447,5,5,2019,
1,43588,102,52,154,5,5,2019,
2,43588,27,0,27,5,5,2019,
3,43588,67,0,67,5,5,2019,
4,43588,115,0,115,5,5,2019,
5,43588,206,0,206,5,5,2019,
6,43588,400,84,484,5,5,2019,
7,43588,309,130,439,5,5,2019,
8,43588,251,426,677,5,5,2019,
9,43588,117,328,445,5,5,2019,
10,43588,202,150,352,5,5,2019,
11,43588,99,215,314,5,5,2019,
12,43588,121,125,246,5,5,2019,
13,43588,152,106,258,5,5,2019,
14,43588,124,191,315,5,5,2019,
15,43588,94,226,320,5,5,2019,
16,43588,138,86,224,5,5,2019,
17,43588,102,226,328,5,5,2019,
18,43588,46,193,239,5,5,2019,
19,43588,21,205,226,5,5,2019,
20,43588,97,108,205,5,5,2019,
21,43588,302,239,541,5,5,2019,
22,43588,360,118,478,5,5,2019,
23,43588,315,210,525,5,5,2019,
0,43589,165,69,234,6,5,2019,
1,43589,50,28,78,6,5,2019,
2,43589,51,0,51,6,5,2019,
3,43589,54,1,55,6,5,2019,
4,43589,93,0,93,6,5,2019,
5,43589,157,0,157,6,5,2019,
6,43589,306,0,306,6,5,2019,
7,43589,402,185,587,6,5,2019,
8,43589,253,507,760,6,5,2019,
9,43589,152,333,485,6,5,2019,
10,43589,138,279,417,6,5,2019,
11,43589,83,160,243,6,5,2019,
12,43589,109,231,340,6,5,2019,
13,43589,96,51,147,6,5,2019,
14,43589,99,269,368,6,5,2019,
15,43589,166,268,434,6,5,2019,
16,43589,208,50,258,6,5,2019,
17,43589,91,327,418,6,5,2019,
18,43589,32,209,241,6,5,2019,
19,43589,20,330,350,6,5,2019,
20,43589,83,27,110,6,5,2019,
21,43589,180,186,366,6,5,2019,
22,43589,262,171,433,6,5,2019,
23,43589,172,184,356,6,5,2019,
0,43590,82,181,263,7,5,2019,
1,43590,19,11,30,7,5,2019,
2,43590,21,35,56,7,5,2019,
3,43590,57,0,57,7,5,2019,
4,43590,83,0,83,7,5,2019,
5,43590,184,0,184,7,5,2019,
6,43590,262,26,288,7,5,2019,
7,43590,248,282,530,7,5,2019,
8,43590,131,550,681,7,5,2019,
9,43590,159,341,500,7,5,2019,
10,43590,158,63,221,7,5,2019,
11,43590,165,296,461,7,5,2019,
12,43590,194,109,303,7,5,2019,
13,43590,212,219,431,7,5,2019,
14,43590,132,258,390,7,5,2019,
15,43590,164,328,492,7,5,2019,
16,43590,177,183,360,7,5,2019,
17,43590,121,187,308,7,5,2019,
18,43590,61,286,347,7,5,2019,
19,43590,57,94,151,7,5,2019,
20,43590,125,167,292,7,5,2019,
21,43590,205,296,501,7,5,2019,
22,43590,227,206,433,7,5,2019,
23,43590,158,280,438,7,5,2019,
0,43591,107,331,438,1,5,2019,
1,43591,30,131,161,1,5,2019,
2,43591,22,0,22,1,5,2019,
3,43591,41,6,47,1,5,2019,
4,43591,42,0,42,1,5,2019,
5,43591,98,0,98,1,5,2019,
6,43591,259,76,335,1,5,2019,
7,43591,248,256,504,1,5,2019,
8,43591,160,410,570,1,5,2019,
9,43591,109,282,391,1,5,2019,
10,43591,115,192,307,1,5,2019,
11,43591,82,191,273,1,5,2019,
12,43591,106,112,218,1,5,2019,
13,43591,131,78,209,1,5,2019,
14,43591,222,157,379,1,5,2019,
15,43591,224,346,570,1,5,2019,
16,43591,211,142,353,1,5,2019,
17,43591,99,294,393,1,5,2019,
18,43591,34,441,475,1,5,2019,
19,43591,18,220,238,1,5,2019,
20,43591,96,158,254,1,5,2019,
21,43591,162,158,320,1,5,2019,
22,43591,261,184,445,1,5,2019,
23,43591,129,220,349,1,5,2019,
0,43592,69,202,271,2,5,2019,
1,43592,13,69,82,2,5,2019,
2,43592,42,30,72,2,5,2019,
3,43592,62,0,62,2,5,2019,
4,43592,67,0,67,2,5,2019,
5,43592,152,0,152,2,5,2019,
6,43592,285,72,357,2,5,2019,
7,43592,236,115,351,2,5,2019,
8,43592,178,327,505,2,5,2019,
9,43592,84,272,356,2,5,2019,
10,43592,142,187,329,2,5,2019,
11,43592,115,185,300,2,5,2019,
12,43592,179,120,299,2,5,2019,
13,43592,178,193,371,2,5,2019,
14,43592,143,200,343,2,5,2019,
15,43592,120,283,403,2,5,2019,
16,43592,161,61,222,2,5,2019,
17,43592,59,339,398,2,5,2019,
18,43592,10,172,182,2,5,2019,
19,43592,31,211,242,2,5,2019,
20,43592,140,91,231,2,5,2019,
21,43592,222,292,514,2,5,2019,
22,43592,300,161,461,2,5,2019,
23,43592,148,148,296,2,5,2019,
0,43593,95,140,235,3,5,2019,
1,43593,24,1,25,3,5,2019,
2,43593,28,32,60,3,5,2019,
3,43593,74,10,84,3,5,2019,
4,43593,72,0,72,3,5,2019,
5,43593,180,0,180,3,5,2019,
6,43593,274,11,285,3,5,2019,
7,43593,267,165,432,3,5,2019,
8,43593,233,288,521,3,5,2019,
9,43593,172,160,332,3,5,2019,
10,43593,177,105,282,3,5,2019,
11,43593,94,167,261,3,5,2019,
12,43593,170,151,321,3,5,2019,
13,43593,194,101,295,3,5,2019,
14,43593,202,180,382,3,5,2019,
15,43593,141,332,473,3,5,2019,
16,43593,137,129,266,3,5,2019,
17,43593,87,189,276,3,5,2019,
18,43593,12,214,226,3,5,2019,
19,43593,49,126,175,3,5,2019,
20,43593,76,111,187,3,5,2019,
21,43593,229,100,329,3,5,2019,
22,43593,373,144,517,3,5,2019,
23,43593,286,105,391,3,5,2019,
0,43594,113,222,335,4,5,2019,
1,43594,29,49,78,4,5,2019,
2,43594,91,0,91,4,5,2019,
3,43594,128,0,128,4,5,2019,
4,43594,151,1,152,4,5,2019,
5,43594,229,0,229,4,5,2019,
6,43594,351,63,414,4,5,2019,
7,43594,448,231,679,4,5,2019,
8,43594,355,311,666,4,5,2019,
9,43594,139,304,443,4,5,2019,
10,43594,212,48,260,4,5,2019,
11,43594,166,201,367,4,5,2019,
12,43594,142,128,270,4,5,2019,
13,43594,166,105,271,4,5,2019,
14,43594,182,192,374,4,5,2019,
15,43594,195,238,433,4,5,2019,
16,43594,215,31,246,4,5,2019,
17,43594,190,253,443,4,5,2019,
18,43594,64,231,295,4,5,2019,
19,43594,40,138,178,4,5,2019,
20,43594,149,150,299,4,5,2019,
21,43594,282,75,357,4,5,2019,
22,43594,381,142,523,4,5,2019,
23,43594,308,108,416,4,5,2019,
0,43595,271,156,427,5,5,2019,
1,43595,83,98,181,5,5,2019,
2,43595,37,34,71,5,5,2019,
3,43595,71,1,72,5,5,2019,
4,43595,82,6,88,5,5,2019,
5,43595,168,2,170,5,5,2019,
6,43595,353,75,428,5,5,2019,
7,43595,330,200,530,5,5,2019,
8,43595,229,365,594,5,5,2019,
9,43595,156,365,521,5,5,2019,
10,43595,177,52,229,5,5,2019,
11,43595,102,298,400,5,5,2019,
12,43595,115,70,185,5,5,2019,
13,43595,130,68,198,5,5,2019,
14,43595,103,195,298,5,5,2019,
15,43595,83,232,315,5,5,2019,
16,43595,161,216,377,5,5,2019,
17,43595,91,175,266,5,5,2019,
18,43595,44,218,262,5,5,2019,
19,43595,31,103,134,5,5,2019,
20,43595,104,186,290,5,5,2019,
21,43595,226,241,467,5,5,2019,
22,43595,288,107,395,5,5,2019,
23,43595,209,196,405,5,5,2019,
0,43596,141,51,192,6,5,2019,
1,43596,50,27,77,6,5,2019,
2,43596,45,1,46,6,5,2019,
3,43596,57,20,77,6,5,2019,
4,43596,55,9,64,6,5,2019,
5,43596,143,0,143,6,5,2019,
6,43596,247,20,267,6,5,2019,
7,43596,403,270,673,6,5,2019,
8,43596,210,487,697,6,5,2019,
9,43596,115,403,518,6,5,2019,
10,43596,112,122,234,6,5,2019,
11,43596,46,204,250,6,5,2019,
12,43596,109,180,289,6,5,2019,
13,43596,103,62,165,6,5,2019,
14,43596,118,222,340,6,5,2019,
15,43596,107,445,552,6,5,2019,
16,43596,75,132,207,6,5,2019,
17,43596,76,412,488,6,5,2019,
18,43596,25,161,186,6,5,2019,
19,43596,28,314,342,6,5,2019,
20,43596,102,225,327,6,5,2019,
21,43596,149,200,349,6,5,2019,
22,43596,161,229,390,6,5,2019,
23,43596,115,265,380,6,5,2019,
0,43597,64,209,273,7,5,2019,
1,43597,15,54,69,7,5,2019,
2,43597,24,0,24,7,5,2019,
3,43597,88,0,88,7,5,2019,
4,43597,107,0,107,7,5,2019,
5,43597,197,0,197,7,5,2019,
6,43597,260,106,366,7,5,2019,
7,43597,206,371,577,7,5,2019,
8,43597,119,539,658,7,5,2019,
9,43597,103,323,426,7,5,2019,
10,43597,145,47,192,7,5,2019,
11,43597,135,332,467,7,5,2019,
12,43597,156,265,421,7,5,2019,
13,43597,198,217,415,7,5,2019,
14,43597,134,398,532,7,5,2019,
15,43597,133,380,513,7,5,2019,
16,43597,126,162,288,7,5,2019,
17,43597,84,251,335,7,5,2019,
18,43597,75,274,349,7,5,2019,
19,43597,41,234,275,7,5,2019,
20,43597,101,173,274,7,5,2019,
21,43597,139,71,210,7,5,2019,
22,43597,212,427,639,7,5,2019,
23,43597,173,239,412,7,5,2019,
0,43598,63,409,472,1,5,2019,
1,43598,25,46,71,1,5,2019,
2,43598,11,13,24,1,5,2019,
3,43598,43,0,43,1,5,2019,
4,43598,25,0,25,1,5,2019,
5,43598,125,0,125,1,5,2019,
6,43598,213,113,326,1,5,2019,
7,43598,194,214,408,1,5,2019,
8,43598,152,526,678,1,5,2019,
9,43598,83,335,418,1,5,2019,
10,43598,94,151,245,1,5,2019,
11,43598,56,169,225,1,5,2019,
12,43598,97,160,257,1,5,2019,
13,43598,152,89,241,1,5,2019,
14,43598,156,192,348,1,5,2019,
15,43598,156,173,329,1,5,2019,
16,43598,167,178,345,1,5,2019,
17,43598,84,285,369,1,5,2019,
18,43598,20,346,366,1,5,2019,
19,43598,36,114,150,1,5,2019,
20,43598,108,164,272,1,5,2019,
21,43598,154,233,387,1,5,2019,
22,43598,148,215,363,1,5,2019,
23,43598,84,213,297,1,5,2019,
0,43599,33,258,291,2,5,2019,
1,43599,11,169,180,2,5,2019,
2,43599,37,32,69,2,5,2019,
3,43599,64,0,64,2,5,2019,
4,43599,69,0,69,2,5,2019,
5,43599,122,0,122,2,5,2019,
6,43599,226,51,277,2,5,2019,
7,43599,193,200,393,2,5,2019,
8,43599,164,397,561,2,5,2019,
9,43599,85,346,431,2,5,2019,
10,43599,131,82,213,2,5,2019,
11,43599,84,217,301,2,5,2019,
12,43599,101,188,289,2,5,2019,
13,43599,109,176,285,2,5,2019,
14,43599,85,332,417,2,5,2019,
15,43599,87,242,329,2,5,2019,
16,43599,66,137,203,2,5,2019,
17,43599,34,309,343,2,5,2019,
18,43599,20,258,278,2,5,2019,
19,43599,29,171,200,2,5,2019,
20,43599,57,49,106,2,5,2019,
21,43599,184,243,427,2,5,2019,
22,43599,165,342,507,2,5,2019,
23,43599,110,155,265,2,5,2019,
0,43600,60,196,256,3,5,2019,
1,43600,6,0,6,3,5,2019,
2,43600,33,3,36,3,5,2019,
3,43600,31,10,41,3,5,2019,
4,43600,41,0,41,3,5,2019,
5,43600,126,0,126,3,5,2019,
6,43600,204,1,205,3,5,2019,
7,43600,231,212,443,3,5,2019,
8,43600,122,386,508,3,5,2019,
9,43600,97,347,444,3,5,2019,
10,43600,129,161,290,3,5,2019,
11,43600,57,213,270,3,5,2019,
12,43600,76,183,259,3,5,2019,
13,43600,136,82,218,3,5,2019,
14,43600,140,203,343,3,5,2019,
15,43600,127,277,404,3,5,2019,
16,43600,133,197,330,3,5,2019,
17,43600,79,158,237,3,5,2019,
18,43600,15,113,128,3,5,2019,
19,43600,15,173,188,3,5,2019,
20,43600,96,93,189,3,5,2019,
21,43600,191,140,331,3,5,2019,
22,43600,311,184,495,3,5,2019,
23,43600,198,301,499,3,5,2019,
0,43601,67,161,228,4,5,2019,
1,43601,36,14,50,4,5,2019,
2,43601,17,0,17,4,5,2019,
3,43601,115,0,115,4,5,2019,
4,43601,97,0,97,4,5,2019,
5,43601,190,0,190,4,5,2019,
6,43601,309,63,372,4,5,2019,
7,43601,308,154,462,4,5,2019,
8,43601,236,419,655,4,5,2019,
9,43601,95,344,439,4,5,2019,
10,43601,168,108,276,4,5,2019,
11,43601,146,177,323,4,5,2019,
12,43601,173,238,411,4,5,2019,
13,43601,170,188,358,4,5,2019,
14,43601,126,175,301,4,5,2019,
15,43601,202,245,447,4,5,2019,
16,43601,173,151,324,4,5,2019,
17,43601,141,334,475,4,5,2019,
18,43601,64,204,268,4,5,2019,
19,43601,24,138,162,4,5,2019,
20,43601,146,42,188,4,5,2019,
21,43601,237,211,448,4,5,2019,
22,43601,300,216,516,4,5,2019,
23,43601,247,184,431,4,5,2019,
0,43602,163,214,377,5,5,2019,
1,43602,20,54,74,5,5,2019,
2,43602,37,3,40,5,5,2019,
3,43602,71,0,71,5,5,2019,
4,43602,51,0,51,5,5,2019,
5,43602,217,0,217,5,5,2019,
6,43602,322,90,412,5,5,2019,
7,43602,263,108,371,5,5,2019,
8,43602,247,465,712,5,5,2019,
9,43602,148,433,581,5,5,2019,
10,43602,130,136,266,5,5,2019,
11,43602,74,218,292,5,5,2019,
12,43602,105,97,202,5,5,2019,
13,43602,137,72,209,5,5,2019,
14,43602,106,392,498,5,5,2019,
15,43602,117,158,275,5,5,2019,
16,43602,141,160,301,5,5,2019,
17,43602,74,173,247,5,5,2019,
18,43602,33,332,365,5,5,2019,
19,43602,33,196,229,5,5,2019,
20,43602,82,140,222,5,5,2019,
21,43602,255,166,421,5,5,2019,
22,43602,264,112,376,5,5,2019,
23,43602,211,231,442,5,5,2019,
0,43603,139,117,256,6,5,2019,
1,43603,45,71,116,6,5,2019,
2,43603,15,54,69,6,5,2019,
3,43603,67,1,68,6,5,2019,
4,43603,40,0,40,6,5,2019,
5,43603,152,0,152,6,5,2019,
6,43603,303,1,304,6,5,2019,
7,43603,346,174,520,6,5,2019,
8,43603,232,501,733,6,5,2019,
9,43603,124,475,599,6,5,2019,
10,43603,134,225,359,6,5,2019,
11,43603,105,230,335,6,5,2019,
12,43603,126,177,303,6,5,2019,
13,43603,125,188,313,6,5,2019,
14,43603,116,261,377,6,5,2019,
15,43603,179,319,498,6,5,2019,
16,43603,110,195,305,6,5,2019,
17,43603,62,281,343,6,5,2019,
18,43603,20,80,100,6,5,2019,
19,43603,22,330,352,6,5,2019,
20,43603,71,70,141,6,5,2019,
21,43603,152,198,350,6,5,2019,
22,43603,135,266,401,6,5,2019,
23,43603,81,161,242,6,5,2019,
0,43604,38,187,225,7,5,2019,
1,43604,14,11,25,7,5,2019,
2,43604,42,0,42,7,5,2019,
3,43604,78,0,78,7,5,2019,
4,43604,83,0,83,7,5,2019,
5,43604,174,0,174,7,5,2019,
6,43604,293,104,397,7,5,2019,
7,43604,250,289,539,7,5,2019,
8,43604,146,586,732,7,5,2019,
9,43604,125,132,257,7,5,2019,
10,43604,171,126,297,7,5,2019,
11,43604,117,211,328,7,5,2019,
12,43604,138,378,516,7,5,2019,
13,43604,180,132,312,7,5,2019,
14,43604,156,342,498,7,5,2019,
15,43604,176,347,523,7,5,2019,
16,43604,198,149,347,7,5,2019,
17,43604,153,361,514,7,5,2019,
18,43604,62,274,336,7,5,2019,
19,43604,39,217,256,7,5,2019,
20,43604,72,228,300,7,5,2019,
21,43604,187,97,284,7,5,2019,
22,43604,175,253,428,7,5,2019,
23,43604,124,267,391,7,5,2019,
0,43605,71,109,180,1,5,2019,
1,43605,34,196,230,1,5,2019,
2,43605,16,0,16,1,5,2019,
3,43605,43,11,54,1,5,2019,
4,43605,38,0,38,1,5,2019,
5,43605,103,0,103,1,5,2019,
6,43605,218,76,294,1,5,2019,
7,43605,218,138,356,1,5,2019,
8,43605,180,276,456,1,5,2019,
9,43605,68,418,486,1,5,2019,
10,43605,121,214,335,1,5,2019,
11,43605,47,191,238,1,5,2019,
12,43605,91,114,205,1,5,2019,
13,43605,113,109,222,1,5,2019,
14,43605,135,188,323,1,5,2019,
15,43605,183,296,479,1,5,2019,
16,43605,149,75,224,1,5,2019,
17,43605,57,506,563,1,5,2019,
18,43605,12,199,211,1,5,2019,
19,43605,28,219,247,1,5,2019,
20,43605,55,17,72,1,5,2019,
21,43605,162,222,384,1,5,2019,
22,43605,154,146,300,1,5,2019,
23,43605,62,480,542,1,5,2019,
0,43606,32,237,269,2,5,2019,
1,43606,20,40,60,2,5,2019,
2,43606,14,51,65,2,5,2019,
3,43606,65,0,65,2,5,2019,
4,43606,70,0,70,2,5,2019,
5,43606,110,1,111,2,5,2019,
6,43606,259,78,337,2,5,2019,
7,43606,246,148,394,2,5,2019,
8,43606,174,296,470,2,5,2019,
9,43606,129,355,484,2,5,2019,
10,43606,97,157,254,2,5,2019,
11,43606,114,181,295,2,5,2019,
12,43606,195,190,385,2,5,2019,
13,43606,141,144,285,2,5,2019,
14,43606,105,144,249,2,5,2019,
15,43606,141,236,377,2,5,2019,
16,43606,147,210,357,2,5,2019,
17,43606,56,342,398,2,5,2019,
18,43606,21,181,202,2,5,2019,
19,43606,24,73,97,2,5,2019,
20,43606,84,162,246,2,5,2019,
21,43606,214,203,417,2,5,2019,
22,43606,247,204,451,2,5,2019,
23,43606,135,166,301,2,5,2019,
0,43607,73,84,157,3,5,2019,
1,43607,11,3,14,3,5,2019,
2,43607,19,6,25,3,5,2019,
3,43607,28,2,30,3,5,2019,
4,43607,81,46,127,3,5,2019,
5,43607,168,0,168,3,5,2019,
6,43607,221,4,225,3,5,2019,
7,43607,257,209,466,3,5,2019,
8,43607,204,303,507,3,5,2019,
9,43607,163,333,496,3,5,2019,
10,43607,160,116,276,3,5,2019,
11,43607,93,222,315,3,5,2019,
12,43607,126,148,274,3,5,2019,
13,43607,135,79,214,3,5,2019,
14,43607,131,260,391,3,5,2019,
15,43607,169,167,336,3,5,2019,
16,43607,137,203,340,3,5,2019,
17,43607,119,264,383,3,5,2019,
18,43607,33,188,221,3,5,2019,
19,43607,21,134,155,3,5,2019,
20,43607,96,84,180,3,5,2019,
21,43607,298,235,533,3,5,2019,
22,43607,374,201,575,3,5,2019,
23,43607,321,172,493,3,5,2019,
0,43608,149,156,305,4,5,2019,
1,43608,24,1,25,4,5,2019,
2,43608,60,0,60,4,5,2019,
3,43608,121,0,121,4,5,2019,
4,43608,125,0,125,4,5,2019,
5,43608,304,3,307,4,5,2019,
6,43608,467,63,530,4,5,2019,
7,43608,401,202,603,4,5,2019,
8,43608,349,381,730,4,5,2019,
9,43608,151,376,527,4,5,2019,
10,43608,321,69,390,4,5,2019,
11,43608,176,169,345,4,5,2019,
12,43608,203,275,478,4,5,2019,
13,43608,178,93,271,4,5,2019,
14,43608,205,187,392,4,5,2019,
15,43608,244,255,499,4,5,2019,
16,43608,290,31,321,4,5,2019,
17,43608,234,284,518,4,5,2019,
18,43608,62,177,239,4,5,2019,
19,43608,41,149,190,4,5,2019,
20,43608,168,167,335,4,5,2019,
21,43608,424,140,564,4,5,2019,
22,43608,420,130,550,4,5,2019,
23,43608,335,228,563,4,5,2019,
0,43609,345,192,537,5,5,2019,
1,43609,101,3,104,5,5,2019,
2,43609,55,0,55,5,5,2019,
3,43609,139,2,141,5,5,2019,
4,43609,141,0,141,5,5,2019,
5,43609,321,0,321,5,5,2019,
6,43609,474,75,549,5,5,2019,
7,43609,472,187,659,5,5,2019,
8,43609,375,368,743,5,5,2019,
9,43609,276,336,612,5,5,2019,
10,43609,241,127,368,5,5,2019,
11,43609,141,44,185,5,5,2019,
12,43609,239,211,450,5,5,2019,
13,43609,207,155,362,5,5,2019,
14,43609,232,317,549,5,5,2019,
15,43609,242,177,419,5,5,2019,
16,43609,276,97,373,5,5,2019,
17,43609,136,145,281,5,5,2019,
18,43609,67,210,277,5,5,2019,
19,43609,64,165,229,5,5,2019,
20,43609,156,102,258,5,5,2019,
21,43609,285,193,478,5,5,2019,
22,43609,374,125,499,5,5,2019,
23,43609,285,190,475,5,5,2019,
0,43610,357,112,469,6,5,2019,
1,43610,82,60,142,6,5,2019,
2,43610,77,8,85,6,5,2019,
3,43610,68,2,70,6,5,2019,
4,43610,67,0,67,6,5,2019,
5,43610,245,2,247,6,5,2019,
6,43610,424,1,425,6,5,2019,
7,43610,575,213,788,6,5,2019,
8,43610,335,410,745,6,5,2019,
9,43610,224,285,509,6,5,2019,
10,43610,289,127,416,6,5,2019,
11,43610,114,344,458,6,5,2019,
12,43610,165,73,238,6,5,2019,
13,43610,229,99,328,6,5,2019,
14,43610,170,232,402,6,5,2019,
15,43610,222,317,539,6,5,2019,
16,43610,185,261,446,6,5,2019,
17,43610,101,260,361,6,5,2019,
18,43610,60,137,197,6,5,2019,
19,43610,47,219,266,6,5,2019,
20,43610,131,89,220,6,5,2019,
21,43610,220,256,476,6,5,2019,
22,43610,243,87,330,6,5,2019,
23,43610,209,167,376,6,5,2019,
0,43611,117,199,316,7,5,2019,
1,43611,42,4,46,7,5,2019,
2,43611,33,1,34,7,5,2019,
3,43611,134,0,134,7,5,2019,
4,43611,106,0,106,7,5,2019,
5,43611,199,0,199,7,5,2019,
6,43611,295,28,323,7,5,2019,
7,43611,264,242,506,7,5,2019,
8,43611,184,376,560,7,5,2019,
9,43611,116,337,453,7,5,2019,
10,43611,160,60,220,7,5,2019,
11,43611,169,234,403,7,5,2019,
12,43611,183,159,342,7,5,2019,
13,43611,151,150,301,7,5,2019,
14,43611,154,266,420,7,5,2019,
15,43611,148,390,538,7,5,2019,
16,43611,167,84,251,7,5,2019,
17,43611,183,217,400,7,5,2019,
18,43611,43,249,292,7,5,2019,
19,43611,39,228,267,7,5,2019,
20,43611,113,67,180,7,5,2019,
21,43611,193,277,470,7,5,2019,
22,43611,232,222,454,7,5,2019,
23,43611,152,207,359,7,5,2019,
0,43612,112,342,454,1,5,2019,
1,43612,42,62,104,1,5,2019,
2,43612,18,2,20,1,5,2019,
3,43612,45,9,54,1,5,2019,
4,43612,37,0,37,1,5,2019,
5,43612,117,0,117,1,5,2019,
6,43612,254,109,363,1,5,2019,
7,43612,275,282,557,1,5,2019,
8,43612,155,589,744,1,5,2019,
9,43612,178,448,626,1,5,2019,
10,43612,142,263,405,1,5,2019,
11,43612,75,337,412,1,5,2019,
12,43612,134,112,246,1,5,2019,
13,43612,150,325,475,1,5,2019,
14,43612,156,303,459,1,5,2019,
15,43612,201,519,720,1,5,2019,
16,43612,224,201,425,1,5,2019,
17,43612,115,531,646,1,5,2019,
18,43612,16,589,605,1,5,2019,
19,43612,33,273,306,1,5,2019,
20,43612,109,225,334,1,5,2019,
21,43612,177,353,530,1,5,2019,
22,43612,206,383,589,1,5,2019,
23,43612,45,691,736,1,5,2019,
0,43613,34,398,432,2,5,2019,
1,43613,19,13,32,2,5,2019,
2,43613,39,1,40,2,5,2019,
3,43613,85,10,95,2,5,2019,
4,43613,63,0,63,2,5,2019,
5,43613,165,0,165,2,5,2019,
6,43613,209,138,347,2,5,2019,
7,43613,248,361,609,2,5,2019,
8,43613,184,386,570,2,5,2019,
9,43613,112,351,463,2,5,2019,
10,43613,170,133,303,2,5,2019,
11,43613,97,216,313,2,5,2019,
12,43613,124,359,483,2,5,2019,
13,43613,151,172,323,2,5,2019,
14,43613,100,290,390,2,5,2019,
15,43613,108,224,332,2,5,2019,
16,43613,114,302,416,2,5,2019,
17,43613,52,428,480,2,5,2019,
18,43613,26,321,347,2,5,2019,
19,43613,28,161,189,2,5,2019,
20,43613,78,186,264,2,5,2019,
21,43613,230,383,613,2,5,2019,
22,43613,212,167,379,2,5,2019,
23,43613,94,322,416,2,5,2019,
0,43614,77,202,279,3,5,2019,
1,43614,20,16,36,3,5,2019,
2,43614,31,5,36,3,5,2019,
3,43614,52,4,56,3,5,2019,
4,43614,74,0,74,3,5,2019,
5,43614,164,1,165,3,5,2019,
6,43614,219,15,234,3,5,2019,
7,43614,152,236,388,3,5,2019,
8,43614,134,359,493,3,5,2019,
9,43614,99,271,370,3,5,2019,
10,43614,177,193,370,3,5,2019,
11,43614,57,243,300,3,5,2019,
12,43614,85,160,245,3,5,2019,
13,43614,137,3,140,3,5,2019,
14,43614,112,324,436,3,5,2019,
15,43614,189,284,473,3,5,2019,
16,43614,88,150,238,3,5,2019,
17,43614,73,276,349,3,5,2019,
18,43614,18,155,173,3,5,2019,
19,43614,16,180,196,3,5,2019,
20,43614,90,218,308,3,5,2019,
21,43614,249,72,321,3,5,2019,
22,43614,242,273,515,3,5,2019,
23,43614,175,238,413,3,5,2019,
0,43615,54,141,195,4,5,2019,
1,43615,43,1,44,4,5,2019,
2,43615,22,0,22,4,5,2019,
3,43615,86,0,86,4,5,2019,
4,43615,80,0,80,4,5,2019,
5,43615,191,1,192,4,5,2019,
6,43615,331,55,386,4,5,2019,
7,43615,293,202,495,4,5,2019,
8,43615,194,318,512,4,5,2019,
9,43615,128,445,573,4,5,2019,
10,43615,146,8,154,4,5,2019,
11,43615,132,237,369,4,5,2019,
12,43615,126,186,312,4,5,2019,
13,43615,133,81,214,4,5,2019,
14,43615,143,242,385,4,5,2019,
15,43615,114,179,293,4,5,2019,
16,43615,151,168,319,4,5,2019,
17,43615,131,303,434,4,5,2019,
18,43615,59,288,347,4,5,2019,
19,43615,23,37,60,4,5,2019,
20,43615,135,75,210,4,5,2019,
21,43615,279,391,670,4,5,2019,
22,43615,321,117,438,4,5,2019,
23,43615,252,231,483,4,5,2019,
0,43616,121,195,316,5,5,2019,
1,43616,45,66,111,5,5,2019,
2,43616,37,1,38,5,5,2019,
3,43616,108,0,108,5,5,2019,
4,43616,85,0,85,5,5,2019,
5,43616,201,2,203,5,5,2019,
6,43616,307,114,421,5,5,2019,
7,43616,278,187,465,5,5,2019,
8,43616,231,351,582,5,5,2019,
9,43616,157,488,645,5,5,2019,
10,43616,135,194,329,5,5,2019,
11,43616,92,213,305,5,5,2019,
12,43616,93,150,243,5,5,2019,
13,43616,153,67,220,5,5,2019,
14,43616,141,210,351,5,5,2019,
15,43616,145,285,430,5,5,2019,
16,43616,157,221,378,5,5,2019,
17,43616,136,204,340,5,5,2019,
18,43616,38,251,289,5,5,2019,
19,43616,38,227,265,5,5,2019,
20,43616,132,44,176,5,5,2019,
21,43616,273,365,638,5,5,2019,
22,43616,369,274,643,5,5,2019,
23,43616,218,144,362,5,5,2019,
0,43617,91,93,184,6,6,2019,
1,43617,42,171,213,6,6,2019,
2,43617,34,12,46,6,6,2019,
3,43617,76,1,77,6,6,2019,
4,43617,58,0,58,6,6,2019,
5,43617,146,1,147,6,6,2019,
6,43617,313,50,363,6,6,2019,
7,43617,352,189,541,6,6,2019,
8,43617,222,496,718,6,6,2019,
9,43617,150,401,551,6,6,2019,
10,43617,114,107,221,6,6,2019,
11,43617,62,307,369,6,6,2019,
12,43617,114,164,278,6,6,2019,
13,43617,115,178,293,6,6,2019,
14,43617,133,141,274,6,6,2019,
15,43617,122,373,495,6,6,2019,
16,43617,98,181,279,6,6,2019,
17,43617,89,222,311,6,6,2019,
18,43617,39,278,317,6,6,2019,
19,43617,46,221,267,6,6,2019,
20,43617,123,122,245,6,6,2019,
21,43617,202,209,411,6,6,2019,
22,43617,206,196,402,6,6,2019,
23,43617,168,179,347,6,6,2019,
0,43618,84,161,245,7,6,2019,
1,43618,14,36,50,7,6,2019,
2,43618,73,0,73,7,6,2019,
3,43618,106,0,106,7,6,2019,
4,43618,134,0,134,7,6,2019,
5,43618,174,0,174,7,6,2019,
6,43618,246,68,314,7,6,2019,
7,43618,235,389,624,7,6,2019,
8,43618,145,461,606,7,6,2019,
9,43618,143,255,398,7,6,2019,
10,43618,170,50,220,7,6,2019,
11,43618,198,302,500,7,6,2019,
12,43618,165,147,312,7,6,2019,
13,43618,174,189,363,7,6,2019,
14,43618,140,259,399,7,6,2019,
15,43618,198,362,560,7,6,2019,
16,43618,177,168,345,7,6,2019,
17,43618,145,119,264,7,6,2019,
18,43618,65,348,413,7,6,2019,
19,43618,68,138,206,7,6,2019,
20,43618,116,102,218,7,6,2019,
21,43618,242,157,399,7,6,2019,
22,43618,186,244,430,7,6,2019,
23,43618,158,381,539,7,6,2019,
0,43619,102,301,403,1,6,2019,
1,43619,54,0,54,1,6,2019,
2,43619,39,12,51,1,6,2019,
3,43619,67,6,73,1,6,2019,
4,43619,40,0,40,1,6,2019,
5,43619,114,0,114,1,6,2019,
6,43619,263,10,273,1,6,2019,
7,43619,339,349,688,1,6,2019,
8,43619,226,288,514,1,6,2019,
9,43619,198,198,396,1,6,2019,
10,43619,141,103,244,1,6,2019,
11,43619,112,243,355,1,6,2019,
12,43619,152,88,240,1,6,2019,
13,43619,155,127,282,1,6,2019,
14,43619,153,182,335,1,6,2019,
15,43619,168,349,517,1,6,2019,
16,43619,187,166,353,1,6,2019,
17,43619,162,242,404,1,6,2019,
18,43619,44,280,324,1,6,2019,
19,43619,33,181,214,1,6,2019,
20,43619,122,167,289,1,6,2019,
21,43619,244,225,469,1,6,2019,
22,43619,228,104,332,1,6,2019,
23,43619,116,258,374,1,6,2019,
0,43620,86,182,268,2,6,2019,
1,43620,24,0,24,2,6,2019,
2,43620,67,11,78,2,6,2019,
3,43620,68,0,68,2,6,2019,
4,43620,90,1,91,2,6,2019,
5,43620,183,0,183,2,6,2019,
6,43620,278,21,299,2,6,2019,
7,43620,246,185,431,2,6,2019,
8,43620,199,394,593,2,6,2019,
9,43620,131,216,347,2,6,2019,
10,43620,155,135,290,2,6,2019,
11,43620,97,180,277,2,6,2019,
12,43620,127,191,318,2,6,2019,
13,43620,154,134,288,2,6,2019,
14,43620,169,279,448,2,6,2019,
15,43620,126,193,319,2,6,2019,
16,43620,137,193,330,2,6,2019,
17,43620,88,221,309,2,6,2019,
18,43620,27,175,202,2,6,2019,
19,43620,30,105,135,2,6,2019,
20,43620,130,172,302,2,6,2019,
21,43620,230,214,444,2,6,2019,
22,43620,269,55,324,2,6,2019,
23,43620,198,148,346,2,6,2019,
0,43621,114,258,372,3,6,2019,
1,43621,18,22,40,3,6,2019,
2,43621,30,3,33,3,6,2019,
3,43621,96,0,96,3,6,2019,
4,43621,131,0,131,3,6,2019,
5,43621,150,0,150,3,6,2019,
6,43621,284,1,285,3,6,2019,
7,43621,242,116,358,3,6,2019,
8,43621,139,227,366,3,6,2019,
9,43621,158,288,446,3,6,2019,
10,43621,171,202,373,3,6,2019,
11,43621,74,243,317,3,6,2019,
12,43621,143,218,361,3,6,2019,
13,43621,121,32,153,3,6,2019,
14,43621,125,107,232,3,6,2019,
15,43621,131,141,272,3,6,2019,
16,43621,116,149,265,3,6,2019,
17,43621,112,327,439,3,6,2019,
18,43621,37,186,223,3,6,2019,
19,43621,22,130,152,3,6,2019,
20,43621,151,107,258,3,6,2019,
21,43621,345,188,533,3,6,2019,
22,43621,275,148,423,3,6,2019,
23,43621,243,114,357,3,6,2019,
0,43622,167,205,372,4,6,2019,
1,43622,42,13,55,4,6,2019,
2,43622,67,0,67,4,6,2019,
3,43622,131,0,131,4,6,2019,
4,43622,108,10,118,4,6,2019,
5,43622,195,0,195,4,6,2019,
6,43622,344,24,368,4,6,2019,
7,43622,344,214,558,4,6,2019,
8,43622,242,263,505,4,6,2019,
9,43622,135,271,406,4,6,2019,
10,43622,191,3,194,4,6,2019,
11,43622,159,211,370,4,6,2019,
12,43622,223,169,392,4,6,2019,
13,43622,158,39,197,4,6,2019,
14,43622,148,179,327,4,6,2019,
15,43622,166,185,351,4,6,2019,
16,43622,158,112,270,4,6,2019,
17,43622,211,224,435,4,6,2019,
18,43622,56,207,263,4,6,2019,
19,43622,28,88,116,4,6,2019,
20,43622,163,109,272,4,6,2019,
21,43622,404,99,503,4,6,2019,
22,43622,338,196,534,4,6,2019,
23,43622,231,157,388,4,6,2019,
0,43623,242,228,470,5,6,2019,
1,43623,78,83,161,5,6,2019,
2,43623,22,3,25,5,6,2019,
3,43623,101,0,101,5,6,2019,
4,43623,100,0,100,5,6,2019,
5,43623,198,0,198,5,6,2019,
6,43623,364,26,390,5,6,2019,
7,43623,319,56,375,5,6,2019,
8,43623,329,253,582,5,6,2019,
9,43623,175,390,565,5,6,2019,
10,43623,161,115,276,5,6,2019,
11,43623,140,141,281,5,6,2019,
12,43623,184,130,314,5,6,2019,
13,43623,152,84,236,5,6,2019,
14,43623,138,271,409,5,6,2019,
15,43623,120,148,268,5,6,2019,
16,43623,122,136,258,5,6,2019,
17,43623,110,229,339,5,6,2019,
18,43623,63,86,149,5,6,2019,
19,43623,48,132,180,5,6,2019,
20,43623,178,147,325,5,6,2019,
21,43623,316,160,476,5,6,2019,
22,43623,330,75,405,5,6,2019,
23,43623,305,110,415,5,6,2019,
0,43624,202,190,392,6,6,2019,
1,43624,74,136,210,6,6,2019,
2,43624,86,14,100,6,6,2019,
3,43624,112,4,116,6,6,2019,
4,43624,65,1,66,6,6,2019,
5,43624,154,0,154,6,6,2019,
6,43624,413,10,423,6,6,2019,
7,43624,470,160,630,6,6,2019,
8,43624,411,484,895,6,6,2019,
9,43624,255,304,559,6,6,2019,
10,43624,180,159,339,6,6,2019,
11,43624,97,245,342,6,6,2019,
12,43624,185,117,302,6,6,2019,
13,43624,141,125,266,6,6,2019,
14,43624,183,277,460,6,6,2019,
15,43624,163,258,421,6,6,2019,
16,43624,179,186,365,6,6,2019,
17,43624,99,315,414,6,6,2019,
18,43624,57,145,202,6,6,2019,
19,43624,57,226,283,6,6,2019,
20,43624,153,201,354,6,6,2019,
21,43624,239,179,418,6,6,2019,
22,43624,263,93,356,6,6,2019,
23,43624,221,154,375,6,6,2019,
0,43625,163,117,280,7,6,2019,
1,43625,40,59,99,7,6,2019,
2,43625,97,9,106,7,6,2019,
3,43625,123,0,123,7,6,2019,
4,43625,111,0,111,7,6,2019,
5,43625,232,0,232,7,6,2019,
6,43625,296,34,330,7,6,2019,
7,43625,248,407,655,7,6,2019,
8,43625,118,415,533,7,6,2019,
9,43625,188,225,413,7,6,2019,
10,43625,201,95,296,7,6,2019,
11,43625,208,254,462,7,6,2019,
12,43625,200,208,408,7,6,2019,
13,43625,155,120,275,7,6,2019,
14,43625,107,477,584,7,6,2019,
15,43625,114,241,355,7,6,2019,
16,43625,208,156,364,7,6,2019,
17,43625,157,201,358,7,6,2019,
18,43625,64,230,294,7,6,2019,
19,43625,74,188,262,7,6,2019,
20,43625,144,149,293,7,6,2019,
21,43625,290,176,466,7,6,2019,
22,43625,219,135,354,7,6,2019,
23,43625,152,228,380,7,6,2019,
0,43626,132,252,384,1,6,2019,
1,43626,41,4,45,1,6,2019,
2,43626,17,4,21,1,6,2019,
3,43626,59,0,59,1,6,2019,
4,43626,77,0,77,1,6,2019,
5,43626,226,0,226,1,6,2019,
6,43626,290,5,295,1,6,2019,
7,43626,339,265,604,1,6,2019,
8,43626,227,325,552,1,6,2019,
9,43626,135,293,428,1,6,2019,
10,43626,190,82,272,1,6,2019,
11,43626,117,202,319,1,6,2019,
12,43626,166,188,354,1,6,2019,
13,43626,141,174,315,1,6,2019,
14,43626,163,162,325,1,6,2019,
15,43626,150,305,455,1,6,2019,
16,43626,130,160,290,1,6,2019,
17,43626,130,168,298,1,6,2019,
18,43626,66,318,384,1,6,2019,
19,43626,45,214,259,1,6,2019,
20,43626,134,232,366,1,6,2019,
21,43626,325,156,481,1,6,2019,
22,43626,255,114,369,1,6,2019,
23,43626,118,330,448,1,6,2019,
0,43627,128,151,279,2,6,2019,
1,43627,28,31,59,2,6,2019,
2,43627,79,55,134,2,6,2019,
3,43627,95,0,95,2,6,2019,
4,43627,124,1,125,2,6,2019,
5,43627,194,0,194,2,6,2019,
6,43627,318,0,318,2,6,2019,
7,43627,303,1,304,2,6,2019,
8,43627,268,139,407,2,6,2019,
9,43627,218,237,455,2,6,2019,
10,43627,244,292,536,2,6,2019,
11,43627,180,183,363,2,6,2019,
12,43627,204,163,367,2,6,2019,
13,43627,135,6,141,2,6,2019,
14,43627,140,255,395,2,6,2019,
15,43627,176,372,548,2,6,2019,
16,43627,165,180,345,2,6,2019,
17,43627,109,326,435,2,6,2019,
18,43627,56,102,158,2,6,2019,
19,43627,47,271,318,2,6,2019,
20,43627,189,67,256,2,6,2019,
21,43627,276,181,457,2,6,2019,
22,43627,268,130,398,2,6,2019,
23,43627,192,215,407,2,6,2019,
0,43628,161,134,295,3,6,2019,
1,43628,17,60,77,3,6,2019,
2,43628,44,2,46,3,6,2019,
3,43628,127,0,127,3,6,2019,
4,43628,136,0,136,3,6,2019,
5,43628,167,0,167,3,6,2019,
6,43628,331,0,331,3,6,2019,
7,43628,274,60,334,3,6,2019,
8,43628,203,296,499,3,6,2019,
9,43628,226,319,545,3,6,2019,
10,43628,193,158,351,3,6,2019,
11,43628,102,191,293,3,6,2019,
12,43628,92,190,282,3,6,2019,
13,43628,159,40,199,3,6,2019,
14,43628,125,232,357,3,6,2019,
15,43628,97,240,337,3,6,2019,
16,43628,108,118,226,3,6,2019,
17,43628,117,367,484,3,6,2019,
18,43628,28,154,182,3,6,2019,
19,43628,30,183,213,3,6,2019,
20,43628,151,22,173,3,6,2019,
21,43628,326,245,571,3,6,2019,
22,43628,322,56,378,3,6,2019,
23,43628,242,121,363,3,6,2019,
0,43629,220,159,379,4,6,2019,
1,43629,66,9,75,4,6,2019,
2,43629,79,0,79,4,6,2019,
3,43629,141,0,141,4,6,2019,
4,43629,173,1,174,4,6,2019,
5,43629,238,0,238,4,6,2019,
6,43629,404,1,405,4,6,2019,
7,43629,435,205,640,4,6,2019,
8,43629,264,300,564,4,6,2019,
9,43629,177,323,500,4,6,2019,
10,43629,212,44,256,4,6,2019,
11,43629,189,213,402,4,6,2019,
12,43629,264,175,439,4,6,2019,
13,43629,205,135,340,4,6,2019,
14,43629,218,147,365,4,6,2019,
15,43629,167,306,473,4,6,2019,
16,43629,110,33,143,4,6,2019,
17,43629,142,306,448,4,6,2019,
18,43629,43,100,143,4,6,2019,
19,43629,51,208,259,4,6,2019,
20,43629,158,81,239,4,6,2019,
21,43629,336,239,575,4,6,2019,
22,43629,398,183,581,4,6,2019,
23,43629,237,169,406,4,6,2019,
0,43630,212,128,340,5,6,2019,
1,43630,130,78,208,5,6,2019,
2,43630,39,1,40,5,6,2019,
3,43630,128,0,128,5,6,2019,
4,43630,111,0,111,5,6,2019,
5,43630,171,0,171,5,6,2019,
6,43630,435,11,446,5,6,2019,
7,43630,362,115,477,5,6,2019,
8,43630,287,318,605,5,6,2019,
9,43630,243,320,563,5,6,2019,
10,43630,253,130,383,5,6,2019,
11,43630,135,156,291,5,6,2019,
12,43630,191,283,474,5,6,2019,
13,43630,88,40,128,5,6,2019,
14,43630,134,249,383,5,6,2019,
15,43630,138,288,426,5,6,2019,
16,43630,108,32,140,5,6,2019,
17,43630,137,275,412,5,6,2019,
18,43630,75,106,181,5,6,2019,
19,43630,68,415,483,5,6,2019,
20,43630,193,23,216,5,6,2019,
21,43630,371,284,655,5,6,2019,
22,43630,420,0,420,5,6,2019,
23,43630,274,211,485,5,6,2019,
0,43631,251,235,486,6,6,2019,
1,43631,106,84,190,6,6,2019,
2,43631,59,20,79,6,6,2019,
3,43631,141,1,142,6,6,2019,
4,43631,60,0,60,6,6,2019,
5,43631,253,0,253,6,6,2019,
6,43631,334,1,335,6,6,2019,
7,43631,475,253,728,6,6,2019,
8,43631,403,494,897,6,6,2019,
9,43631,393,375,768,6,6,2019,
10,43631,187,216,403,6,6,2019,
11,43631,157,152,309,6,6,2019,
12,43631,204,172,376,6,6,2019,
13,43631,169,219,388,6,6,2019,
14,43631,162,254,416,6,6,2019,
15,43631,237,271,508,6,6,2019,
16,43631,180,197,377,6,6,2019,
17,43631,178,470,648,6,6,2019,
18,43631,52,119,171,6,6,2019,
19,43631,81,322,403,6,6,2019,
20,43631,181,106,287,6,6,2019,
21,43631,338,402,740,6,6,2019,
22,43631,317,111,428,6,6,2019,
23,43631,232,272,504,6,6,2019,
0,43632,168,295,463,7,6,2019,
1,43632,73,43,116,7,6,2019,
2,43632,57,0,57,7,6,2019,
3,43632,183,0,183,7,6,2019,
4,43632,197,0,197,7,6,2019,
5,43632,247,0,247,7,6,2019,
6,43632,349,39,388,7,6,2019,
7,43632,298,341,639,7,6,2019,
8,43632,267,498,765,7,6,2019,
9,43632,203,333,536,7,6,2019,
10,43632,264,11,275,7,6,2019,
11,43632,232,264,496,7,6,2019,
12,43632,160,124,284,7,6,2019,
13,43632,175,258,433,7,6,2019,
14,43632,91,432,523,7,6,2019,
15,43632,130,340,470,7,6,2019,
16,43632,144,83,227,7,6,2019,
17,43632,168,208,376,7,6,2019,
18,43632,78,169,247,7,6,2019,
19,43632,59,161,220,7,6,2019,
20,43632,238,85,323,7,6,2019,
21,43632,287,284,571,7,6,2019,
22,43632,333,182,515,7,6,2019,
23,43632,234,328,562,7,6,2019,
0,43633,182,415,597,1,6,2019,
1,43633,60,18,78,1,6,2019,
2,43633,40,2,42,1,6,2019,
3,43633,60,6,66,1,6,2019,
4,43633,112,0,112,1,6,2019,
5,43633,242,4,246,1,6,2019,
6,43633,322,63,385,1,6,2019,
7,43633,318,225,543,1,6,2019,
8,43633,295,318,613,1,6,2019,
9,43633,261,389,650,1,6,2019,
10,43633,190,114,304,1,6,2019,
11,43633,148,294,442,1,6,2019,
12,43633,187,116,303,1,6,2019,
13,43633,196,70,266,1,6,2019,
14,43633,161,249,410,1,6,2019,
15,43633,139,292,431,1,6,2019,
16,43633,220,244,464,1,6,2019,
17,43633,154,469,623,1,6,2019,
18,43633,73,262,335,1,6,2019,
19,43633,90,263,353,1,6,2019,
20,43633,169,217,386,1,6,2019,
21,43633,288,59,347,1,6,2019,
22,43633,309,79,388,1,6,2019,
23,43633,278,376,654,1,6,2019,
0,43634,131,371,502,2,6,2019,
1,43634,37,34,71,2,6,2019,
2,43634,112,0,112,2,6,2019,
3,43634,114,10,124,2,6,2019,
4,43634,100,0,100,2,6,2019,
5,43634,264,0,264,2,6,2019,
6,43634,351,1,352,2,6,2019,
7,43634,380,208,588,2,6,2019,
8,43634,288,309,597,2,6,2019,
9,43634,205,375,580,2,6,2019,
10,43634,247,68,315,2,6,2019,
11,43634,172,365,537,2,6,2019,
12,43634,193,304,497,2,6,2019,
13,43634,203,142,345,2,6,2019,
14,43634,151,288,439,2,6,2019,
15,43634,117,249,366,2,6,2019,
16,43634,119,241,360,2,6,2019,
17,43634,94,217,311,2,6,2019,
18,43634,42,294,336,2,6,2019,
19,43634,23,138,161,2,6,2019,
20,43634,192,102,294,2,6,2019,
21,43634,350,417,767,2,6,2019,
22,43634,272,70,342,2,6,2019,
23,43634,242,251,493,2,6,2019,
0,43635,114,145,259,3,6,2019,
1,43635,13,66,79,3,6,2019,
2,43635,40,3,43,3,6,2019,
3,43635,110,0,110,3,6,2019,
4,43635,122,0,122,3,6,2019,
5,43635,170,0,170,3,6,2019,
6,43635,378,6,384,3,6,2019,
7,43635,389,179,568,3,6,2019,
8,43635,175,342,517,3,6,2019,
9,43635,220,284,504,3,6,2019,
10,43635,186,173,359,3,6,2019,
11,43635,123,256,379,3,6,2019,
12,43635,176,227,403,3,6,2019,
13,43635,133,26,159,3,6,2019,
14,43635,155,251,406,3,6,2019,
15,43635,146,63,209,3,6,2019,
16,43635,160,384,544,3,6,2019,
17,43635,139,194,333,3,6,2019,
18,43635,75,193,268,3,6,2019,
19,43635,34,193,227,3,6,2019,
20,43635,209,200,409,3,6,2019,
21,43635,323,56,379,3,6,2019,
22,43635,298,70,368,3,6,2019,
23,43635,235,157,392,3,6,2019,
0,43636,181,292,473,4,6,2019,
1,43636,137,97,234,4,6,2019,
2,43636,65,24,89,4,6,2019,
3,43636,115,1,116,4,6,2019,
4,43636,169,1,170,4,6,2019,
5,43636,366,3,369,4,6,2019,
6,43636,475,72,547,4,6,2019,
7,43636,385,120,505,4,6,2019,
8,43636,353,461,814,4,6,2019,
9,43636,258,340,598,4,6,2019,
10,43636,281,65,346,4,6,2019,
11,43636,193,286,479,4,6,2019,
12,43636,172,351,523,4,6,2019,
13,43636,178,67,245,4,6,2019,
14,43636,189,195,384,4,6,2019,
15,43636,175,233,408,4,6,2019,
16,43636,188,186,374,4,6,2019,
17,43636,164,367,531,4,6,2019,
18,43636,73,145,218,4,6,2019,
19,43636,56,280,336,4,6,2019,
20,43636,183,80,263,4,6,2019,
21,43636,379,260,639,4,6,2019,
22,43636,433,149,582,4,6,2019,
23,43636,364,256,620,4,6,2019,
0,43637,217,255,472,5,6,2019,
1,43637,70,144,214,5,6,2019,
2,43637,39,48,87,5,6,2019,
3,43637,133,19,152,5,6,2019,
4,43637,199,0,199,5,6,2019,
5,43637,213,0,213,5,6,2019,
6,43637,418,24,442,5,6,2019,
7,43637,351,187,538,5,6,2019,
8,43637,256,383,639,5,6,2019,
9,43637,186,272,458,5,6,2019,
10,43637,199,191,390,5,6,2019,
11,43637,186,351,537,5,6,2019,
12,43637,185,104,289,5,6,2019,
13,43637,140,278,418,5,6,2019,
14,43637,90,129,219,5,6,2019,
15,43637,156,258,414,5,6,2019,
16,43637,179,224,403,5,6,2019,
17,43637,111,276,387,5,6,2019,
18,43637,78,53,131,5,6,2019,
19,43637,56,454,510,5,6,2019,
20,43637,149,170,319,5,6,2019,
21,43637,392,383,775,5,6,2019,
22,43637,411,105,516,5,6,2019,
23,43637,315,216,531,5,6,2019,
0,43638,192,188,380,6,6,2019,
1,43638,71,83,154,6,6,2019,
2,43638,76,0,76,6,6,2019,
3,43638,92,0,92,6,6,2019,
4,43638,76,0,76,6,6,2019,
5,43638,188,0,188,6,6,2019,
6,43638,381,13,394,6,6,2019,
7,43638,402,243,645,6,6,2019,
8,43638,342,560,902,6,6,2019,
9,43638,256,334,590,6,6,2019,
10,43638,242,254,496,6,6,2019,
11,43638,116,327,443,6,6,2019,
12,43638,170,208,378,6,6,2019,
13,43638,157,308,465,6,6,2019,
14,43638,160,248,408,6,6,2019,
15,43638,182,332,514,6,6,2019,
16,43638,205,144,349,6,6,2019,
17,43638,175,495,670,6,6,2019,
18,43638,64,339,403,6,6,2019,
19,43638,57,306,363,6,6,2019,
20,43638,117,249,366,6,6,2019,
21,43638,301,319,620,6,6,2019,
22,43638,307,161,468,6,6,2019,
23,43638,226,231,457,6,6,2019,
0,43639,138,391,529,7,6,2019,
1,43639,24,86,110,7,6,2019,
2,43639,67,3,70,7,6,2019,
3,43639,109,0,109,7,6,2019,
4,43639,190,0,190,7,6,2019,
5,43639,218,0,218,7,6,2019,
6,43639,300,29,329,7,6,2019,
7,43639,268,375,643,7,6,2019,
8,43639,168,514,682,7,6,2019,
9,43639,343,292,635,7,6,2019,
10,43639,260,4,264,7,6,2019,
11,43639,220,398,618,7,6,2019,
12,43639,159,378,537,7,6,2019,
13,43639,134,300,434,7,6,2019,
14,43639,109,364,473,7,6,2019,
15,43639,169,284,453,7,6,2019,
16,43639,163,190,353,7,6,2019,
17,43639,152,345,497,7,6,2019,
18,43639,55,460,515,7,6,2019,
19,43639,92,260,352,7,6,2019,
20,43639,179,194,373,7,6,2019,
21,43639,282,170,452,7,6,2019,
22,43639,222,237,459,7,6,2019,
23,43639,194,131,325,7,6,2019,
0,43640,186,592,778,1,6,2019,
1,43640,44,14,58,1,6,2019,
2,43640,12,0,12,1,6,2019,
3,43640,66,6,72,1,6,2019,
4,43640,41,0,41,1,6,2019,
5,43640,195,1,196,1,6,2019,
6,43640,262,24,286,1,6,2019,
7,43640,305,305,610,1,6,2019,
8,43640,268,355,623,1,6,2019,
9,43640,193,345,538,1,6,2019,
10,43640,204,261,465,1,6,2019,
11,43640,74,188,262,1,6,2019,
12,43640,156,205,361,1,6,2019,
13,43640,149,64,213,1,6,2019,
14,43640,178,343,521,1,6,2019,
15,43640,152,365,517,1,6,2019,
16,43640,148,223,371,1,6,2019,
17,43640,105,225,330,1,6,2019,
18,43640,47,372,419,1,6,2019,
19,43640,43,320,363,1,6,2019,
20,43640,171,114,285,1,6,2019,
21,43640,262,188,450,1,6,2019,
22,43640,234,226,460,1,6,2019,
23,43640,190,509,699,1,6,2019,
0,43641,124,305,429,2,6,2019,
1,43641,82,241,323,2,6,2019,
2,43641,56,23,79,2,6,2019,
3,43641,157,36,193,2,6,2019,
4,43641,82,1,83,2,6,2019,
5,43641,180,0,180,2,6,2019,
6,43641,309,0,309,2,6,2019,
7,43641,337,191,528,2,6,2019,
8,43641,252,414,666,2,6,2019,
9,43641,177,417,594,2,6,2019,
10,43641,175,91,266,2,6,2019,
11,43641,205,330,535,2,6,2019,
12,43641,164,279,443,2,6,2019,
13,43641,143,166,309,2,6,2019,
14,43641,153,199,352,2,6,2019,
15,43641,119,387,506,2,6,2019,
16,43641,139,235,374,2,6,2019,
17,43641,111,335,446,2,6,2019,
18,43641,30,248,278,2,6,2019,
19,43641,81,204,285,2,6,2019,
20,43641,201,213,414,2,6,2019,
21,43641,278,384,662,2,6,2019,
22,43641,267,84,351,2,6,2019,
23,43641,260,286,546,2,6,2019,
0,43642,173,281,454,3,6,2019,
1,43642,47,16,63,3,6,2019,
2,43642,35,7,42,3,6,2019,
3,43642,75,2,77,3,6,2019,
4,43642,105,3,108,3,6,2019,
5,43642,165,0,165,3,6,2019,
6,43642,288,7,295,3,6,2019,
7,43642,345,285,630,3,6,2019,
8,43642,230,402,632,3,6,2019,
9,43642,191,354,545,3,6,2019,
10,43642,188,221,409,3,6,2019,
11,43642,174,420,594,3,6,2019,
12,43642,151,172,323,3,6,2019,
13,43642,140,93,233,3,6,2019,
14,43642,105,206,311,3,6,2019,
15,43642,122,258,380,3,6,2019,
16,43642,149,284,433,3,6,2019,
17,43642,105,267,372,3,6,2019,
18,43642,38,197,235,3,6,2019,
19,43642,39,282,321,3,6,2019,
20,43642,168,167,335,3,6,2019,
21,43642,301,183,484,3,6,2019,
22,43642,342,77,419,3,6,2019,
23,43642,292,215,507,3,6,2019,
0,43643,224,279,503,4,6,2019,
1,43643,59,140,199,4,6,2019,
2,43643,89,51,140,4,6,2019,
3,43643,102,7,109,4,6,2019,
4,43643,136,8,144,4,6,2019,
5,43643,297,0,297,4,6,2019,
6,43643,367,0,367,4,6,2019,
7,43643,422,244,666,4,6,2019,
8,43643,293,453,746,4,6,2019,
9,43643,239,405,644,4,6,2019,
10,43643,236,156,392,4,6,2019,
11,43643,160,283,443,4,6,2019,
12,43643,140,297,437,4,6,2019,
13,43643,150,94,244,4,6,2019,
14,43643,185,306,491,4,6,2019,
15,43643,180,230,410,4,6,2019,
16,43643,166,189,355,4,6,2019,
17,43643,174,477,651,4,6,2019,
18,43643,69,148,217,4,6,2019,
19,43643,76,290,366,4,6,2019,
20,43643,147,175,322,4,6,2019,
21,43643,451,305,756,4,6,2019,
22,43643,408,85,493,4,6,2019,
23,43643,325,243,568,4,6,2019,
0,43644,167,312,479,5,6,2019,
1,43644,61,152,213,5,6,2019,
2,43644,48,0,48,5,6,2019,
3,43644,96,0,96,5,6,2019,
4,43644,134,0,134,5,6,2019,
5,43644,263,0,263,5,6,2019,
6,43644,419,29,448,5,6,2019,
7,43644,320,230,550,5,6,2019,
8,43644,268,399,667,5,6,2019,
9,43644,223,448,671,5,6,2019,
10,43644,166,217,383,5,6,2019,
11,43644,121,379,500,5,6,2019,
12,43644,197,186,383,5,6,2019,
13,43644,118,78,196,5,6,2019,
14,43644,152,305,457,5,6,2019,
15,43644,171,374,545,5,6,2019,
16,43644,165,131,296,5,6,2019,
17,43644,128,368,496,5,6,2019,
18,43644,51,171,222,5,6,2019,
19,43644,57,388,445,5,6,2019,
20,43644,209,168,377,5,6,2019,
21,43644,345,277,622,5,6,2019,
22,43644,283,201,484,5,6,2019,
23,43644,345,203,548,5,6,2019,
0,43645,228,241,469,6,6,2019,
1,43645,142,167,309,6,6,2019,
2,43645,66,4,70,6,6,2019,
3,43645,126,6,132,6,6,2019,
4,43645,81,0,81,6,6,2019,
5,43645,149,1,150,6,6,2019,
6,43645,335,17,352,6,6,2019,
7,43645,435,192,627,6,6,2019,
8,43645,451,587,1038,6,6,2019,
9,43645,313,624,937,6,6,2019,
10,43645,215,180,395,6,6,2019,
11,43645,97,441,538,6,6,2019,
12,43645,160,255,415,6,6,2019,
13,43645,143,110,253,6,6,2019,
14,43645,166,348,514,6,6,2019,
15,43645,199,438,637,6,6,2019,
16,43645,178,219,397,6,6,2019,
17,43645,133,513,646,6,6,2019,
18,43645,65,208,273,6,6,2019,
19,43645,49,436,485,6,6,2019,
20,43645,181,177,358,6,6,2019,
21,43645,241,351,592,6,6,2019,
22,43645,319,196,515,6,6,2019,
23,43645,198,346,544,6,6,2019,
0,43646,194,317,511,7,6,2019,
1,43646,59,216,275,7,6,2019,
2,43646,43,0,43,7,6,2019,
3,43646,137,0,137,7,6,2019,
4,43646,168,0,168,7,6,2019,
5,43646,142,0,142,7,6,2019,
6,43646,289,14,303,7,6,2019,
7,43646,303,501,804,7,6,2019,
8,43646,230,567,797,7,6,2019,
9,43646,217,465,682,7,6,2019,
10,43646,187,40,227,7,6,2019,
11,43646,209,449,658,7,6,2019,
12,43646,179,331,510,7,6,2019,
13,43646,149,306,455,7,6,2019,
14,43646,133,246,379,7,6,2019,
15,43646,121,493,614,7,6,2019,
16,43646,154,232,386,7,6,2019,
17,43646,157,242,399,7,6,2019,
18,43646,58,255,313,7,6,2019,
19,43646,74,534,608,7,6,2019,
20,43646,163,165,328,7,6,2019,
21,43646,250,239,489,7,6,2019,
22,43646,259,219,478,7,6,2019,
23,43646,207,326,533,7,6,2019,
0,43647,136,560,696,1,7,2019,
1,43647,30,156,186,1,7,2019,
2,43647,22,0,22,1,7,2019,
3,43647,75,0,75,1,7,2019,
4,43647,96,0,96,1,7,2019,
5,43647,154,0,154,1,7,2019,
6,43647,258,0,258,1,7,2019,
7,43647,257,0,257,1,7,2019,
8,43647,176,242,418,1,7,2019,
9,43647,141,292,433,1,7,2019,
10,43647,159,564,723,1,7,2019,
11,43647,77,319,396,1,7,2019,
12,43647,156,136,292,1,7,2019,
13,43647,146,166,312,1,7,2019,
14,43647,138,337,475,1,7,2019,
15,43647,179,338,517,1,7,2019,
16,43647,137,153,290,1,7,2019,
17,43647,141,527,668,1,7,2019,
18,43647,33,449,482,1,7,2019,
19,43647,45,301,346,1,7,2019,
20,43647,112,99,211,1,7,2019,
21,43647,221,261,482,1,7,2019,
22,43647,267,293,560,1,7,2019,
23,43647,220,379,599,1,7,2019,
0,43648,101,361,462,2,7,2019,
1,43648,37,62,99,2,7,2019,
2,43648,80,0,80,2,7,2019,
3,43648,106,0,106,2,7,2019,
4,43648,113,0,113,2,7,2019,
5,43648,170,0,170,2,7,2019,
6,43648,292,91,383,2,7,2019,
7,43648,295,402,697,2,7,2019,
8,43648,285,273,558,2,7,2019,
9,43648,185,472,657,2,7,2019,
10,43648,181,124,305,2,7,2019,
11,43648,202,401,603,2,7,2019,
12,43648,229,253,482,2,7,2019,
13,43648,163,205,368,2,7,2019,
14,43648,155,276,431,2,7,2019,
15,43648,132,318,450,2,7,2019,
16,43648,108,151,259,2,7,2019,
17,43648,144,398,542,2,7,2019,
18,43648,47,172,219,2,7,2019,
19,43648,48,225,273,2,7,2019,
20,43648,181,204,385,2,7,2019,
21,43648,307,374,681,2,7,2019,
22,43648,410,109,519,2,7,2019,
23,43648,266,338,604,2,7,2019,
0,43649,136,153,289,3,7,2019,
1,43649,23,160,183,3,7,2019,
2,43649,38,49,87,3,7,2019,
3,43649,97,6,103,3,7,2019,
4,43649,97,3,100,3,7,2019,
5,43649,215,39,254,3,7,2019,
6,43649,360,61,421,3,7,2019,
7,43649,423,327,750,3,7,2019,
8,43649,267,371,638,3,7,2019,
9,43649,209,432,641,3,7,2019,
10,43649,166,203,369,3,7,2019,
11,43649,138,271,409,3,7,2019,
12,43649,181,282,463,3,7,2019,
13,43649,235,162,397,3,7,2019,
14,43649,170,263,433,3,7,2019,
15,43649,195,207,402,3,7,2019,
16,43649,229,276,505,3,7,2019,
17,43649,158,410,568,3,7,2019,
18,43649,99,270,369,3,7,2019,
19,43649,85,157,242,3,7,2019,
20,43649,208,150,358,3,7,2019,
21,43649,384,301,685,3,7,2019,
22,43649,445,75,520,3,7,2019,
23,43649,349,354,703,3,7,2019,
0,43650,238,376,614,4,7,2019,
1,43650,113,26,139,4,7,2019,
2,43650,89,37,126,4,7,2019,
3,43650,135,2,137,4,7,2019,
4,43650,196,6,202,4,7,2019,
5,43650,293,1,294,4,7,2019,
6,43650,470,136,606,4,7,2019,
7,43650,572,312,884,4,7,2019,
8,43650,419,456,875,4,7,2019,
9,43650,277,274,551,4,7,2019,
10,43650,318,124,442,4,7,2019,
11,43650,187,178,365,4,7,2019,
12,43650,178,280,458,4,7,2019,
13,43650,206,196,402,4,7,2019,
14,43650,161,247,408,4,7,2019,
15,43650,174,224,398,4,7,2019,
16,43650,184,211,395,4,7,2019,
17,43650,126,295,421,4,7,2019,
18,43650,75,204,279,4,7,2019,
19,43650,106,159,265,4,7,2019,
20,43650,171,172,343,4,7,2019,
21,43650,274,215,489,4,7,2019,
22,43650,313,209,522,4,7,2019,
23,43650,205,162,367,4,7,2019,
0,43651,115,239,354,5,7,2019,
1,43651,34,116,150,5,7,2019,
2,43651,36,69,105,5,7,2019,
3,43651,87,0,87,5,7,2019,
4,43651,132,0,132,5,7,2019,
5,43651,235,0,235,5,7,2019,
6,43651,306,53,359,5,7,2019,
7,43651,246,285,531,5,7,2019,
8,43651,180,390,570,5,7,2019,
9,43651,178,294,472,5,7,2019,
10,43651,133,356,489,5,7,2019,
11,43651,113,374,487,5,7,2019,
12,43651,128,223,351,5,7,2019,
13,43651,98,88,186,5,7,2019,
14,43651,139,299,438,5,7,2019,
15,43651,131,246,377,5,7,2019,
16,43651,129,257,386,5,7,2019,
17,43651,127,387,514,5,7,2019,
18,43651,37,178,215,5,7,2019,
19,43651,70,250,320,5,7,2019,
20,43651,139,190,329,5,7,2019,
21,43651,212,462,674,5,7,2019,
22,43651,302,158,460,5,7,2019,
23,43651,258,328,586,5,7,2019,
0,43652,115,120,235,6,7,2019,
1,43652,19,57,76,6,7,2019,
2,43652,57,0,57,6,7,2019,
3,43652,67,3,70,6,7,2019,
4,43652,86,0,86,6,7,2019,
5,43652,127,13,140,6,7,2019,
6,43652,280,5,285,6,7,2019,
7,43652,295,397,692,6,7,2019,
8,43652,247,668,915,6,7,2019,
9,43652,185,446,631,6,7,2019,
10,43652,148,221,369,6,7,2019,
11,43652,96,363,459,6,7,2019,
12,43652,145,133,278,6,7,2019,
13,43652,136,227,363,6,7,2019,
14,43652,138,466,604,6,7,2019,
15,43652,178,255,433,6,7,2019,
16,43652,153,473,626,6,7,2019,
17,43652,100,367,467,6,7,2019,
18,43652,60,210,270,6,7,2019,
19,43652,55,204,259,6,7,2019,
20,43652,195,185,380,6,7,2019,
21,43652,255,307,562,6,7,2019,
22,43652,286,356,642,6,7,2019,
23,43652,208,454,662,6,7,2019,
0,43653,81,313,394,7,7,2019,
1,43653,29,120,149,7,7,2019,
2,43653,54,0,54,7,7,2019,
3,43653,96,9,105,7,7,2019,
4,43653,108,0,108,7,7,2019,
5,43653,157,0,157,7,7,2019,
6,43653,277,103,380,7,7,2019,
7,43653,223,520,743,7,7,2019,
8,43653,115,667,782,7,7,2019,
9,43653,177,377,554,7,7,2019,
10,43653,206,29,235,7,7,2019,
11,43653,110,537,647,7,7,2019,
12,43653,160,453,613,7,7,2019,
13,43653,179,234,413,7,7,2019,
14,43653,99,602,701,7,7,2019,
15,43653,97,353,450,7,7,2019,
16,43653,132,166,298,7,7,2019,
17,43653,144,372,516,7,7,2019,
18,43653,99,543,642,7,7,2019,
19,43653,88,423,511,7,7,2019,
20,43653,129,318,447,7,7,2019,
21,43653,198,286,484,7,7,2019,
22,43653,258,359,617,7,7,2019,
23,43653,192,544,736,7,7,2019,
0,43654,82,531,613,1,7,2019,
1,43654,30,178,208,1,7,2019,
2,43654,15,0,15,1,7,2019,
3,43654,51,26,77,1,7,2019,
4,43654,106,4,110,1,7,2019,
5,43654,146,12,158,1,7,2019,
6,43654,321,171,492,1,7,2019,
7,43654,240,455,695,1,7,2019,
8,43654,185,618,803,1,7,2019,
9,43654,115,353,468,1,7,2019,
10,43654,118,114,232,1,7,2019,
11,43654,76,297,373,1,7,2019,
12,43654,123,147,270,1,7,2019,
13,43654,131,273,404,1,7,2019,
14,43654,117,229,346,1,7,2019,
15,43654,152,447,599,1,7,2019,
16,43654,131,215,346,1,7,2019,
17,43654,164,365,529,1,7,2019,
18,43654,15,382,397,1,7,2019,
19,43654,48,415,463,1,7,2019,
20,43654,127,126,253,1,7,2019,
21,43654,177,220,397,1,7,2019,
22,43654,193,206,399,1,7,2019,
23,43654,155,467,622,1,7,2019,
0,43655,57,292,349,2,7,2019,
1,43655,35,262,297,2,7,2019,
2,43655,51,11,62,2,7,2019,
3,43655,93,0,93,2,7,2019,
4,43655,57,1,58,2,7,2019,
5,43655,155,2,157,2,7,2019,
6,43655,261,106,367,2,7,2019,
7,43655,202,357,559,2,7,2019,
8,43655,189,326,515,2,7,2019,
9,43655,121,482,603,2,7,2019,
10,43655,159,140,299,2,7,2019,
11,43655,134,492,626,2,7,2019,
12,43655,189,278,467,2,7,2019,
13,43655,175,145,320,2,7,2019,
14,43655,134,291,425,2,7,2019,
15,43655,107,260,367,2,7,2019,
16,43655,90,192,282,2,7,2019,
17,43655,94,372,466,2,7,2019,
18,43655,47,181,228,2,7,2019,
19,43655,76,205,281,2,7,2019,
20,43655,151,197,348,2,7,2019,
21,43655,255,490,745,2,7,2019,
22,43655,216,274,490,2,7,2019,
23,43655,176,176,352,2,7,2019,
0,43656,63,277,340,3,7,2019,
1,43656,13,60,73,3,7,2019,
2,43656,26,0,26,3,7,2019,
3,43656,39,22,61,3,7,2019,
4,43656,97,0,97,3,7,2019,
5,43656,131,5,136,3,7,2019,
6,43656,280,72,352,3,7,2019,
7,43656,188,425,613,3,7,2019,
8,43656,148,318,466,3,7,2019,
9,43656,137,470,607,3,7,2019,
10,43656,134,99,233,3,7,2019,
11,43656,80,393,473,3,7,2019,
12,43656,142,136,278,3,7,2019,
13,43656,155,122,277,3,7,2019,
14,43656,138,268,406,3,7,2019,
15,43656,107,259,366,3,7,2019,
16,43656,143,336,479,3,7,2019,
17,43656,116,108,224,3,7,2019,
18,43656,52,194,246,3,7,2019,
19,43656,51,251,302,3,7,2019,
20,43656,85,107,192,3,7,2019,
21,43656,302,164,466,3,7,2019,
22,43656,283,114,397,3,7,2019,
23,43656,248,335,583,3,7,2019,
0,43657,179,191,370,4,7,2019,
1,43657,22,178,200,4,7,2019,
2,43657,42,0,42,4,7,2019,
3,43657,84,31,115,4,7,2019,
4,43657,115,0,115,4,7,2019,
5,43657,220,0,220,4,7,2019,
6,43657,306,110,416,4,7,2019,
7,43657,255,256,511,4,7,2019,
8,43657,215,529,744,4,7,2019,
9,43657,187,349,536,4,7,2019,
10,43657,197,215,412,4,7,2019,
11,43657,150,178,328,4,7,2019,
12,43657,158,333,491,4,7,2019,
13,43657,159,142,301,4,7,2019,
14,43657,131,260,391,4,7,2019,
15,43657,133,175,308,4,7,2019,
16,43657,158,186,344,4,7,2019,
17,43657,149,343,492,4,7,2019,
18,43657,57,294,351,4,7,2019,
19,43657,51,274,325,4,7,2019,
20,43657,157,158,315,4,7,2019,
21,43657,333,83,416,4,7,2019,
22,43657,355,232,587,4,7,2019,
23,43657,307,252,559,4,7,2019,
0,43658,179,314,493,5,7,2019,
1,43658,41,161,202,5,7,2019,
2,43658,42,4,46,5,7,2019,
3,43658,94,1,95,5,7,2019,
4,43658,171,7,178,5,7,2019,
5,43658,203,0,203,5,7,2019,
6,43658,308,109,417,5,7,2019,
7,43658,257,237,494,5,7,2019,
8,43658,217,422,639,5,7,2019,
9,43658,161,479,640,5,7,2019,
10,43658,184,166,350,5,7,2019,
11,43658,124,419,543,5,7,2019,
12,43658,127,107,234,5,7,2019,
13,43658,137,172,309,5,7,2019,
14,43658,137,310,447,5,7,2019,
15,43658,169,175,344,5,7,2019,
16,43658,128,286,414,5,7,2019,
17,43658,108,290,398,5,7,2019,
18,43658,62,133,195,5,7,2019,
19,43658,67,296,363,5,7,2019,
20,43658,150,215,365,5,7,2019,
21,43658,333,370,703,5,7,2019,
22,43658,335,180,515,5,7,2019,
23,43658,244,280,524,5,7,2019,
0,43659,154,292,446,6,7,2019,
1,43659,66,121,187,6,7,2019,
2,43659,55,18,73,6,7,2019,
3,43659,73,0,73,6,7,2019,
4,43659,68,7,75,6,7,2019,
5,43659,167,0,167,6,7,2019,
6,43659,303,9,312,6,7,2019,
7,43659,361,289,650,6,7,2019,
8,43659,271,667,938,6,7,2019,
9,43659,187,565,752,6,7,2019,
10,43659,155,317,472,6,7,2019,
11,43659,97,324,421,6,7,2019,
12,43659,120,199,319,6,7,2019,
13,43659,136,101,237,6,7,2019,
14,43659,153,344,497,6,7,2019,
15,43659,156,241,397,6,7,2019,
16,43659,184,120,304,6,7,2019,
17,43659,122,442,564,6,7,2019,
18,43659,52,353,405,6,7,2019,
19,43659,107,241,348,6,7,2019,
20,43659,107,172,279,6,7,2019,
21,43659,236,352,588,6,7,2019,
22,43659,255,280,535,6,7,2019,
23,43659,227,250,477,6,7,2019,
0,43660,65,307,372,7,7,2019,
1,43660,17,73,90,7,7,2019,
2,43660,43,0,43,7,7,2019,
3,43660,70,0,70,7,7,2019,
4,43660,90,0,90,7,7,2019,
5,43660,190,0,190,7,7,2019,
6,43660,227,100,327,7,7,2019,
7,43660,223,461,684,7,7,2019,
8,43660,159,542,701,7,7,2019,
9,43660,161,488,649,7,7,2019,
10,43660,180,10,190,7,7,2019,
11,43660,158,477,635,7,7,2019,
12,43660,144,326,470,7,7,2019,
13,43660,222,232,454,7,7,2019,
14,43660,103,249,352,7,7,2019,
15,43660,136,370,506,7,7,2019,
16,43660,165,97,262,7,7,2019,
17,43660,135,409,544,7,7,2019,
18,43660,75,170,245,7,7,2019,
19,43660,121,329,450,7,7,2019,
20,43660,135,226,361,7,7,2019,
21,43660,186,250,436,7,7,2019,
22,43660,260,111,371,7,7,2019,
23,43660,205,475,680,7,7,2019,
0,43661,64,288,352,1,7,2019,
1,43661,28,145,173,1,7,2019,
2,43661,26,0,26,1,7,2019,
3,43661,59,12,71,1,7,2019,
4,43661,42,0,42,1,7,2019,
5,43661,124,9,133,1,7,2019,
6,43661,213,125,338,1,7,2019,
7,43661,246,20,266,1,7,2019,
8,43661,208,599,807,1,7,2019,
9,43661,165,446,611,1,7,2019,
10,43661,132,349,481,1,7,2019,
11,43661,78,387,465,1,7,2019,
12,43661,107,208,315,1,7,2019,
13,43661,156,143,299,1,7,2019,
14,43661,195,268,463,1,7,2019,
15,43661,130,288,418,1,7,2019,
16,43661,167,245,412,1,7,2019,
17,43661,152,349,501,1,7,2019,
18,43661,44,333,377,1,7,2019,
19,43661,58,183,241,1,7,2019,
20,43661,100,71,171,1,7,2019,
21,43661,181,334,515,1,7,2019,
22,43661,163,210,373,1,7,2019,
23,43661,179,199,378,1,7,2019,
0,43662,126,358,484,2,7,2019,
1,43662,63,106,169,2,7,2019,
2,43662,68,97,165,2,7,2019,
3,43662,69,1,70,2,7,2019,
4,43662,61,0,61,2,7,2019,
5,43662,149,0,149,2,7,2019,
6,43662,254,0,254,2,7,2019,
7,43662,263,0,263,2,7,2019,
8,43662,155,22,177,2,7,2019,
9,43662,137,646,783,2,7,2019,
10,43662,171,590,761,2,7,2019,
11,43662,140,504,644,2,7,2019,
12,43662,146,254,400,2,7,2019,
13,43662,155,278,433,2,7,2019,
14,43662,134,108,242,2,7,2019,
15,43662,115,119,234,2,7,2019,
16,43662,130,473,603,2,7,2019,
17,43662,119,301,420,2,7,2019,
18,43662,49,350,399,2,7,2019,
19,43662,84,257,341,2,7,2019,
20,43662,124,161,285,2,7,2019,
21,43662,258,263,521,2,7,2019,
22,43662,265,68,333,2,7,2019,
23,43662,215,327,542,2,7,2019,
0,43663,130,321,451,3,7,2019,
1,43663,8,241,249,3,7,2019,
2,43663,19,0,19,3,7,2019,
3,43663,54,0,54,3,7,2019,
4,43663,101,0,101,3,7,2019,
5,43663,127,0,127,3,7,2019,
6,43663,273,0,273,3,7,2019,
7,43663,227,269,496,3,7,2019,
8,43663,189,391,580,3,7,2019,
9,43663,114,591,705,3,7,2019,
10,43663,205,176,381,3,7,2019,
11,43663,136,363,499,3,7,2019,
12,43663,187,173,360,3,7,2019,
13,43663,126,188,314,3,7,2019,
14,43663,187,298,485,3,7,2019,
15,43663,123,247,370,3,7,2019,
16,43663,105,224,329,3,7,2019,
17,43663,138,134,272,3,7,2019,
18,43663,106,194,300,3,7,2019,
19,43663,67,239,306,3,7,2019,
20,43663,129,177,306,3,7,2019,
21,43663,264,282,546,3,7,2019,
22,43663,348,145,493,3,7,2019,
23,43663,342,207,549,3,7,2019,
0,43664,184,259,443,4,7,2019,
1,43664,61,248,309,4,7,2019,
2,43664,2,59,61,4,7,2019,
3,43664,5,3,8,4,7,2019,
4,43664,126,0,126,4,7,2019,
5,43664,382,0,382,4,7,2019,
6,43664,409,91,500,4,7,2019,
7,43664,374,359,733,4,7,2019,
8,43664,252,367,619,4,7,2019,
9,43664,168,492,660,4,7,2019,
10,43664,250,113,363,4,7,2019,
11,43664,156,359,515,4,7,2019,
12,43664,172,297,469,4,7,2019,
13,43664,211,140,351,4,7,2019,
14,43664,171,222,393,4,7,2019,
15,43664,165,204,369,4,7,2019,
16,43664,166,220,386,4,7,2019,
17,43664,164,264,428,4,7,2019,
18,43664,85,192,277,4,7,2019,
19,43664,91,228,319,4,7,2019,
20,43664,180,118,298,4,7,2019,
21,43664,377,297,674,4,7,2019,
22,43664,394,221,615,4,7,2019,
23,43664,319,280,599,4,7,2019,
0,43665,193,309,502,5,7,2019,
1,43665,38,152,190,5,7,2019,
2,43665,46,85,131,5,7,2019,
3,43665,129,0,129,5,7,2019,
4,43665,149,10,159,5,7,2019,
5,43665,257,0,257,5,7,2019,
6,43665,344,84,428,5,7,2019,
7,43665,333,319,652,5,7,2019,
8,43665,232,374,606,5,7,2019,
9,43665,193,454,647,5,7,2019,
10,43665,170,62,232,5,7,2019,
11,43665,125,329,454,5,7,2019,
12,43665,171,122,293,5,7,2019,
13,43665,150,219,369,5,7,2019,
14,43665,106,295,401,5,7,2019,
15,43665,176,291,467,5,7,2019,
16,43665,158,211,369,5,7,2019,
17,43665,162,236,398,5,7,2019,
18,43665,71,262,333,5,7,2019,
19,43665,77,225,302,5,7,2019,
20,43665,149,128,277,5,7,2019,
21,43665,316,256,572,5,7,2019,
22,43665,334,247,581,5,7,2019,
23,43665,347,236,583,5,7,2019,
0,43666,197,467,664,6,7,2019,
1,43666,59,230,289,6,7,2019,
2,43666,31,0,31,6,7,2019,
3,43666,77,15,92,6,7,2019,
4,43666,51,15,66,6,7,2019,
5,43666,163,2,165,6,7,2019,
6,43666,315,0,315,6,7,2019,
7,43666,420,260,680,6,7,2019,
8,43666,304,692,996,6,7,2019,
9,43666,207,488,695,6,7,2019,
10,43666,134,236,370,6,7,2019,
11,43666,57,423,480,6,7,2019,
12,43666,186,152,338,6,7,2019,
13,43666,184,182,366,6,7,2019,
14,43666,224,209,433,6,7,2019,
15,43666,185,326,511,6,7,2019,
16,43666,132,290,422,6,7,2019,
17,43666,194,366,560,6,7,2019,
18,43666,87,127,214,6,7,2019,
19,43666,122,257,379,6,7,2019,
20,43666,202,164,366,6,7,2019,
21,43666,338,269,607,6,7,2019,
22,43666,253,293,546,6,7,2019,
23,43666,189,239,428,6,7,2019,
0,43667,115,172,287,7,7,2019,
1,43667,41,138,179,7,7,2019,
2,43667,54,6,60,7,7,2019,
3,43667,147,0,147,7,7,2019,
4,43667,100,10,110,7,7,2019,
5,43667,204,110,314,7,7,2019,
6,43667,281,62,343,7,7,2019,
7,43667,273,534,807,7,7,2019,
8,43667,166,442,608,7,7,2019,
9,43667,240,310,550,7,7,2019,
10,43667,260,121,381,7,7,2019,
11,43667,145,460,605,7,7,2019,
12,43667,160,249,409,7,7,2019,
13,43667,180,306,486,7,7,2019,
14,43667,142,295,437,7,7,2019,
15,43667,182,362,544,7,7,2019,
16,43667,198,91,289,7,7,2019,
17,43667,225,274,499,7,7,2019,
18,43667,102,204,306,7,7,2019,
19,43667,84,179,263,7,7,2019,
20,43667,194,153,347,7,7,2019,
21,43667,322,251,573,7,7,2019,
22,43667,299,473,772,7,7,2019,
23,43667,132,386,518,7,7,2019,
0,43668,113,172,285,1,7,2019,
1,43668,38,169,207,1,7,2019,
2,43668,45,0,45,1,7,2019,
3,43668,74,9,83,1,7,2019,
4,43668,73,1,74,1,7,2019,
5,43668,134,7,141,1,7,2019,
6,43668,275,200,475,1,7,2019,
7,43668,327,345,672,1,7,2019,
8,43668,197,464,661,1,7,2019,
9,43668,234,362,596,1,7,2019,
10,43668,212,138,350,1,7,2019,
11,43668,108,337,445,1,7,2019,
12,43668,136,182,318,1,7,2019,
13,43668,179,141,320,1,7,2019,
14,43668,158,254,412,1,7,2019,
15,43668,205,464,669,1,7,2019,
16,43668,184,168,352,1,7,2019,
17,43668,144,359,503,1,7,2019,
18,43668,75,267,342,1,7,2019,
19,43668,56,415,471,1,7,2019,
20,43668,132,33,165,1,7,2019,
21,43668,318,309,627,1,7,2019,
22,43668,232,185,417,1,7,2019,
23,43668,191,486,677,1,7,2019,
0,43669,99,306,405,2,7,2019,
1,43669,35,140,175,2,7,2019,
2,43669,108,51,159,2,7,2019,
3,43669,82,0,82,2,7,2019,
4,43669,77,2,79,2,7,2019,
5,43669,178,1,179,2,7,2019,
6,43669,294,90,384,2,7,2019,
7,43669,281,413,694,2,7,2019,
8,43669,215,332,547,2,7,2019,
9,43669,141,492,633,2,7,2019,
10,43669,239,167,406,2,7,2019,
11,43669,173,285,458,2,7,2019,
12,43669,164,340,504,2,7,2019,
13,43669,192,155,347,2,7,2019,
14,43669,112,198,310,2,7,2019,
15,43669,153,308,461,2,7,2019,
16,43669,166,147,313,2,7,2019,
17,43669,153,295,448,2,7,2019,
18,43669,45,188,233,2,7,2019,
19,43669,85,128,213,2,7,2019,
20,43669,203,67,270,2,7,2019,
21,43669,304,317,621,2,7,2019,
22,43669,298,315,613,2,7,2019,
23,43669,239,126,365,2,7,2019,
0,43670,160,219,379,3,7,2019,
1,43670,31,134,165,3,7,2019,
2,43670,36,57,93,3,7,2019,
3,43670,89,0,89,3,7,2019,
4,43670,91,24,115,3,7,2019,
5,43670,128,2,130,3,7,2019,
6,43670,298,75,373,3,7,2019,
7,43670,272,337,609,3,7,2019,
8,43670,201,337,538,3,7,2019,
9,43670,223,337,560,3,7,2019,
10,43670,178,253,431,3,7,2019,
11,43670,116,343,459,3,7,2019,
12,43670,159,232,391,3,7,2019,
13,43670,225,61,286,3,7,2019,
14,43670,199,133,332,3,7,2019,
15,43670,154,300,454,3,7,2019,
16,43670,137,171,308,3,7,2019,
17,43670,133,302,435,3,7,2019,
18,43670,54,185,239,3,7,2019,
19,43670,75,217,292,3,7,2019,
20,43670,130,120,250,3,7,2019,
21,43670,347,129,476,3,7,2019,
22,43670,330,149,479,3,7,2019,
23,43670,279,296,575,3,7,2019,
0,43671,288,306,594,4,7,2019,
1,43671,68,90,158,4,7,2019,
2,43671,64,12,76,4,7,2019,
3,43671,82,0,82,4,7,2019,
4,43671,111,0,111,4,7,2019,
5,43671,300,0,300,4,7,2019,
6,43671,320,68,388,4,7,2019,
7,43671,386,353,739,4,7,2019,
8,43671,295,408,703,4,7,2019,
9,43671,216,406,622,4,7,2019,
10,43671,268,237,505,4,7,2019,
11,43671,153,266,419,4,7,2019,
12,43671,175,273,448,4,7,2019,
13,43671,200,221,421,4,7,2019,
14,43671,210,178,388,4,7,2019,
15,43671,150,67,217,4,7,2019,
16,43671,204,378,582,4,7,2019,
17,43671,141,186,327,4,7,2019,
18,43671,57,255,312,4,7,2019,
19,43671,50,251,301,4,7,2019,
20,43671,153,109,262,4,7,2019,
21,43671,403,253,656,4,7,2019,
22,43671,379,165,544,4,7,2019,
23,43671,354,247,601,4,7,2019,
0,43672,301,304,605,5,7,2019,
1,43672,30,107,137,5,7,2019,
2,43672,48,71,119,5,7,2019,
3,43672,100,6,106,5,7,2019,
4,43672,144,0,144,5,7,2019,
5,43672,209,2,211,5,7,2019,
6,43672,353,67,420,5,7,2019,
7,43672,378,297,675,5,7,2019,
8,43672,253,372,625,5,7,2019,
9,43672,175,337,512,5,7,2019,
10,43672,214,211,425,5,7,2019,
11,43672,172,453,625,5,7,2019,
12,43672,151,68,219,5,7,2019,
13,43672,173,114,287,5,7,2019,
14,43672,191,233,424,5,7,2019,
15,43672,161,236,397,5,7,2019,
16,43672,174,234,408,5,7,2019,
17,43672,162,385,547,5,7,2019,
18,43672,90,212,302,5,7,2019,
19,43672,78,152,230,5,7,2019,
20,43672,110,161,271,5,7,2019,
21,43672,377,192,569,5,7,2019,
22,43672,376,164,540,5,7,2019,
23,43672,341,297,638,5,7,2019,
0,43673,201,323,524,6,7,2019,
1,43673,85,199,284,6,7,2019,
2,43673,32,0,32,6,7,2019,
3,43673,97,6,103,6,7,2019,
4,43673,95,15,110,6,7,2019,
5,43673,152,0,152,6,7,2019,
6,43673,260,0,260,6,7,2019,
7,43673,391,6,397,6,7,2019,
8,43673,362,350,712,6,7,2019,
9,43673,183,606,789,6,7,2019,
10,43673,237,417,654,6,7,2019,
11,43673,90,573,663,6,7,2019,
12,43673,146,248,394,6,7,2019,
13,43673,157,53,210,6,7,2019,
14,43673,204,301,505,6,7,2019,
15,43673,259,152,411,6,7,2019,
16,43673,231,278,509,6,7,2019,
17,43673,120,415,535,6,7,2019,
18,43673,71,474,545,6,7,2019,
19,43673,127,211,338,6,7,2019,
20,43673,210,123,333,6,7,2019,
21,43673,286,269,555,6,7,2019,
22,43673,300,248,548,6,7,2019,
23,43673,231,283,514,6,7,2019,
0,43674,97,214,311,7,7,2019,
1,43674,53,234,287,7,7,2019,
2,43674,41,66,107,7,7,2019,
3,43674,138,0,138,7,7,2019,
4,43674,172,0,172,7,7,2019,
5,43674,206,0,206,7,7,2019,
6,43674,303,84,387,7,7,2019,
7,43674,300,467,767,7,7,2019,
8,43674,159,612,771,7,7,2019,
9,43674,193,300,493,7,7,2019,
10,43674,226,158,384,7,7,2019,
11,43674,145,263,408,7,7,2019,
12,43674,186,304,490,7,7,2019,
13,43674,188,163,351,7,7,2019,
14,43674,159,358,517,7,7,2019,
15,43674,232,477,709,7,7,2019,
16,43674,240,242,482,7,7,2019,
17,43674,230,298,528,7,7,2019,
18,43674,91,195,286,7,7,2019,
19,43674,93,569,662,7,7,2019,
20,43674,119,21,140,7,7,2019,
21,43674,263,187,450,7,7,2019,
22,43674,289,408,697,7,7,2019,
23,43674,176,393,569,7,7,2019,
0,43675,102,252,354,1,7,2019,
1,43675,35,219,254,1,7,2019,
2,43675,24,50,74,1,7,2019,
3,43675,68,12,80,1,7,2019,
4,43675,67,6,73,1,7,2019,
5,43675,156,19,175,1,7,2019,
6,43675,274,137,411,1,7,2019,
7,43675,332,374,706,1,7,2019,
8,43675,258,437,695,1,7,2019,
9,43675,251,453,704,1,7,2019,
10,43675,160,188,348,1,7,2019,
11,43675,97,324,421,1,7,2019,
12,43675,185,151,336,1,7,2019,
13,43675,175,131,306,1,7,2019,
14,43675,221,283,504,1,7,2019,
15,43675,190,407,597,1,7,2019,
16,43675,177,66,243,1,7,2019,
17,43675,161,338,499,1,7,2019,
18,43675,108,307,415,1,7,2019,
19,43675,66,398,464,1,7,2019,
20,43675,105,218,323,1,7,2019,
21,43675,236,253,489,1,7,2019,
22,43675,267,223,490,1,7,2019,
23,43675,179,354,533,1,7,2019,
0,43676,89,341,430,2,7,2019,
1,43676,51,166,217,2,7,2019,
2,43676,58,225,283,2,7,2019,
3,43676,90,0,90,2,7,2019,
4,43676,43,0,43,2,7,2019,
5,43676,162,9,171,2,7,2019,
6,43676,348,61,409,2,7,2019,
7,43676,258,380,638,2,7,2019,
8,43676,177,376,553,2,7,2019,
9,43676,233,461,694,2,7,2019,
10,43676,193,123,316,2,7,2019,
11,43676,189,492,681,2,7,2019,
12,43676,212,272,484,2,7,2019,
13,43676,236,314,550,2,7,2019,
14,43676,140,184,324,2,7,2019,
15,43676,184,292,476,2,7,2019,
16,43676,166,254,420,2,7,2019,
17,43676,123,287,410,2,7,2019,
18,43676,76,165,241,2,7,2019,
19,43676,86,230,316,2,7,2019,
20,43676,136,215,351,2,7,2019,
21,43676,331,382,713,2,7,2019,
22,43676,300,348,648,2,7,2019,
23,43676,208,176,384,2,7,2019,
0,43677,65,156,221,3,7,2019,
1,43677,21,97,118,3,7,2019,
2,43677,34,38,72,3,7,2019,
3,43677,52,28,80,3,7,2019,
4,43677,92,0,92,3,7,2019,
5,43677,129,3,132,3,7,2019,
6,43677,281,47,328,3,7,2019,
7,43677,276,234,510,3,7,2019,
8,43677,245,607,852,3,7,2019,
9,43677,189,331,520,3,7,2019,
10,43677,241,233,474,3,7,2019,
11,43677,164,212,376,3,7,2019,
12,43677,149,316,465,3,7,2019,
13,43677,229,90,319,3,7,2019,
14,43677,174,349,523,3,7,2019,
15,43677,143,160,303,3,7,2019,
16,43677,173,188,361,3,7,2019,
17,43677,132,224,356,3,7,2019,
18,43677,82,251,333,3,7,2019,
19,43677,89,135,224,3,7,2019,
20,43677,186,107,293,3,7,2019,
21,43677,311,185,496,3,7,2019,
22,43677,379,222,601,3,7,2019,
23,43677,282,359,641,3,7,2019,
0,43678,162,319,481,4,8,2019,
1,43678,39,245,284,4,8,2019,
2,43678,42,35,77,4,8,2019,
3,43678,120,0,120,4,8,2019,
4,43678,122,0,122,4,8,2019,
5,43678,267,0,267,4,8,2019,
6,43678,300,83,383,4,8,2019,
7,43678,330,393,723,4,8,2019,
8,43678,288,360,648,4,8,2019,
9,43678,253,427,680,4,8,2019,
10,43678,249,116,365,4,8,2019,
11,43678,102,413,515,4,8,2019,
12,43678,147,213,360,4,8,2019,
13,43678,176,106,282,4,8,2019,
14,43678,216,207,423,4,8,2019,
15,43678,217,300,517,4,8,2019,
16,43678,49,0,49,4,8,2019,
17,43678,74,3,77,4,8,2019,
18,43678,19,0,19,4,8,2019,
19,43678,73,209,282,4,8,2019,
20,43678,167,82,249,4,8,2019,
21,43678,351,229,580,4,8,2019,
22,43678,314,212,526,4,8,2019,
23,43678,367,372,739,4,8,2019,
0,43679,134,253,387,5,8,2019,
1,43679,34,252,286,5,8,2019,
2,43679,45,10,55,5,8,2019,
3,43679,84,0,84,5,8,2019,
4,43679,167,0,167,5,8,2019,
5,43679,208,1,209,5,8,2019,
6,43679,290,79,369,5,8,2019,
7,43679,244,295,539,5,8,2019,
8,43679,207,362,569,5,8,2019,
9,43679,158,407,565,5,8,2019,
10,43679,167,134,301,5,8,2019,
11,43679,176,386,562,5,8,2019,
12,43679,161,197,358,5,8,2019,
13,43679,148,159,307,5,8,2019,
14,43679,196,371,567,5,8,2019,
15,43679,157,173,330,5,8,2019,
16,43679,173,178,351,5,8,2019,
17,43679,117,274,391,5,8,2019,
18,43679,75,285,360,5,8,2019,
19,43679,64,243,307,5,8,2019,
20,43679,189,232,421,5,8,2019,
21,43679,372,343,715,5,8,2019,
22,43679,345,169,514,5,8,2019,
23,43679,303,448,751,5,8,2019,
0,43680,159,232,391,6,8,2019,
1,43680,29,85,114,6,8,2019,
2,43680,64,3,67,6,8,2019,
3,43680,92,4,96,6,8,2019,
4,43680,64,76,140,6,8,2019,
5,43680,121,0,121,6,8,2019,
6,43680,320,24,344,6,8,2019,
7,43680,282,305,587,6,8,2019,
8,43680,322,600,922,6,8,2019,
9,43680,301,406,707,6,8,2019,
10,43680,183,294,477,6,8,2019,
11,43680,96,340,436,6,8,2019,
12,43680,198,148,346,6,8,2019,
13,43680,136,235,371,6,8,2019,
14,43680,182,258,440,6,8,2019,
15,43680,191,198,389,6,8,2019,
16,43680,229,330,559,6,8,2019,
17,43680,170,297,467,6,8,2019,
18,43680,69,291,360,6,8,2019,
19,43680,120,201,321,6,8,2019,
20,43680,166,149,315,6,8,2019,
21,43680,278,304,582,6,8,2019,
22,43680,282,120,402,6,8,2019,
23,43680,148,291,439,6,8,2019,
0,43681,118,370,488,7,8,2019,
1,43681,20,228,248,7,8,2019,
2,43681,41,0,41,7,8,2019,
3,43681,103,0,103,7,8,2019,
4,43681,122,0,122,7,8,2019,
5,43681,127,0,127,7,8,2019,
6,43681,218,0,218,7,8,2019,
7,43681,222,63,285,7,8,2019,
8,43681,186,613,799,7,8,2019,
9,43681,172,674,846,7,8,2019,
10,43681,247,167,414,7,8,2019,
11,43681,184,344,528,7,8,2019,
12,43681,172,306,478,7,8,2019,
13,43681,173,96,269,7,8,2019,
14,43681,168,210,378,7,8,2019,
15,43681,146,421,567,7,8,2019,
16,43681,191,279,470,7,8,2019,
17,43681,215,241,456,7,8,2019,
18,43681,91,277,368,7,8,2019,
19,43681,60,546,606,7,8,2019,
20,43681,170,90,260,7,8,2019,
21,43681,244,281,525,7,8,2019,
22,43681,255,295,550,7,8,2019,
23,43681,190,496,686,7,8,2019,
0,43682,80,319,399,1,8,2019,
1,43682,37,3,40,1,8,2019,
2,43682,29,34,63,1,8,2019,
3,43682,85,0,85,1,8,2019,
4,43682,75,0,75,1,8,2019,
5,43682,108,0,108,1,8,2019,
6,43682,249,0,249,1,8,2019,
7,43682,220,4,224,1,8,2019,
8,43682,155,407,562,1,8,2019,
9,43682,158,554,712,1,8,2019,
10,43682,182,423,605,1,8,2019,
11,43682,115,223,338,1,8,2019,
12,43682,150,99,249,1,8,2019,
13,43682,112,142,254,1,8,2019,
14,43682,164,252,416,1,8,2019,
15,43682,169,431,600,1,8,2019,
16,43682,170,340,510,1,8,2019,
17,43682,126,191,317,1,8,2019,
18,43682,76,178,254,1,8,2019,
19,43682,36,322,358,1,8,2019,
20,43682,77,238,315,1,8,2019,
21,43682,166,246,412,1,8,2019,
22,43682,205,206,411,1,8,2019,
23,43682,211,356,567,1,8,2019,
0,43683,65,278,343,2,8,2019,
1,43683,30,185,215,2,8,2019,
2,43683,48,35,83,2,8,2019,
3,43683,81,64,145,2,8,2019,
4,43683,91,12,103,2,8,2019,
5,43683,142,14,156,2,8,2019,
6,43683,251,96,347,2,8,2019,
7,43683,203,341,544,2,8,2019,
8,43683,205,358,563,2,8,2019,
9,43683,183,275,458,2,8,2019,
10,43683,175,283,458,2,8,2019,
11,43683,173,433,606,2,8,2019,
12,43683,217,256,473,2,8,2019,
13,43683,171,152,323,2,8,2019,
14,43683,153,387,540,2,8,2019,
15,43683,147,160,307,2,8,2019,
16,43683,128,244,372,2,8,2019,
17,43683,82,407,489,2,8,2019,
18,43683,52,114,166,2,8,2019,
19,43683,77,320,397,2,8,2019,
20,43683,115,228,343,2,8,2019,
21,43683,226,361,587,2,8,2019,
22,43683,301,177,478,2,8,2019,
23,43683,138,129,267,2,8,2019,
0,43684,82,199,281,3,8,2019,
1,43684,27,284,311,3,8,2019,
2,43684,22,92,114,3,8,2019,
3,43684,85,15,100,3,8,2019,
4,43684,68,0,68,3,8,2019,
5,43684,154,0,154,3,8,2019,
6,43684,206,132,338,3,8,2019,
7,43684,188,405,593,3,8,2019,
8,43684,202,221,423,3,8,2019,
9,43684,206,270,476,3,8,2019,
10,43684,196,174,370,3,8,2019,
11,43684,115,205,320,3,8,2019,
12,43684,120,179,299,3,8,2019,
13,43684,162,323,485,3,8,2019,
14,43684,160,298,458,3,8,2019,
15,43684,94,209,303,3,8,2019,
16,43684,139,225,364,3,8,2019,
17,43684,116,254,370,3,8,2019,
18,43684,78,244,322,3,8,2019,
19,43684,56,61,117,3,8,2019,
20,43684,86,65,151,3,8,2019,
21,43684,276,190,466,3,8,2019,
22,43684,245,175,420,3,8,2019,
23,43684,232,318,550,3,8,2019,
0,43685,155,409,564,4,8,2019,
1,43685,27,89,116,4,8,2019,
2,43685,27,63,90,4,8,2019,
3,43685,59,78,137,4,8,2019,
4,43685,76,3,79,4,8,2019,
5,43685,274,38,312,4,8,2019,
6,43685,364,68,432,4,8,2019,
7,43685,267,323,590,4,8,2019,
8,43685,210,129,339,4,8,2019,
9,43685,169,502,671,4,8,2019,
10,43685,287,177,464,4,8,2019,
11,43685,131,264,395,4,8,2019,
12,43685,175,268,443,4,8,2019,
13,43685,144,191,335,4,8,2019,
14,43685,129,167,296,4,8,2019,
15,43685,180,210,390,4,8,2019,
16,43685,188,356,544,4,8,2019,
17,43685,109,248,357,4,8,2019,
18,43685,67,328,395,4,8,2019,
19,43685,63,137,200,4,8,2019,
20,43685,118,214,332,4,8,2019,
21,43685,305,138,443,4,8,2019,
22,43685,348,210,558,4,8,2019,
23,43685,249,205,454,4,8,2019,
0,43686,111,402,513,5,8,2019,
1,43686,23,204,227,5,8,2019,
2,43686,38,27,65,5,8,2019,
3,43686,66,0,66,5,8,2019,
4,43686,99,0,99,5,8,2019,
5,43686,194,0,194,5,8,2019,
6,43686,273,55,328,5,8,2019,
7,43686,201,243,444,5,8,2019,
8,43686,203,311,514,5,8,2019,
9,43686,175,253,428,5,8,2019,
10,43686,172,265,437,5,8,2019,
11,43686,82,372,454,5,8,2019,
12,43686,157,122,279,5,8,2019,
13,43686,143,109,252,5,8,2019,
14,43686,179,329,508,5,8,2019,
15,43686,158,200,358,5,8,2019,
16,43686,166,348,514,5,8,2019,
17,43686,157,255,412,5,8,2019,
18,43686,93,221,314,5,8,2019,
19,43686,82,135,217,5,8,2019,
20,43686,145,182,327,5,8,2019,
21,43686,307,322,629,5,8,2019,
22,43686,302,172,474,5,8,2019,
23,43686,263,285,548,5,8,2019,
0,43687,179,357,536,6,8,2019,
1,43687,27,35,62,6,8,2019,
2,43687,55,0,55,6,8,2019,
3,43687,80,11,91,6,8,2019,
4,43687,62,2,64,6,8,2019,
5,43687,132,2,134,6,8,2019,
6,43687,309,0,309,6,8,2019,
7,43687,318,259,577,6,8,2019,
8,43687,334,652,986,6,8,2019,
9,43687,194,336,530,6,8,2019,
10,43687,87,285,372,6,8,2019,
11,43687,76,264,340,6,8,2019,
12,43687,143,72,215,6,8,2019,
13,43687,133,132,265,6,8,2019,
14,43687,138,231,369,6,8,2019,
15,43687,196,334,530,6,8,2019,
16,43687,237,159,396,6,8,2019,
17,43687,171,441,612,6,8,2019,
18,43687,50,192,242,6,8,2019,
19,43687,71,261,332,6,8,2019,
20,43687,133,225,358,6,8,2019,
21,43687,224,181,405,6,8,2019,
22,43687,201,384,585,6,8,2019,
23,43687,153,338,491,6,8,2019,
0,43688,95,286,381,7,8,2019,
1,43688,18,136,154,7,8,2019,
2,43688,34,0,34,7,8,2019,
3,43688,49,0,49,7,8,2019,
4,43688,120,0,120,7,8,2019,
5,43688,220,2,222,7,8,2019,
6,43688,259,124,383,7,8,2019,
7,43688,180,574,754,7,8,2019,
8,43688,143,427,570,7,8,2019,
9,43688,173,349,522,7,8,2019,
10,43688,208,117,325,7,8,2019,
11,43688,98,271,369,7,8,2019,
12,43688,130,269,399,7,8,2019,
13,43688,156,93,249,7,8,2019,
14,43688,129,514,643,7,8,2019,
15,43688,121,300,421,7,8,2019,
16,43688,200,241,441,7,8,2019,
17,43688,179,210,389,7,8,2019,
18,43688,107,328,435,7,8,2019,
19,43688,66,425,491,7,8,2019,
20,43688,181,330,511,7,8,2019,
21,43688,223,67,290,7,8,2019,
22,43688,169,296,465,7,8,2019,
23,43688,90,575,665,7,8,2019,
0,43689,88,339,427,1,8,2019,
1,43689,29,79,108,1,8,2019,
2,43689,8,19,27,1,8,2019,
3,43689,37,19,56,1,8,2019,
4,43689,63,0,63,1,8,2019,
5,43689,99,11,110,1,8,2019,
6,43689,215,164,379,1,8,2019,
7,43689,158,408,566,1,8,2019,
8,43689,132,348,480,1,8,2019,
9,43689,133,324,457,1,8,2019,
10,43689,108,141,249,1,8,2019,
11,43689,82,246,328,1,8,2019,
12,43689,101,215,316,1,8,2019,
13,43689,184,41,225,1,8,2019,
14,43689,140,359,499,1,8,2019,
15,43689,130,307,437,1,8,2019,
16,43689,172,164,336,1,8,2019,
17,43689,121,476,597,1,8,2019,
18,43689,78,251,329,1,8,2019,
19,43689,36,264,300,1,8,2019,
20,43689,81,182,263,1,8,2019,
21,43689,165,169,334,1,8,2019,
22,43689,175,230,405,1,8,2019,
23,43689,122,329,451,1,8,2019,
0,43690,46,276,322,2,8,2019,
1,43690,18,87,105,2,8,2019,
2,43690,51,0,51,2,8,2019,
3,43690,85,13,98,2,8,2019,
4,43690,26,0,26,2,8,2019,
5,43690,105,1,106,2,8,2019,
6,43690,253,107,360,2,8,2019,
7,43690,178,325,503,2,8,2019,
8,43690,147,255,402,2,8,2019,
9,43690,161,547,708,2,8,2019,
10,43690,164,172,336,2,8,2019,
11,43690,140,441,581,2,8,2019,
12,43690,172,219,391,2,8,2019,
13,43690,149,202,351,2,8,2019,
14,43690,128,192,320,2,8,2019,
15,43690,110,251,361,2,8,2019,
16,43690,119,190,309,2,8,2019,
17,43690,96,298,394,2,8,2019,
18,43690,28,222,250,2,8,2019,
19,43690,36,195,231,2,8,2019,
20,43690,114,76,190,2,8,2019,
21,43690,190,410,600,2,8,2019,
22,43690,239,299,538,2,8,2019,
23,43690,157,188,345,2,8,2019,
0,43691,55,155,210,3,8,2019,
1,43691,35,130,165,3,8,2019,
2,43691,18,2,20,3,8,2019,
3,43691,51,52,103,3,8,2019,
4,43691,82,0,82,3,8,2019,
5,43691,106,1,107,3,8,2019,
6,43691,229,51,280,3,8,2019,
7,43691,143,1,144,3,8,2019,
8,43691,201,13,214,3,8,2019,
9,43691,190,344,534,3,8,2019,
10,43691,158,443,601,3,8,2019,
11,43691,87,465,552,3,8,2019,
12,43691,143,287,430,3,8,2019,
13,43691,118,118,236,3,8,2019,
14,43691,159,234,393,3,8,2019,
15,43691,66,239,305,3,8,2019,
16,43691,111,242,353,3,8,2019,
17,43691,117,167,284,3,8,2019,
18,43691,41,222,263,3,8,2019,
19,43691,27,314,341,3,8,2019,
20,43691,100,111,211,3,8,2019,
21,43691,216,262,478,3,8,2019,
22,43691,232,152,384,3,8,2019,
23,43691,175,194,369,3,8,2019,
0,43692,125,333,458,4,8,2019,
1,43692,15,17,32,4,8,2019,
2,43692,50,16,66,4,8,2019,
3,43692,62,0,62,4,8,2019,
4,43692,91,0,91,4,8,2019,
5,43692,210,0,210,4,8,2019,
6,43692,286,0,286,4,8,2019,
7,43692,217,0,217,4,8,2019,
8,43692,195,8,203,4,8,2019,
9,43692,178,525,703,4,8,2019,
10,43692,250,564,814,4,8,2019,
11,43692,75,262,337,4,8,2019,
12,43692,131,205,336,4,8,2019,
13,43692,134,119,253,4,8,2019,
14,43692,112,94,206,4,8,2019,
15,43692,110,113,223,4,8,2019,
16,43692,157,311,468,4,8,2019,
17,43692,117,273,390,4,8,2019,
18,43692,55,209,264,4,8,2019,
19,43692,43,176,219,4,8,2019,
20,43692,104,83,187,4,8,2019,
21,43692,304,215,519,4,8,2019,
22,43692,295,165,460,4,8,2019,
23,43692,175,189,364,4,8,2019,
0,43693,85,190,275,5,8,2019,
1,43693,45,276,321,5,8,2019,
2,43693,42,37,79,5,8,2019,
3,43693,60,9,69,5,8,2019,
4,43693,134,6,140,5,8,2019,
5,43693,134,0,134,5,8,2019,
6,43693,277,15,292,5,8,2019,
7,43693,195,171,366,5,8,2019,
8,43693,163,318,481,5,8,2019,
9,43693,141,402,543,5,8,2019,
10,43693,127,120,247,5,8,2019,
11,43693,77,357,434,5,8,2019,
12,43693,120,136,256,5,8,2019,
13,43693,89,64,153,5,8,2019,
14,43693,146,321,467,5,8,2019,
15,43693,117,120,237,5,8,2019,
16,43693,134,218,352,5,8,2019,
17,43693,131,223,354,5,8,2019,
18,43693,77,132,209,5,8,2019,
19,43693,40,236,276,5,8,2019,
20,43693,109,139,248,5,8,2019,
21,43693,259,284,543,5,8,2019,
22,43693,241,134,375,5,8,2019,
23,43693,215,263,478,5,8,2019,
0,43694,169,254,423,6,8,2019,
1,43694,39,0,39,6,8,2019,
2,43694,24,0,24,6,8,2019,
3,43694,73,2,75,6,8,2019,
4,43694,48,1,49,6,8,2019,
5,43694,90,0,90,6,8,2019,
6,43694,231,9,240,6,8,2019,
7,43694,248,296,544,6,8,2019,
8,43694,238,600,838,6,8,2019,
9,43694,183,482,665,6,8,2019,
10,43694,156,128,284,6,8,2019,
11,43694,53,241,294,6,8,2019,
12,43694,111,120,231,6,8,2019,
13,43694,152,133,285,6,8,2019,
14,43694,167,261,428,6,8,2019,
15,43694,203,201,404,6,8,2019,
16,43694,162,284,446,6,8,2019,
17,43694,100,277,377,6,8,2019,
18,43694,47,156,203,6,8,2019,
19,43694,39,302,341,6,8,2019,
20,43694,104,158,262,6,8,2019,
21,43694,207,349,556,6,8,2019,
22,43694,161,133,294,6,8,2019,
23,43694,147,213,360,6,8,2019,
0,43695,49,248,297,7,8,2019,
1,43695,12,91,103,7,8,2019,
2,43695,29,0,29,7,8,2019,
3,43695,96,0,96,7,8,2019,
4,43695,106,0,106,7,8,2019,
5,43695,180,0,180,7,8,2019,
6,43695,203,50,253,7,8,2019,
7,43695,140,474,614,7,8,2019,
8,43695,115,453,568,7,8,2019,
9,43695,132,257,389,7,8,2019,
10,43695,191,79,270,7,8,2019,
11,43695,134,350,484,7,8,2019,
12,43695,153,264,417,7,8,2019,
13,43695,155,311,466,7,8,2019,
14,43695,97,393,490,7,8,2019,
15,43695,85,272,357,7,8,2019,
16,43695,146,280,426,7,8,2019,
17,43695,159,156,315,7,8,2019,
18,43695,68,281,349,7,8,2019,
19,43695,37,313,350,7,8,2019,
20,43695,105,168,273,7,8,2019,
21,43695,160,95,255,7,8,2019,
22,43695,224,110,334,7,8,2019,
23,43695,137,513,650,7,8,2019,
0,43696,82,386,468,1,8,2019,
1,43696,42,115,157,1,8,2019,
2,43696,16,0,16,1,8,2019,
3,43696,47,19,66,1,8,2019,
4,43696,54,0,54,1,8,2019,
5,43696,105,12,117,1,8,2019,
6,43696,239,138,377,1,8,2019,
7,43696,171,384,555,1,8,2019,
8,43696,129,222,351,1,8,2019,
9,43696,151,288,439,1,8,2019,
10,43696,121,72,193,1,8,2019,
11,43696,83,303,386,1,8,2019,
12,43696,109,41,150,1,8,2019,
13,43696,102,117,219,1,8,2019,
14,43696,104,338,442,1,8,2019,
15,43696,161,238,399,1,8,2019,
16,43696,91,166,257,1,8,2019,
17,43696,113,252,365,1,8,2019,
18,43696,37,182,219,1,8,2019,
19,43696,47,317,364,1,8,2019,
20,43696,79,183,262,1,8,2019,
21,43696,161,81,242,1,8,2019,
22,43696,155,187,342,1,8,2019,
23,43696,124,293,417,1,8,2019,
0,43697,47,284,331,2,8,2019,
1,43697,16,65,81,2,8,2019,
2,43697,44,0,44,2,8,2019,
3,43697,56,0,56,2,8,2019,
4,43697,42,1,43,2,8,2019,
5,43697,102,0,102,2,8,2019,
6,43697,184,92,276,2,8,2019,
7,43697,184,42,226,2,8,2019,
8,43697,134,1,135,2,8,2019,
9,43697,151,59,210,2,8,2019,
10,43697,126,212,338,2,8,2019,
11,43697,122,559,681,2,8,2019,
12,43697,140,528,668,2,8,2019,
13,43697,122,356,478,2,8,2019,
14,43697,119,174,293,2,8,2019,
15,43697,103,144,247,2,8,2019,
16,43697,145,108,253,2,8,2019,
17,43697,107,368,475,2,8,2019,
18,43697,68,131,199,2,8,2019,
19,43697,16,244,260,2,8,2019,
20,43697,78,195,273,2,8,2019,
21,43697,183,175,358,2,8,2019,
22,43697,190,76,266,2,8,2019,
23,43697,90,176,266,2,8,2019,
0,43698,51,279,330,3,8,2019,
1,43698,9,125,134,3,8,2019,
2,43698,27,14,41,3,8,2019,
3,43698,51,34,85,3,8,2019,
4,43698,77,0,77,3,8,2019,
5,43698,100,0,100,3,8,2019,
6,43698,210,2,212,3,8,2019,
7,43698,142,197,339,3,8,2019,
8,43698,176,301,477,3,8,2019,
9,43698,110,384,494,3,8,2019,
10,43698,135,182,317,3,8,2019,
11,43698,86,233,319,3,8,2019,
12,43698,123,166,289,3,8,2019,
13,43698,113,71,184,3,8,2019,
14,43698,101,254,355,3,8,2019,
15,43698,103,178,281,3,8,2019,
16,43698,117,278,395,3,8,2019,
17,43698,85,116,201,3,8,2019,
18,43698,36,108,144,3,8,2019,
19,43698,27,108,135,3,8,2019,
20,43698,109,69,178,3,8,2019,
21,43698,182,334,516,3,8,2019,
22,43698,234,113,347,3,8,2019,
23,43698,152,216,368,3,8,2019,
0,43699,103,172,275,4,8,2019,
1,43699,18,51,69,4,8,2019,
2,43699,44,0,44,4,8,2019,
3,43699,69,0,69,4,8,2019,
4,43699,85,5,90,4,8,2019,
5,43699,184,0,184,4,8,2019,
6,43699,306,118,424,4,8,2019,
7,43699,230,207,437,4,8,2019,
8,43699,168,305,473,4,8,2019,
9,43699,113,495,608,4,8,2019,
10,43699,119,71,190,4,8,2019,
11,43699,112,213,325,4,8,2019,
12,43699,86,205,291,4,8,2019,
13,43699,170,34,204,4,8,2019,
14,43699,127,200,327,4,8,2019,
15,43699,138,183,321,4,8,2019,
16,43699,141,121,262,4,8,2019,
17,43699,140,352,492,4,8,2019,
18,43699,45,164,209,4,8,2019,
19,43699,39,133,172,4,8,2019,
20,43699,90,136,226,4,8,2019,
21,43699,236,199,435,4,8,2019,
22,43699,281,139,420,4,8,2019,
23,43699,251,165,416,4,8,2019,
0,43700,69,213,282,5,8,2019,
1,43700,47,144,191,5,8,2019,
2,43700,18,0,18,5,8,2019,
3,43700,60,0,60,5,8,2019,
4,43700,94,0,94,5,8,2019,
5,43700,179,4,183,5,8,2019,
6,43700,273,108,381,5,8,2019,
7,43700,182,160,342,5,8,2019,
8,43700,185,326,511,5,8,2019,
9,43700,115,312,427,5,8,2019,
10,43700,112,138,250,5,8,2019,
11,43700,109,180,289,5,8,2019,
12,43700,121,193,314,5,8,2019,
13,43700,108,73,181,5,8,2019,
14,43700,119,207,326,5,8,2019,
15,43700,95,149,244,5,8,2019,
16,43700,93,270,363,5,8,2019,
17,43700,100,240,340,5,8,2019,
18,43700,58,164,222,5,8,2019,
19,43700,28,158,186,5,8,2019,
20,43700,107,55,162,5,8,2019,
21,43700,253,242,495,5,8,2019,
22,43700,285,165,450,5,8,2019,
23,43700,192,223,415,5,8,2019,
0,43701,154,89,243,6,8,2019,
1,43701,45,109,154,6,8,2019,
2,43701,47,36,83,6,8,2019,
3,43701,78,0,78,6,8,2019,
4,43701,48,1,49,6,8,2019,
5,43701,156,0,156,6,8,2019,
6,43701,193,39,232,6,8,2019,
7,43701,256,216,472,6,8,2019,
8,43701,265,487,752,6,8,2019,
9,43701,162,312,474,6,8,2019,
10,43701,182,190,372,6,8,2019,
11,43701,41,238,279,6,8,2019,
12,43701,153,76,229,6,8,2019,
13,43701,211,150,361,6,8,2019,
14,43701,130,187,317,6,8,2019,
15,43701,131,205,336,6,8,2019,
16,43701,160,262,422,6,8,2019,
17,43701,112,111,223,6,8,2019,
18,43701,44,206,250,6,8,2019,
19,43701,49,196,245,6,8,2019,
20,43701,104,267,371,6,8,2019,
21,43701,182,170,352,6,8,2019,
22,43701,186,157,343,6,8,2019,
23,43701,141,219,360,6,8,2019,
0,43702,71,82,153,7,8,2019,
1,43702,31,76,107,7,8,2019,
2,43702,32,0,32,7,8,2019,
3,43702,59,3,62,7,8,2019,
4,43702,111,0,111,7,8,2019,
5,43702,177,3,180,7,8,2019,
6,43702,205,49,254,7,8,2019,
7,43702,182,344,526,7,8,2019,
8,43702,105,454,559,7,8,2019,
9,43702,172,206,378,7,8,2019,
10,43702,145,55,200,7,8,2019,
11,43702,120,216,336,7,8,2019,
12,43702,209,213,422,7,8,2019,
13,43702,145,204,349,7,8,2019,
14,43702,126,335,461,7,8,2019,
15,43702,164,176,340,7,8,2019,
16,43702,169,124,293,7,8,2019,
17,43702,182,426,608,7,8,2019,
18,43702,98,256,354,7,8,2019,
19,43702,43,235,278,7,8,2019,
20,43702,74,205,279,7,8,2019,
21,43702,198,237,435,7,8,2019,
22,43702,201,239,440,7,8,2019,
23,43702,118,236,354,7,8,2019,
0,43703,66,293,359,1,8,2019,
1,43703,24,49,73,1,8,2019,
2,43703,18,0,18,1,8,2019,
3,43703,46,3,49,1,8,2019,
4,43703,32,0,32,1,8,2019,
5,43703,75,7,82,1,8,2019,
6,43703,183,88,271,1,8,2019,
7,43703,141,244,385,1,8,2019,
8,43703,140,238,378,1,8,2019,
9,43703,101,203,304,1,8,2019,
10,43703,156,157,313,1,8,2019,
11,43703,136,167,303,1,8,2019,
12,43703,124,106,230,1,8,2019,
13,43703,138,92,230,1,8,2019,
14,43703,161,323,484,1,8,2019,
15,43703,159,103,262,1,8,2019,
16,43703,131,323,454,1,8,2019,
17,43703,66,114,180,1,8,2019,
18,43703,58,175,233,1,8,2019,
19,43703,58,81,139,1,8,2019,
20,43703,93,226,319,1,8,2019,
21,43703,206,91,297,1,8,2019,
22,43703,172,291,463,1,8,2019,
23,43703,105,254,359,1,8,2019,
0,43704,38,154,192,2,8,2019,
1,43704,29,44,73,2,8,2019,
2,43704,24,0,24,2,8,2019,
3,43704,62,0,62,2,8,2019,
4,43704,38,1,39,2,8,2019,
5,43704,114,0,114,2,8,2019,
6,43704,210,102,312,2,8,2019,
7,43704,169,205,374,2,8,2019,
8,43704,144,194,338,2,8,2019,
9,43704,128,268,396,2,8,2019,
10,43704,113,126,239,2,8,2019,
11,43704,153,190,343,2,8,2019,
12,43704,134,179,313,2,8,2019,
13,43704,153,82,235,2,8,2019,
14,43704,82,300,382,2,8,2019,
15,43704,112,115,227,2,8,2019,
16,43704,64,175,239,2,8,2019,
17,43704,46,167,213,2,8,2019,
18,43704,32,180,212,2,8,2019,
19,43704,38,122,160,2,8,2019,
20,43704,94,84,178,2,8,2019,
21,43704,210,276,486,2,8,2019,
22,43704,217,74,291,2,8,2019,
23,43704,136,97,233,2,8,2019,
0,43705,83,56,139,3,8,2019,
1,43705,27,22,49,3,8,2019,
2,43705,24,0,24,3,8,2019,
3,43705,75,3,78,3,8,2019,
4,43705,70,0,70,3,8,2019,
5,43705,105,0,105,3,8,2019,
6,43705,236,27,263,3,8,2019,
7,43705,188,253,441,3,8,2019,
8,43705,156,258,414,3,8,2019,
9,43705,169,289,458,3,8,2019,
10,43705,161,64,225,3,8,2019,
11,43705,92,247,339,3,8,2019,
12,43705,113,188,301,3,8,2019,
13,43705,110,37,147,3,8,2019,
14,43705,151,213,364,3,8,2019,
15,43705,86,77,163,3,8,2019,
16,43705,59,239,298,3,8,2019,
17,43705,92,145,237,3,8,2019,
18,43705,33,129,162,3,8,2019,
19,43705,37,126,163,3,8,2019,
20,43705,122,165,287,3,8,2019,
21,43705,307,118,425,3,8,2019,
22,43705,253,92,345,3,8,2019,
23,43705,326,239,565,3,8,2019,
0,43706,203,37,240,4,8,2019,
1,43706,9,3,12,4,8,2019,
2,43706,50,0,50,4,8,2019,
3,43706,131,48,179,4,8,2019,
4,43706,108,0,108,4,8,2019,
5,43706,334,8,342,4,8,2019,
6,43706,346,62,408,4,8,2019,
7,43706,259,300,559,4,8,2019,
8,43706,238,268,506,4,8,2019,
9,43706,148,271,419,4,8,2019,
10,43706,222,9,231,4,8,2019,
11,43706,128,224,352,4,8,2019,
12,43706,195,188,383,4,8,2019,
13,43706,164,97,261,4,8,2019,
14,43706,197,163,360,4,8,2019,
15,43706,225,144,369,4,8,2019,
16,43706,169,236,405,4,8,2019,
17,43706,145,161,306,4,8,2019,
18,43706,72,104,176,4,8,2019,
19,43706,29,109,138,4,8,2019,
20,43706,167,86,253,4,8,2019,
21,43706,380,177,557,4,8,2019,
22,43706,517,152,669,4,8,2019,
23,43706,346,144,490,4,8,2019,
0,43707,189,160,349,5,8,2019,
1,43707,88,34,122,5,8,2019,
2,43707,57,19,76,5,8,2019,
3,43707,113,0,113,5,8,2019,
4,43707,131,0,131,5,8,2019,
5,43707,217,0,217,5,8,2019,
6,43707,329,70,399,5,8,2019,
7,43707,351,163,514,5,8,2019,
8,43707,296,217,513,5,8,2019,
9,43707,242,230,472,5,8,2019,
10,43707,282,176,458,5,8,2019,
11,43707,141,146,287,5,8,2019,
12,43707,209,126,335,5,8,2019,
13,43707,177,46,223,5,8,2019,
14,43707,194,125,319,5,8,2019,
15,43707,248,250,498,5,8,2019,
16,43707,263,169,432,5,8,2019,
17,43707,170,227,397,5,8,2019,
18,43707,77,101,178,5,8,2019,
19,43707,47,106,153,5,8,2019,
20,43707,182,137,319,5,8,2019,
21,43707,340,64,404,5,8,2019,
22,43707,431,230,661,5,8,2019,
23,43707,398,102,500,5,8,2019,
0,43708,217,204,421,6,8,2019,
1,43708,100,11,111,6,8,2019,
2,43708,103,0,103,6,8,2019,
3,43708,104,4,108,6,8,2019,
4,43708,88,1,89,6,8,2019,
5,43708,175,0,175,6,8,2019,
6,43708,267,47,314,6,8,2019,
7,43708,394,69,463,6,8,2019,
8,43708,334,242,576,6,8,2019,
9,43708,199,528,727,6,8,2019,
10,43708,205,169,374,6,8,2019,
11,43708,81,196,277,6,8,2019,
12,43708,155,140,295,6,8,2019,
13,43708,177,78,255,6,8,2019,
14,43708,140,271,411,6,8,2019,
15,43708,129,97,226,6,8,2019,
16,43708,147,239,386,6,8,2019,
17,43708,144,223,367,6,8,2019,
18,43708,44,93,137,6,8,2019,
19,43708,70,210,280,6,8,2019,
20,43708,102,57,159,6,8,2019,
21,43708,180,253,433,6,8,2019,
22,43708,195,158,353,6,8,2019,
23,43708,132,127,259,6,8,2019,
0,43709,75,56,131,7,9,2019,
1,43709,18,32,50,7,9,2019,
2,43709,41,0,41,7,9,2019,
3,43709,92,0,92,7,9,2019,
4,43709,101,0,101,7,9,2019,
5,43709,158,0,158,7,9,2019,
6,43709,199,52,251,7,9,2019,
7,43709,190,166,356,7,9,2019,
8,43709,126,479,605,7,9,2019,
9,43709,122,343,465,7,9,2019,
10,43709,134,41,175,7,9,2019,
11,43709,140,255,395,7,9,2019,
12,43709,170,58,228,7,9,2019,
13,43709,128,265,393,7,9,2019,
14,43709,124,302,426,7,9,2019,
15,43709,204,267,471,7,9,2019,
16,43709,151,240,391,7,9,2019,
17,43709,128,223,351,7,9,2019,
18,43709,33,260,293,7,9,2019,
19,43709,31,188,219,7,9,2019,
20,43709,90,230,320,7,9,2019,
21,43709,167,34,201,7,9,2019,
22,43709,147,164,311,7,9,2019,
23,43709,88,276,364,7,9,2019,
0,43710,55,258,313,1,9,2019,
1,43710,21,13,34,1,9,2019,
2,43710,15,0,15,1,9,2019,
3,43710,38,0,38,1,9,2019,
4,43710,11,0,11,1,9,2019,
5,43710,95,1,96,1,9,2019,
6,43710,205,99,304,1,9,2019,
7,43710,223,614,837,1,9,2019,
8,43710,144,304,448,1,9,2019,
9,43710,101,387,488,1,9,2019,
10,43710,118,262,380,1,9,2019,
11,43710,43,207,250,1,9,2019,
12,43710,109,202,311,1,9,2019,
13,43710,115,522,637,1,9,2019,
14,43710,144,69,213,1,9,2019,
15,43710,138,520,658,1,9,2019,
16,43710,123,401,524,1,9,2019,
17,43710,81,633,714,1,9,2019,
18,43710,34,239,273,1,9,2019,
19,43710,18,453,471,1,9,2019,
20,43710,56,284,340,1,9,2019,
21,43710,153,342,495,1,9,2019,
22,43710,130,426,556,1,9,2019,
23,43710,68,503,571,1,9,2019,
0,43711,50,443,493,2,9,2019,
1,43711,26,61,87,2,9,2019,
2,43711,44,92,136,2,9,2019,
3,43711,34,69,103,2,9,2019,
4,43711,47,1,48,2,9,2019,
5,43711,95,0,95,2,9,2019,
6,43711,151,86,237,2,9,2019,
7,43711,192,296,488,2,9,2019,
8,43711,148,373,521,2,9,2019,
9,43711,65,282,347,2,9,2019,
10,43711,99,299,398,2,9,2019,
11,43711,77,272,349,2,9,2019,
12,43711,99,368,467,2,9,2019,
13,43711,97,207,304,2,9,2019,
14,43711,68,337,405,2,9,2019,
15,43711,59,162,221,2,9,2019,
16,43711,39,206,245,2,9,2019,
17,43711,49,405,454,2,9,2019,
18,43711,15,345,360,2,9,2019,
19,43711,22,70,92,2,9,2019,
20,43711,115,316,431,2,9,2019,
21,43711,165,367,532,2,9,2019,
22,43711,165,95,260,2,9,2019,
23,43711,123,310,433,2,9,2019,
0,43712,50,96,146,3,9,2019,
1,43712,12,0,12,3,9,2019,
2,43712,14,5,19,3,9,2019,
3,43712,33,6,39,3,9,2019,
4,43712,69,0,69,3,9,2019,
5,43712,109,0,109,3,9,2019,
6,43712,144,31,175,3,9,2019,
7,43712,132,287,419,3,9,2019,
8,43712,107,375,482,3,9,2019,
9,43712,79,258,337,3,9,2019,
10,43712,101,130,231,3,9,2019,
11,43712,97,158,255,3,9,2019,
12,43712,99,160,259,3,9,2019,
13,43712,92,87,179,3,9,2019,
14,43712,68,187,255,3,9,2019,
15,43712,69,221,290,3,9,2019,
16,43712,86,183,269,3,9,2019,
17,43712,61,144,205,3,9,2019,
18,43712,13,221,234,3,9,2019,
19,43712,23,28,51,3,9,2019,
20,43712,68,188,256,3,9,2019,
21,43712,208,196,404,3,9,2019,
22,43712,205,94,299,3,9,2019,
23,43712,131,243,374,3,9,2019,
0,43713,57,143,200,4,9,2019,
1,43713,14,0,14,4,9,2019,
2,43713,34,0,34,4,9,2019,
3,43713,56,0,56,4,9,2019,
4,43713,51,0,51,4,9,2019,
5,43713,156,11,167,4,9,2019,
6,43713,200,90,290,4,9,2019,
7,43713,221,248,469,4,9,2019,
8,43713,155,199,354,4,9,2019,
9,43713,105,262,367,4,9,2019,
10,43713,131,63,194,4,9,2019,
11,43713,91,197,288,4,9,2019,
12,43713,133,139,272,4,9,2019,
13,43713,109,203,312,4,9,2019,
14,43713,114,48,162,4,9,2019,
15,43713,118,154,272,4,9,2019,
16,43713,112,219,331,4,9,2019,
17,43713,110,244,354,4,9,2019,
18,43713,28,149,177,4,9,2019,
19,43713,20,145,165,4,9,2019,
20,43713,91,191,282,4,9,2019,
21,43713,207,94,301,4,9,2019,
22,43713,282,170,452,4,9,2019,
23,43713,202,62,264,4,9,2019,
0,43714,155,181,336,5,9,2019,
1,43714,21,15,36,5,9,2019,
2,43714,19,26,45,5,9,2019,
3,43714,97,0,97,5,9,2019,
4,43714,100,1,101,5,9,2019,
5,43714,206,2,208,5,9,2019,
6,43714,261,42,303,5,9,2019,
7,43714,177,182,359,5,9,2019,
8,43714,151,312,463,5,9,2019,
9,43714,95,265,360,5,9,2019,
10,43714,169,120,289,5,9,2019,
11,43714,128,176,304,5,9,2019,
12,43714,121,106,227,5,9,2019,
13,43714,103,256,359,5,9,2019,
14,43714,105,178,283,5,9,2019,
15,43714,108,76,184,5,9,2019,
16,43714,63,200,263,5,9,2019,
17,43714,75,159,234,5,9,2019,
18,43714,52,202,254,5,9,2019,
19,43714,49,56,105,5,9,2019,
20,43714,105,137,242,5,9,2019,
21,43714,277,236,513,5,9,2019,
22,43714,287,136,423,5,9,2019,
23,43714,223,127,350,5,9,2019,
0,43715,116,122,238,6,9,2019,
1,43715,32,12,44,6,9,2019,
2,43715,45,0,45,6,9,2019,
3,43715,52,10,62,6,9,2019,
4,43715,83,1,84,6,9,2019,
5,43715,122,0,122,6,9,2019,
6,43715,258,0,258,6,9,2019,
7,43715,274,0,274,6,9,2019,
8,43715,191,217,408,6,9,2019,
9,43715,126,523,649,6,9,2019,
10,43715,171,351,522,6,9,2019,
11,43715,118,185,303,6,9,2019,
12,43715,101,167,268,6,9,2019,
13,43715,95,203,298,6,9,2019,
14,43715,86,129,215,6,9,2019,
15,43715,123,120,243,6,9,2019,
16,43715,114,260,374,6,9,2019,
17,43715,62,288,350,6,9,2019,
18,43715,15,124,139,6,9,2019,
19,43715,17,160,177,6,9,2019,
20,43715,101,229,330,6,9,2019,
21,43715,178,235,413,6,9,2019,
22,43715,184,210,394,6,9,2019,
23,43715,106,69,175,6,9,2019,
0,43716,60,69,129,7,9,2019,
1,43716,22,71,93,7,9,2019,
2,43716,37,5,42,7,9,2019,
3,43716,103,0,103,7,9,2019,
4,43716,117,0,117,7,9,2019,
5,43716,151,0,151,7,9,2019,
6,43716,193,2,195,7,9,2019,
7,43716,202,384,586,7,9,2019,
8,43716,102,301,403,7,9,2019,
9,43716,77,175,252,7,9,2019,
10,43716,185,44,229,7,9,2019,
11,43716,138,277,415,7,9,2019,
12,43716,128,117,245,7,9,2019,
13,43716,154,319,473,7,9,2019,
14,43716,107,256,363,7,9,2019,
15,43716,144,228,372,7,9,2019,
16,43716,120,200,320,7,9,2019,
17,43716,88,272,360,7,9,2019,
18,43716,56,223,279,7,9,2019,
19,43716,43,219,262,7,9,2019,
20,43716,78,224,302,7,9,2019,
21,43716,177,53,230,7,9,2019,
22,43716,181,196,377,7,9,2019,
23,43716,126,203,329,7,9,2019,
0,43717,59,225,284,1,9,2019,
1,43717,24,5,29,1,9,2019,
2,43717,16,0,16,1,9,2019,
3,43717,25,3,28,1,9,2019,
4,43717,32,0,32,1,9,2019,
5,43717,102,3,105,1,9,2019,
6,43717,172,46,218,1,9,2019,
7,43717,211,288,499,1,9,2019,
8,43717,118,176,294,1,9,2019,
9,43717,82,261,343,1,9,2019,
10,43717,135,108,243,1,9,2019,
11,43717,83,217,300,1,9,2019,
12,43717,107,107,214,1,9,2019,
13,43717,122,168,290,1,9,2019,
14,43717,153,92,245,1,9,2019,
15,43717,137,250,387,1,9,2019,
16,43717,118,245,363,1,9,2019,
17,43717,86,236,322,1,9,2019,
18,43717,43,163,206,1,9,2019,
19,43717,30,70,100,1,9,2019,
20,43717,67,174,241,1,9,2019,
21,43717,163,44,207,1,9,2019,
22,43717,183,210,393,1,9,2019,
23,43717,108,312,420,1,9,2019,
0,43718,50,125,175,2,9,2019,
1,43718,17,29,46,2,9,2019,
2,43718,41,0,41,2,9,2019,
3,43718,51,1,52,2,9,2019,
4,43718,48,0,48,2,9,2019,
5,43718,120,0,120,2,9,2019,
6,43718,185,51,236,2,9,2019,
7,43718,159,303,462,2,9,2019,
8,43718,112,285,397,2,9,2019,
9,43718,106,264,370,2,9,2019,
10,43718,128,112,240,2,9,2019,
11,43718,91,220,311,2,9,2019,
12,43718,138,110,248,2,9,2019,
13,43718,102,220,322,2,9,2019,
14,43718,60,121,181,2,9,2019,
15,43718,84,134,218,2,9,2019,
16,43718,77,166,243,2,9,2019,
17,43718,65,213,278,2,9,2019,
18,43718,32,144,176,2,9,2019,
19,43718,29,50,79,2,9,2019,
20,43718,77,128,205,2,9,2019,
21,43718,193,266,459,2,9,2019,
22,43718,212,76,288,2,9,2019,
23,43718,142,130,272,2,9,2019,
0,43719,80,162,242,3,9,2019,
1,43719,30,0,30,3,9,2019,
2,43719,77,3,80,3,9,2019,
3,43719,77,7,84,3,9,2019,
4,43719,112,0,112,3,9,2019,
5,43719,125,0,125,3,9,2019,
6,43719,200,12,212,3,9,2019,
7,43719,195,283,478,3,9,2019,
8,43719,135,227,362,3,9,2019,
9,43719,122,184,306,3,9,2019,
10,43719,173,243,416,3,9,2019,
11,43719,81,257,338,3,9,2019,
12,43719,100,197,297,3,9,2019,
13,43719,174,118,292,3,9,2019,
14,43719,93,222,315,3,9,2019,
15,43719,104,90,194,3,9,2019,
16,43719,166,121,287,3,9,2019,
17,43719,75,130,205,3,9,2019,
18,43719,18,215,233,3,9,2019,
19,43719,30,129,159,3,9,2019,
20,43719,115,169,284,3,9,2019,
21,43719,205,114,319,3,9,2019,
22,43719,164,132,296,3,9,2019,
23,43719,115,283,398,3,9,2019,
0,43720,94,69,163,4,9,2019,
1,43720,20,0,20,4,9,2019,
2,43720,49,0,49,4,9,2019,
3,43720,72,0,72,4,9,2019,
4,43720,85,0,85,4,9,2019,
5,43720,163,0,163,4,9,2019,
6,43720,301,102,403,4,9,2019,
7,43720,200,406,606,4,9,2019,
8,43720,122,155,277,4,9,2019,
9,43720,115,495,610,4,9,2019,
10,43720,114,23,137,4,9,2019,
11,43720,88,255,343,4,9,2019,
12,43720,100,170,270,4,9,2019,
13,43720,86,227,313,4,9,2019,
14,43720,156,56,212,4,9,2019,
15,43720,142,161,303,4,9,2019,
16,43720,137,246,383,4,9,2019,
17,43720,159,333,492,4,9,2019,
18,43720,70,202,272,4,9,2019,
19,43720,24,172,196,4,9,2019,
20,43720,107,176,283,4,9,2019,
21,43720,222,224,446,4,9,2019,
22,43720,253,283,536,4,9,2019,
23,43720,175,222,397,4,9,2019,
0,43721,92,227,319,5,9,2019,
1,43721,24,51,75,5,9,2019,
2,43721,27,0,27,5,9,2019,
3,43721,62,2,64,5,9,2019,
4,43721,43,0,43,5,9,2019,
5,43721,148,8,156,5,9,2019,
6,43721,231,82,313,5,9,2019,
7,43721,117,239,356,5,9,2019,
8,43721,107,282,389,5,9,2019,
9,43721,102,247,349,5,9,2019,
10,43721,103,142,245,5,9,2019,
11,43721,68,269,337,5,9,2019,
12,43721,97,97,194,5,9,2019,
13,43721,82,209,291,5,9,2019,
14,43721,117,228,345,5,9,2019,
15,43721,96,137,233,5,9,2019,
16,43721,80,238,318,5,9,2019,
17,43721,89,172,261,5,9,2019,
18,43721,60,334,394,5,9,2019,
19,43721,33,191,224,5,9,2019,
20,43721,96,175,271,5,9,2019,
21,43721,253,159,412,5,9,2019,
22,43721,215,253,468,5,9,2019,
23,43721,159,303,462,5,9,2019,
0,43722,88,291,379,6,9,2019,
1,43722,29,13,42,6,9,2019,
2,43722,37,9,46,6,9,2019,
3,43722,58,32,90,6,9,2019,
4,43722,22,0,22,6,9,2019,
5,43722,128,0,128,6,9,2019,
6,43722,262,58,320,6,9,2019,
7,43722,178,275,453,6,9,2019,
8,43722,168,491,659,6,9,2019,
9,43722,110,365,475,6,9,2019,
10,43722,104,97,201,6,9,2019,
11,43722,64,273,337,6,9,2019,
12,43722,94,143,237,6,9,2019,
13,43722,123,183,306,6,9,2019,
14,43722,108,212,320,6,9,2019,
15,43722,173,90,263,6,9,2019,
16,43722,118,325,443,6,9,2019,
17,43722,86,214,300,6,9,2019,
18,43722,20,252,272,6,9,2019,
19,43722,39,110,149,6,9,2019,
20,43722,89,189,278,6,9,2019,
21,43722,250,167,417,6,9,2019,
22,43722,205,156,361,6,9,2019,
23,43722,133,97,230,6,9,2019,
0,43723,51,118,169,7,9,2019,
1,43723,19,2,21,7,9,2019,
2,43723,33,0,33,7,9,2019,
3,43723,100,0,100,7,9,2019,
4,43723,117,1,118,7,9,2019,
5,43723,169,1,170,7,9,2019,
6,43723,277,57,334,7,9,2019,
7,43723,196,330,526,7,9,2019,
8,43723,98,410,508,7,9,2019,
9,43723,109,220,329,7,9,2019,
10,43723,148,96,244,7,9,2019,
11,43723,133,201,334,7,9,2019,
12,43723,165,201,366,7,9,2019,
13,43723,120,152,272,7,9,2019,
14,43723,142,383,525,7,9,2019,
15,43723,162,95,257,7,9,2019,
16,43723,134,230,364,7,9,2019,
17,43723,130,211,341,7,9,2019,
18,43723,52,181,233,7,9,2019,
19,43723,55,104,159,7,9,2019,
20,43723,146,186,332,7,9,2019,
21,43723,212,199,411,7,9,2019,
22,43723,173,150,323,7,9,2019,
23,43723,149,186,335,7,9,2019,
0,43724,104,161,265,1,9,2019,
1,43724,26,0,26,1,9,2019,
2,43724,25,3,28,1,9,2019,
3,43724,62,0,62,1,9,2019,
4,43724,83,0,83,1,9,2019,
5,43724,98,0,98,1,9,2019,
6,43724,203,110,313,1,9,2019,
7,43724,255,64,319,1,9,2019,
8,43724,225,231,456,1,9,2019,
9,43724,208,261,469,1,9,2019,
10,43724,128,192,320,1,9,2019,
11,43724,140,149,289,1,9,2019,
12,43724,108,49,157,1,9,2019,
13,43724,156,97,253,1,9,2019,
14,43724,198,29,227,1,9,2019,
15,43724,287,122,409,1,9,2019,
16,43724,276,130,406,1,9,2019,
17,43724,142,136,278,1,9,2019,
18,43724,57,90,147,1,9,2019,
19,43724,63,9,72,1,9,2019,
20,43724,109,87,196,1,9,2019,
21,43724,211,48,259,1,9,2019,
22,43724,251,169,420,1,9,2019,
23,43724,132,159,291,1,9,2019,
0,43725,62,130,192,2,9,2019,
1,43725,26,0,26,2,9,2019,
2,43725,28,0,28,2,9,2019,
3,43725,119,1,120,2,9,2019,
4,43725,95,0,95,2,9,2019,
5,43725,167,9,176,2,9,2019,
6,43725,309,25,334,2,9,2019,
7,43725,285,157,442,2,9,2019,
8,43725,168,248,416,2,9,2019,
9,43725,136,163,299,2,9,2019,
10,43725,160,32,192,2,9,2019,
11,43725,156,173,329,2,9,2019,
12,43725,195,196,391,2,9,2019,
13,43725,213,108,321,2,9,2019,
14,43725,84,201,285,2,9,2019,
15,43725,136,39,175,2,9,2019,
16,43725,162,132,294,2,9,2019,
17,43725,99,152,251,2,9,2019,
18,43725,44,142,186,2,9,2019,
19,43725,20,110,130,2,9,2019,
20,43725,106,90,196,2,9,2019,
21,43725,227,243,470,2,9,2019,
22,43725,199,118,317,2,9,2019,
23,43725,163,127,290,2,9,2019,
0,43726,87,57,144,3,9,2019,
1,43726,15,73,88,3,9,2019,
2,43726,59,23,82,3,9,2019,
3,43726,85,0,85,3,9,2019,
4,43726,79,0,79,3,9,2019,
5,43726,119,0,119,3,9,2019,
6,43726,243,1,244,3,9,2019,
7,43726,171,368,539,3,9,2019,
8,43726,138,232,370,3,9,2019,
9,43726,112,149,261,3,9,2019,
10,43726,157,187,344,3,9,2019,
11,43726,113,120,233,3,9,2019,
12,43726,148,135,283,3,9,2019,
13,43726,114,115,229,3,9,2019,
14,43726,127,125,252,3,9,2019,
15,43726,122,175,297,3,9,2019,
16,43726,141,110,251,3,9,2019,
17,43726,107,176,283,3,9,2019,
18,43726,38,150,188,3,9,2019,
19,43726,27,201,228,3,9,2019,
20,43726,94,214,308,3,9,2019,
21,43726,275,55,330,3,9,2019,
22,43726,286,140,426,3,9,2019,
23,43726,133,206,339,3,9,2019,
0,43727,87,113,200,4,9,2019,
1,43727,5,0,5,4,9,2019,
2,43727,31,0,31,4,9,2019,
3,43727,80,0,80,4,9,2019,
4,43727,74,0,74,4,9,2019,
5,43727,257,4,261,4,9,2019,
6,43727,327,57,384,4,9,2019,
7,43727,290,385,675,4,9,2019,
8,43727,227,231,458,4,9,2019,
9,43727,145,394,539,4,9,2019,
10,43727,167,40,207,4,9,2019,
11,43727,120,228,348,4,9,2019,
12,43727,114,125,239,4,9,2019,
13,43727,87,119,206,4,9,2019,
14,43727,136,123,259,4,9,2019,
15,43727,155,162,317,4,9,2019,
16,43727,205,138,343,4,9,2019,
17,43727,167,191,358,4,9,2019,
18,43727,76,142,218,4,9,2019,
19,43727,34,229,263,4,9,2019,
20,43727,114,165,279,4,9,2019,
21,43727,285,130,415,4,9,2019,
22,43727,329,117,446,4,9,2019,
23,43727,247,155,402,4,9,2019,
0,43728,188,170,358,5,9,2019,
1,43728,64,79,143,5,9,2019,
2,43728,37,1,38,5,9,2019,
3,43728,92,16,108,5,9,2019,
4,43728,115,7,122,5,9,2019,
5,43728,235,0,235,5,9,2019,
6,43728,355,68,423,5,9,2019,
7,43728,218,177,395,5,9,2019,
8,43728,195,314,509,5,9,2019,
9,43728,100,259,359,5,9,2019,
10,43728,186,99,285,5,9,2019,
11,43728,101,166,267,5,9,2019,
12,43728,159,131,290,5,9,2019,
13,43728,132,201,333,5,9,2019,
14,43728,101,167,268,5,9,2019,
15,43728,194,45,239,5,9,2019,
16,43728,126,232,358,5,9,2019,
17,43728,150,187,337,5,9,2019,
18,43728,66,129,195,5,9,2019,
19,43728,42,100,142,5,9,2019,
20,43728,116,216,332,5,9,2019,
21,43728,265,147,412,5,9,2019,
22,43728,315,138,453,5,9,2019,
23,43728,249,182,431,5,9,2019,
0,43729,159,132,291,6,9,2019,
1,43729,34,0,34,6,9,2019,
2,43729,47,4,51,6,9,2019,
3,43729,78,0,78,6,9,2019,
4,43729,102,0,102,6,9,2019,
5,43729,152,0,152,6,9,2019,
6,43729,286,3,289,6,9,2019,
7,43729,319,201,520,6,9,2019,
8,43729,284,537,821,6,9,2019,
9,43729,160,294,454,6,9,2019,
10,43729,137,144,281,6,9,2019,
11,43729,119,237,356,6,9,2019,
12,43729,131,121,252,6,9,2019,
13,43729,159,216,375,6,9,2019,
14,43729,122,170,292,6,9,2019,
15,43729,200,189,389,6,9,2019,
16,43729,143,150,293,6,9,2019,
17,43729,90,291,381,6,9,2019,
18,43729,30,234,264,6,9,2019,
19,43729,21,106,127,6,9,2019,
20,43729,113,262,375,6,9,2019,
21,43729,240,146,386,6,9,2019,
22,43729,225,92,317,6,9,2019,
23,43729,134,167,301,6,9,2019,
0,43730,84,189,273,7,9,2019,
1,43730,38,20,58,7,9,2019,
2,43730,60,0,60,7,9,2019,
3,43730,117,0,117,7,9,2019,
4,43730,165,0,165,7,9,2019,
5,43730,187,0,187,7,9,2019,
6,43730,222,0,222,7,9,2019,
7,43730,253,0,253,7,9,2019,
8,43730,127,29,156,7,9,2019,
9,43730,153,290,443,7,9,2019,
10,43730,155,353,508,7,9,2019,
11,43730,162,529,691,7,9,2019,
12,43730,146,383,529,7,9,2019,
13,43730,130,189,319,7,9,2019,
14,43730,131,133,264,7,9,2019,
15,43730,191,118,309,7,9,2019,
16,43730,189,309,498,7,9,2019,
17,43730,135,411,546,7,9,2019,
18,43730,65,303,368,7,9,2019,
19,43730,45,320,365,7,9,2019,
20,43730,109,159,268,7,9,2019,
21,43730,218,45,263,7,9,2019,
22,43730,258,114,372,7,9,2019,
23,43730,120,315,435,7,9,2019,
0,43731,65,312,377,1,9,2019,
1,43731,19,58,77,1,9,2019,
2,43731,7,7,14,1,9,2019,
3,43731,50,0,50,1,9,2019,
4,43731,32,1,33,1,9,2019,
5,43731,125,7,132,1,9,2019,
6,43731,240,70,310,1,9,2019,
7,43731,249,342,591,1,9,2019,
8,43731,152,284,436,1,9,2019,
9,43731,95,334,429,1,9,2019,
10,43731,153,76,229,1,9,2019,
11,43731,70,249,319,1,9,2019,
12,43731,103,64,167,1,9,2019,
13,43731,150,181,331,1,9,2019,
14,43731,174,113,287,1,9,2019,
15,43731,227,219,446,1,9,2019,
16,43731,104,285,389,1,9,2019,
17,43731,136,327,463,1,9,2019,
18,43731,43,275,318,1,9,2019,
19,43731,22,141,163,1,9,2019,
20,43731,57,136,193,1,9,2019,
21,43731,139,253,392,1,9,2019,
22,43731,131,237,368,1,9,2019,
23,43731,76,291,367,1,9,2019,
0,43732,26,187,213,2,9,2019,
1,43732,9,1,10,2,9,2019,
2,43732,29,0,29,2,9,2019,
3,43732,68,0,68,2,9,2019,
4,43732,101,0,101,2,9,2019,
5,43732,133,8,141,2,9,2019,
6,43732,254,72,326,2,9,2019,
7,43732,195,230,425,2,9,2019,
8,43732,142,166,308,2,9,2019,
9,43732,125,114,239,2,9,2019,
10,43732,179,118,297,2,9,2019,
11,43732,132,119,251,2,9,2019,
12,43732,156,254,410,2,9,2019,
13,43732,124,167,291,2,9,2019,
14,43732,86,241,327,2,9,2019,
15,43732,94,56,150,2,9,2019,
16,43732,97,50,147,2,9,2019,
17,43732,46,285,331,2,9,2019,
18,43732,14,99,113,2,9,2019,
19,43732,35,100,135,2,9,2019,
20,43732,84,215,299,2,9,2019,
21,43732,228,241,469,2,9,2019,
22,43732,216,83,299,2,9,2019,
23,43732,149,212,361,2,9,2019,
0,43733,63,53,116,3,9,2019,
1,43733,22,0,22,3,9,2019,
2,43733,29,1,30,3,9,2019,
3,43733,74,0,74,3,9,2019,
4,43733,108,0,108,3,9,2019,
5,43733,118,0,118,3,9,2019,
6,43733,261,21,282,3,9,2019,
7,43733,155,250,405,3,9,2019,
8,43733,164,206,370,3,9,2019,
9,43733,122,297,419,3,9,2019,
10,43733,170,135,305,3,9,2019,
11,43733,110,259,369,3,9,2019,
12,43733,141,85,226,3,9,2019,
13,43733,120,113,233,3,9,2019,
14,43733,118,115,233,3,9,2019,
15,43733,108,172,280,3,9,2019,
16,43733,94,178,272,3,9,2019,
17,43733,88,155,243,3,9,2019,
18,43733,7,216,223,3,9,2019,
19,43733,31,35,66,3,9,2019,
20,43733,112,173,285,3,9,2019,
21,43733,376,95,471,3,9,2019,
22,43733,272,114,386,3,9,2019,
23,43733,209,201,410,3,9,2019,
0,43734,153,90,243,4,9,2019,
1,43734,26,0,26,4,9,2019,
2,43734,46,0,46,4,9,2019,
3,43734,109,0,109,4,9,2019,
4,43734,90,0,90,4,9,2019,
5,43734,255,26,281,4,9,2019,
6,43734,407,63,470,4,9,2019,
7,43734,323,336,659,4,9,2019,
8,43734,266,253,519,4,9,2019,
9,43734,146,326,472,4,9,2019,
10,43734,165,70,235,4,9,2019,
11,43734,164,211,375,4,9,2019,
12,43734,147,152,299,4,9,2019,
13,43734,154,137,291,4,9,2019,
14,43734,126,92,218,4,9,2019,
15,43734,153,120,273,4,9,2019,
16,43734,180,251,431,4,9,2019,
17,43734,181,112,293,4,9,2019,
18,43734,76,210,286,4,9,2019,
19,43734,33,100,133,4,9,2019,
20,43734,120,150,270,4,9,2019,
21,43734,297,274,571,4,9,2019,
22,43734,371,157,528,4,9,2019,
23,43734,302,216,518,4,9,2019,
0,43735,336,165,501,5,9,2019,
1,43735,41,7,48,5,9,2019,
2,43735,74,0,74,5,9,2019,
3,43735,96,1,97,5,9,2019,
4,43735,135,0,135,5,9,2019,
5,43735,211,1,212,5,9,2019,
6,43735,357,75,432,5,9,2019,
7,43735,285,136,421,5,9,2019,
8,43735,233,358,591,5,9,2019,
9,43735,95,277,372,5,9,2019,
10,43735,193,111,304,5,9,2019,
11,43735,139,149,288,5,9,2019,
12,43735,164,122,286,5,9,2019,
13,43735,146,166,312,5,9,2019,
14,43735,143,218,361,5,9,2019,
15,43735,154,92,246,5,9,2019,
16,43735,164,213,377,5,9,2019,
17,43735,103,219,322,5,9,2019,
18,43735,56,179,235,5,9,2019,
19,43735,42,84,126,5,9,2019,
20,43735,161,221,382,5,9,2019,
21,43735,317,183,500,5,9,2019,
22,43735,296,93,389,5,9,2019,
23,43735,225,261,486,5,9,2019,
0,43736,121,132,253,6,9,2019,
1,43736,41,12,53,6,9,2019,
2,43736,61,3,64,6,9,2019,
3,43736,84,0,84,6,9,2019,
4,43736,137,0,137,6,9,2019,
5,43736,122,0,122,6,9,2019,
6,43736,359,30,389,6,9,2019,
7,43736,340,202,542,6,9,2019,
8,43736,293,403,696,6,9,2019,
9,43736,162,278,440,6,9,2019,
10,43736,165,110,275,6,9,2019,
11,43736,140,247,387,6,9,2019,
12,43736,130,122,252,6,9,2019,
13,43736,128,299,427,6,9,2019,
14,43736,143,81,224,6,9,2019,
15,43736,166,130,296,6,9,2019,
16,43736,190,179,369,6,9,2019,
17,43736,64,282,346,6,9,2019,
18,43736,31,138,169,6,9,2019,
19,43736,58,248,306,6,9,2019,
20,43736,132,236,368,6,9,2019,
21,43736,232,137,369,6,9,2019,
22,43736,198,145,343,6,9,2019,
23,43736,127,188,315,6,9,2019,
0,43737,104,112,216,7,9,2019,
1,43737,35,52,87,7,9,2019,
2,43737,35,0,35,7,9,2019,
3,43737,102,0,102,7,9,2019,
4,43737,156,0,156,7,9,2019,
5,43737,177,3,180,7,9,2019,
6,43737,221,62,283,7,9,2019,
7,43737,243,277,520,7,9,2019,
8,43737,113,561,674,7,9,2019,
9,43737,118,140,258,7,9,2019,
10,43737,212,83,295,7,9,2019,
11,43737,136,172,308,7,9,2019,
12,43737,177,267,444,7,9,2019,
13,43737,121,176,297,7,9,2019,
14,43737,104,362,466,7,9,2019,
15,43737,194,241,435,7,9,2019,
16,43737,176,247,423,7,9,2019,
17,43737,154,223,377,7,9,2019,
18,43737,75,345,420,7,9,2019,
19,43737,60,286,346,7,9,2019,
20,43737,91,256,347,7,9,2019,
21,43737,247,155,402,7,9,2019,
22,43737,195,153,348,7,9,2019,
23,43737,100,284,384,7,9,2019,
0,43738,75,232,307,1,9,2019,
1,43738,40,5,45,1,9,2019,
2,43738,20,17,37,1,9,2019,
3,43738,33,8,41,1,9,2019,
4,43738,38,0,38,1,9,2019,
5,43738,132,0,132,1,9,2019,
6,43738,262,93,355,1,9,2019,
7,43738,225,372,597,1,9,2019,
8,43738,164,263,427,1,9,2019,
9,43738,124,336,460,1,9,2019,
10,43738,193,113,306,1,9,2019,
11,43738,87,168,255,1,9,2019,
12,43738,88,162,250,1,9,2019,
13,43738,154,92,246,1,9,2019,
14,43738,199,70,269,1,9,2019,
15,43738,179,184,363,1,9,2019,
16,43738,116,372,488,1,9,2019,
17,43738,156,213,369,1,9,2019,
18,43738,42,313,355,1,9,2019,
19,43738,23,265,288,1,9,2019,
20,43738,88,291,379,1,9,2019,
21,43738,181,89,270,1,9,2019,
22,43738,166,295,461,1,9,2019,
23,43738,73,349,422,1,9,2019,
0,43739,20,211,231,2,10,2019,
1,43739,15,74,89,2,10,2019,
2,43739,41,0,41,2,10,2019,
3,43739,81,0,81,2,10,2019,
4,43739,45,0,45,2,10,2019,
5,43739,106,1,107,2,10,2019,
6,43739,229,54,283,2,10,2019,
7,43739,215,136,351,2,10,2019,
8,43739,188,404,592,2,10,2019,
9,43739,114,307,421,2,10,2019,
10,43739,134,91,225,2,10,2019,
11,43739,93,192,285,2,10,2019,
12,43739,114,262,376,2,10,2019,
13,43739,109,123,232,2,10,2019,
14,43739,89,344,433,2,10,2019,
15,43739,115,83,198,2,10,2019,
16,43739,134,148,282,2,10,2019,
17,43739,61,276,337,2,10,2019,
18,43739,29,125,154,2,10,2019,
19,43739,13,205,218,2,10,2019,
20,43739,124,217,341,2,10,2019,
21,43739,267,293,560,2,10,2019,
22,43739,268,169,437,2,10,2019,
23,43739,150,211,361,2,10,2019,
0,43740,21,84,105,3,10,2019,
1,43740,9,58,67,3,10,2019,
2,43740,17,0,17,3,10,2019,
3,43740,67,0,67,3,10,2019,
4,43740,77,0,77,3,10,2019,
5,43740,145,0,145,3,10,2019,
6,43740,237,19,256,3,10,2019,
7,43740,201,292,493,3,10,2019,
8,43740,138,226,364,3,10,2019,
9,43740,147,317,464,3,10,2019,
10,43740,132,115,247,3,10,2019,
11,43740,86,170,256,3,10,2019,
12,43740,77,87,164,3,10,2019,
13,43740,91,78,169,3,10,2019,
14,43740,124,209,333,3,10,2019,
15,43740,62,139,201,3,10,2019,
16,43740,104,143,247,3,10,2019,
17,43740,101,155,256,3,10,2019,
18,43740,35,208,243,3,10,2019,
19,43740,28,80,108,3,10,2019,
20,43740,119,232,351,3,10,2019,
21,43740,252,87,339,3,10,2019,
22,43740,246,55,301,3,10,2019,
23,43740,222,346,568,3,10,2019,
0,43741,55,83,138,4,10,2019,
1,43741,24,3,27,4,10,2019,
2,43741,35,0,35,4,10,2019,
3,43741,84,0,84,4,10,2019,
4,43741,79,0,79,4,10,2019,
5,43741,236,0,236,4,10,2019,
6,43741,350,44,394,4,10,2019,
7,43741,290,324,614,4,10,2019,
8,43741,196,180,376,4,10,2019,
9,43741,80,363,443,4,10,2019,
10,43741,176,75,251,4,10,2019,
11,43741,141,140,281,4,10,2019,
12,43741,99,208,307,4,10,2019,
13,43741,157,117,274,4,10,2019,
14,43741,179,202,381,4,10,2019,
15,43741,143,172,315,4,10,2019,
16,43741,86,113,199,4,10,2019,
17,43741,118,278,396,4,10,2019,
18,43741,65,122,187,4,10,2019,
19,43741,33,223,256,4,10,2019,
20,43741,111,131,242,4,10,2019,
21,43741,245,243,488,4,10,2019,
22,43741,261,169,430,4,10,2019,
23,43741,309,234,543,4,10,2019,
0,43742,189,49,238,5,10,2019,
1,43742,18,35,53,5,10,2019,
2,43742,23,0,23,5,10,2019,
3,43742,55,0,55,5,10,2019,
4,43742,88,0,88,5,10,2019,
5,43742,215,3,218,5,10,2019,
6,43742,320,59,379,5,10,2019,
7,43742,296,160,456,5,10,2019,
8,43742,196,282,478,5,10,2019,
9,43742,138,268,406,5,10,2019,
10,43742,160,179,339,5,10,2019,
11,43742,114,108,222,5,10,2019,
12,43742,104,120,224,5,10,2019,
13,43742,93,105,198,5,10,2019,
14,43742,125,221,346,5,10,2019,
15,43742,131,129,260,5,10,2019,
16,43742,129,106,235,5,10,2019,
17,43742,130,173,303,5,10,2019,
18,43742,45,113,158,5,10,2019,
19,43742,34,269,303,5,10,2019,
20,43742,89,215,304,5,10,2019,
21,43742,225,205,430,5,10,2019,
22,43742,320,161,481,5,10,2019,
23,43742,228,110,338,5,10,2019,
0,43743,40,140,180,6,10,2019,
1,43743,9,50,59,6,10,2019,
2,43743,29,2,31,6,10,2019,
3,43743,103,0,103,6,10,2019,
4,43743,61,0,61,6,10,2019,
5,43743,190,0,190,6,10,2019,
6,43743,323,25,348,6,10,2019,
7,43743,329,199,528,6,10,2019,
8,43743,278,423,701,6,10,2019,
9,43743,171,253,424,6,10,2019,
10,43743,143,175,318,6,10,2019,
11,43743,87,216,303,6,10,2019,
12,43743,141,207,348,6,10,2019,
13,43743,124,100,224,6,10,2019,
14,43743,109,269,378,6,10,2019,
15,43743,135,215,350,6,10,2019,
16,43743,102,217,319,6,10,2019,
17,43743,103,256,359,6,10,2019,
18,43743,21,149,170,6,10,2019,
19,43743,54,257,311,6,10,2019,
20,43743,114,269,383,6,10,2019,
21,43743,168,181,349,6,10,2019,
22,43743,204,161,365,6,10,2019,
23,43743,146,158,304,6,10,2019,
0,43744,32,113,145,7,10,2019,
1,43744,10,7,17,7,10,2019,
2,43744,24,0,24,7,10,2019,
3,43744,87,0,87,7,10,2019,
4,43744,133,0,133,7,10,2019,
5,43744,160,6,166,7,10,2019,
6,43744,299,49,348,7,10,2019,
7,43744,250,373,623,7,10,2019,
8,43744,127,479,606,7,10,2019,
9,43744,113,242,355,7,10,2019,
10,43744,186,83,269,7,10,2019,
11,43744,141,282,423,7,10,2019,
12,43744,143,278,421,7,10,2019,
13,43744,157,163,320,7,10,2019,
14,43744,118,435,553,7,10,2019,
15,43744,113,175,288,7,10,2019,
16,43744,160,217,377,7,10,2019,
17,43744,158,166,324,7,10,2019,
18,43744,91,408,499,7,10,2019,
19,43744,29,307,336,7,10,2019,
20,43744,95,186,281,7,10,2019,
21,43744,218,189,407,7,10,2019,
22,43744,223,198,421,7,10,2019,
23,43744,98,442,540,7,10,2019,
0,43745,44,132,176,1,10,2019,
1,43745,8,1,9,1,10,2019,
2,43745,12,0,12,1,10,2019,
3,43745,35,0,35,1,10,2019,
4,43745,46,0,46,1,10,2019,
5,43745,108,16,124,1,10,2019,
6,43745,209,66,275,1,10,2019,
7,43745,225,344,569,1,10,2019,
8,43745,146,288,434,1,10,2019,
9,43745,68,373,441,1,10,2019,
10,43745,126,53,179,1,10,2019,
11,43745,97,149,246,1,10,2019,
12,43745,98,246,344,1,10,2019,
13,43745,125,95,220,1,10,2019,
14,43745,124,212,336,1,10,2019,
15,43745,103,209,312,1,10,2019,
16,43745,138,298,436,1,10,2019,
17,43745,49,356,405,1,10,2019,
18,43745,19,143,162,1,10,2019,
19,43745,24,193,217,1,10,2019,
20,43745,77,205,282,1,10,2019,
21,43745,154,157,311,1,10,2019,
22,43745,173,155,328,1,10,2019,
23,43745,65,321,386,1,10,2019,
0,43746,13,231,244,2,10,2019,
1,43746,13,6,19,2,10,2019,
2,43746,16,0,16,2,10,2019,
3,43746,68,0,68,2,10,2019,
4,43746,92,0,92,2,10,2019,
5,43746,132,1,133,2,10,2019,
6,43746,195,89,284,2,10,2019,
7,43746,181,243,424,2,10,2019,
8,43746,154,274,428,2,10,2019,
9,43746,97,317,414,2,10,2019,
10,43746,118,149,267,2,10,2019,
11,43746,113,116,229,2,10,2019,
12,43746,140,280,420,2,10,2019,
13,43746,128,189,317,2,10,2019,
14,43746,95,318,413,2,10,2019,
15,43746,113,113,226,2,10,2019,
16,43746,93,125,218,2,10,2019,
17,43746,64,249,313,2,10,2019,
18,43746,42,212,254,2,10,2019,
19,43746,18,88,106,2,10,2019,
20,43746,101,172,273,2,10,2019,
21,43746,228,234,462,2,10,2019,
22,43746,206,179,385,2,10,2019,
23,43746,158,131,289,2,10,2019,
0,43747,33,165,198,3,10,2019,
1,43747,19,0,19,3,10,2019,
2,43747,14,0,14,3,10,2019,
3,43747,72,0,72,3,10,2019,
4,43747,93,0,93,3,10,2019,
5,43747,162,0,162,3,10,2019,
6,43747,286,0,286,3,10,2019,
7,43747,206,279,485,3,10,2019,
8,43747,181,252,433,3,10,2019,
9,43747,113,221,334,3,10,2019,
10,43747,133,105,238,3,10,2019,
11,43747,91,84,175,3,10,2019,
12,43747,132,291,423,3,10,2019,
13,43747,98,28,126,3,10,2019,
14,43747,74,241,315,3,10,2019,
15,43747,113,130,243,3,10,2019,
16,43747,106,94,200,3,10,2019,
17,43747,96,174,270,3,10,2019,
18,43747,22,195,217,3,10,2019,
19,43747,22,170,192,3,10,2019,
20,43747,96,152,248,3,10,2019,
21,43747,268,127,395,3,10,2019,
22,43747,328,92,420,3,10,2019,
23,43747,242,169,411,3,10,2019,
0,43748,84,100,184,4,10,2019,
1,43748,6,86,92,4,10,2019,
2,43748,43,0,43,4,10,2019,
3,43748,89,1,90,4,10,2019,
4,43748,137,0,137,4,10,2019,
5,43748,265,0,265,4,10,2019,
6,43748,408,52,460,4,10,2019,
7,43748,313,342,655,4,10,2019,
8,43748,232,213,445,4,10,2019,
9,43748,72,215,287,4,10,2019,
10,43748,215,25,240,4,10,2019,
11,43748,154,196,350,4,10,2019,
12,43748,118,298,416,4,10,2019,
13,43748,134,57,191,4,10,2019,
14,43748,140,180,320,4,10,2019,
15,43748,148,175,323,4,10,2019,
16,43748,157,174,331,4,10,2019,
17,43748,190,208,398,4,10,2019,
18,43748,111,143,254,4,10,2019,
19,43748,18,135,153,4,10,2019,
20,43748,132,158,290,4,10,2019,
21,43748,282,222,504,4,10,2019,
22,43748,318,166,484,4,10,2019,
23,43748,279,160,439,4,10,2019,
0,43749,243,115,358,5,10,2019,
1,43749,35,26,61,5,10,2019,
2,43749,32,0,32,5,10,2019,
3,43749,81,0,81,5,10,2019,
4,43749,99,0,99,5,10,2019,
5,43749,222,0,222,5,10,2019,
6,43749,313,105,418,5,10,2019,
7,43749,282,119,401,5,10,2019,
8,43749,196,290,486,5,10,2019,
9,43749,167,263,430,5,10,2019,
10,43749,224,130,354,5,10,2019,
11,43749,141,75,216,5,10,2019,
12,43749,127,253,380,5,10,2019,
13,43749,115,200,315,5,10,2019,
14,43749,169,110,279,5,10,2019,
15,43749,156,94,250,5,10,2019,
16,43749,194,250,444,5,10,2019,
17,43749,96,165,261,5,10,2019,
18,43749,65,237,302,5,10,2019,
19,43749,47,111,158,5,10,2019,
20,43749,106,136,242,5,10,2019,
21,43749,288,166,454,5,10,2019,
22,43749,297,161,458,5,10,2019,
23,43749,192,210,402,5,10,2019,
0,43750,77,120,197,6,10,2019,
1,43750,8,14,22,6,10,2019,
2,43750,23,0,23,6,10,2019,
3,43750,51,0,51,6,10,2019,
4,43750,96,0,96,6,10,2019,
5,43750,149,0,149,6,10,2019,
6,43750,302,17,319,6,10,2019,
7,43750,426,295,721,6,10,2019,
8,43750,314,419,733,6,10,2019,
9,43750,152,390,542,6,10,2019,
10,43750,145,92,237,6,10,2019,
11,43750,106,292,398,6,10,2019,
12,43750,161,170,331,6,10,2019,
13,43750,157,92,249,6,10,2019,
14,43750,103,275,378,6,10,2019,
15,43750,120,237,357,6,10,2019,
16,43750,157,271,428,6,10,2019,
17,43750,127,252,379,6,10,2019,
18,43750,27,160,187,6,10,2019,
19,43750,39,237,276,6,10,2019,
20,43750,126,185,311,6,10,2019,
21,43750,214,318,532,6,10,2019,
22,43750,183,134,317,6,10,2019,
23,43750,107,153,260,6,10,2019,
0,43751,42,154,196,7,10,2019,
1,43751,4,0,4,7,10,2019,
2,43751,27,0,27,7,10,2019,
3,43751,75,0,75,7,10,2019,
4,43751,110,1,111,7,10,2019,
5,43751,177,0,177,7,10,2019,
6,43751,247,98,345,7,10,2019,
7,43751,241,161,402,7,10,2019,
8,43751,154,594,748,7,10,2019,
9,43751,108,342,450,7,10,2019,
10,43751,161,133,294,7,10,2019,
11,43751,156,162,318,7,10,2019,
12,43751,113,233,346,7,10,2019,
13,43751,130,206,336,7,10,2019,
14,43751,131,264,395,7,10,2019,
15,43751,179,412,591,7,10,2019,
16,43751,131,216,347,7,10,2019,
17,43751,110,321,431,7,10,2019,
18,43751,52,315,367,7,10,2019,
19,43751,39,198,237,7,10,2019,
20,43751,99,254,353,7,10,2019,
21,43751,185,101,286,7,10,2019,
22,43751,225,295,520,7,10,2019,
23,43751,130,303,433,7,10,2019,
0,43752,59,227,286,1,10,2019,
1,43752,3,77,80,1,10,2019,
2,43752,22,0,22,1,10,2019,
3,43752,58,0,58,1,10,2019,
4,43752,81,0,81,1,10,2019,
5,43752,80,0,80,1,10,2019,
6,43752,172,5,177,1,10,2019,
7,43752,198,265,463,1,10,2019,
8,43752,135,348,483,1,10,2019,
9,43752,109,343,452,1,10,2019,
10,43752,124,123,247,1,10,2019,
11,43752,67,141,208,1,10,2019,
12,43752,64,224,288,1,10,2019,
13,43752,126,102,228,1,10,2019,
14,43752,197,299,496,1,10,2019,
15,43752,171,260,431,1,10,2019,
16,43752,133,314,447,1,10,2019,
17,43752,148,259,407,1,10,2019,
18,43752,23,229,252,1,10,2019,
19,43752,39,196,235,1,10,2019,
20,43752,64,294,358,1,10,2019,
21,43752,222,154,376,1,10,2019,
22,43752,138,328,466,1,10,2019,
23,43752,113,349,462,1,10,2019,
0,43753,37,166,203,2,10,2019,
1,43753,10,108,118,2,10,2019,
2,43753,33,0,33,2,10,2019,
3,43753,51,0,51,2,10,2019,
4,43753,100,0,100,2,10,2019,
5,43753,137,1,138,2,10,2019,
6,43753,187,53,240,2,10,2019,
7,43753,195,203,398,2,10,2019,
8,43753,166,271,437,2,10,2019,
9,43753,126,286,412,2,10,2019,
10,43753,124,143,267,2,10,2019,
11,43753,106,158,264,2,10,2019,
12,43753,102,304,406,2,10,2019,
13,43753,136,103,239,2,10,2019,
14,43753,94,247,341,2,10,2019,
15,43753,78,214,292,2,10,2019,
16,43753,144,137,281,2,10,2019,
17,43753,125,295,420,2,10,2019,
18,43753,12,64,76,2,10,2019,
19,43753,25,224,249,2,10,2019,
20,43753,94,226,320,2,10,2019,
21,43753,194,194,388,2,10,2019,
22,43753,196,182,378,2,10,2019,
23,43753,128,190,318,2,10,2019,
0,43754,83,99,182,3,10,2019,
1,43754,11,5,16,3,10,2019,
2,43754,26,0,26,3,10,2019,
3,43754,72,3,75,3,10,2019,
4,43754,101,0,101,3,10,2019,
5,43754,144,1,145,3,10,2019,
6,43754,232,2,234,3,10,2019,
7,43754,149,197,346,3,10,2019,
8,43754,186,333,519,3,10,2019,
9,43754,115,258,373,3,10,2019,
10,43754,142,89,231,3,10,2019,
11,43754,93,206,299,3,10,2019,
12,43754,76,370,446,3,10,2019,
13,43754,111,52,163,3,10,2019,
14,43754,131,193,324,3,10,2019,
15,43754,108,177,285,3,10,2019,
16,43754,157,224,381,3,10,2019,
17,43754,94,247,341,3,10,2019,
18,43754,18,152,170,3,10,2019,
19,43754,25,119,144,3,10,2019,
20,43754,91,123,214,3,10,2019,
21,43754,254,152,406,3,10,2019,
22,43754,252,213,465,3,10,2019,
23,43754,191,190,381,3,10,2019,
0,43755,115,98,213,4,10,2019,
1,43755,20,0,20,4,10,2019,
2,43755,42,0,42,4,10,2019,
3,43755,94,0,94,4,10,2019,
4,43755,77,0,77,4,10,2019,
5,43755,250,0,250,4,10,2019,
6,43755,465,19,484,4,10,2019,
7,43755,331,267,598,4,10,2019,
8,43755,199,263,462,4,10,2019,
9,43755,119,293,412,4,10,2019,
10,43755,192,91,283,4,10,2019,
11,43755,199,229,428,4,10,2019,
12,43755,110,231,341,4,10,2019,
13,43755,151,96,247,4,10,2019,
14,43755,183,198,381,4,10,2019,
15,43755,155,181,336,4,10,2019,
16,43755,155,144,299,4,10,2019,
17,43755,196,245,441,4,10,2019,
18,43755,65,147,212,4,10,2019,
19,43755,16,347,363,4,10,2019,
20,43755,146,137,283,4,10,2019,
21,43755,230,285,515,4,10,2019,
22,43755,444,106,550,4,10,2019,
23,43755,264,84,348,4,10,2019,
0,43756,108,153,261,5,10,2019,
1,43756,38,41,79,5,10,2019,
2,43756,46,18,64,5,10,2019,
3,43756,68,0,68,5,10,2019,
4,43756,137,0,137,5,10,2019,
5,43756,153,0,153,5,10,2019,
6,43756,358,90,448,5,10,2019,
7,43756,293,108,401,5,10,2019,
8,43756,179,250,429,5,10,2019,
9,43756,145,272,417,5,10,2019,
10,43756,135,77,212,5,10,2019,
11,43756,93,117,210,5,10,2019,
12,43756,159,116,275,5,10,2019,
13,43756,138,108,246,5,10,2019,
14,43756,167,176,343,5,10,2019,
15,43756,165,181,346,5,10,2019,
16,43756,115,214,329,5,10,2019,
17,43756,111,143,254,5,10,2019,
18,43756,50,202,252,5,10,2019,
19,43756,31,164,195,5,10,2019,
20,43756,134,204,338,5,10,2019,
21,43756,265,122,387,5,10,2019,
22,43756,361,204,565,5,10,2019,
23,43756,215,134,349,5,10,2019,
0,43757,154,206,360,6,10,2019,
1,43757,30,4,34,6,10,2019,
2,43757,35,0,35,6,10,2019,
3,43757,76,7,83,6,10,2019,
4,43757,81,0,81,6,10,2019,
5,43757,162,1,163,6,10,2019,
6,43757,323,1,324,6,10,2019,
7,43757,397,208,605,6,10,2019,
8,43757,288,516,804,6,10,2019,
9,43757,145,276,421,6,10,2019,
10,43757,148,142,290,6,10,2019,
11,43757,74,291,365,6,10,2019,
12,43757,136,114,250,6,10,2019,
13,43757,148,100,248,6,10,2019,
14,43757,128,238,366,6,10,2019,
15,43757,178,225,403,6,10,2019,
16,43757,107,256,363,6,10,2019,
17,43757,102,214,316,6,10,2019,
18,43757,19,138,157,6,10,2019,
19,43757,21,206,227,6,10,2019,
20,43757,120,257,377,6,10,2019,
21,43757,196,267,463,6,10,2019,
22,43757,231,101,332,6,10,2019,
23,43757,100,189,289,6,10,2019,
0,43758,83,124,207,7,10,2019,
1,43758,20,16,36,7,10,2019,
2,43758,38,0,38,7,10,2019,
3,43758,89,0,89,7,10,2019,
4,43758,140,0,140,7,10,2019,
5,43758,162,0,162,7,10,2019,
6,43758,318,67,385,7,10,2019,
7,43758,181,330,511,7,10,2019,
8,43758,165,420,585,7,10,2019,
9,43758,163,189,352,7,10,2019,
10,43758,192,138,330,7,10,2019,
11,43758,134,184,318,7,10,2019,
12,43758,185,132,317,7,10,2019,
13,43758,173,225,398,7,10,2019,
14,43758,137,354,491,7,10,2019,
15,43758,232,250,482,7,10,2019,
16,43758,129,191,320,7,10,2019,
17,43758,195,244,439,7,10,2019,
18,43758,59,286,345,7,10,2019,
19,43758,42,227,269,7,10,2019,
20,43758,106,148,254,7,10,2019,
21,43758,207,282,489,7,10,2019,
22,43758,219,246,465,7,10,2019,
23,43758,161,128,289,7,10,2019,
0,43759,78,317,395,1,10,2019,
1,43759,27,62,89,1,10,2019,
2,43759,20,10,30,1,10,2019,
3,43759,45,4,49,1,10,2019,
4,43759,53,0,53,1,10,2019,
5,43759,142,0,142,1,10,2019,
6,43759,206,25,231,1,10,2019,
7,43759,152,351,503,1,10,2019,
8,43759,159,205,364,1,10,2019,
9,43759,103,285,388,1,10,2019,
10,43759,152,125,277,1,10,2019,
11,43759,116,218,334,1,10,2019,
12,43759,98,154,252,1,10,2019,
13,43759,110,96,206,1,10,2019,
14,43759,185,213,398,1,10,2019,
15,43759,219,303,522,1,10,2019,
16,43759,112,304,416,1,10,2019,
17,43759,99,300,399,1,10,2019,
18,43759,39,133,172,1,10,2019,
19,43759,24,225,249,1,10,2019,
20,43759,54,176,230,1,10,2019,
21,43759,168,144,312,1,10,2019,
22,43759,165,192,357,1,10,2019,
23,43759,94,427,521,1,10,2019,
0,43760,47,168,215,2,10,2019,
1,43760,36,0,36,2,10,2019,
2,43760,32,0,32,2,10,2019,
3,43760,48,1,49,2,10,2019,
4,43760,63,0,63,2,10,2019,
5,43760,105,0,105,2,10,2019,
6,43760,226,75,301,2,10,2019,
7,43760,251,177,428,2,10,2019,
8,43760,177,210,387,2,10,2019,
9,43760,133,280,413,2,10,2019,
10,43760,166,113,279,2,10,2019,
11,43760,137,203,340,2,10,2019,
12,43760,137,228,365,2,10,2019,
13,43760,171,141,312,2,10,2019,
14,43760,96,304,400,2,10,2019,
15,43760,158,168,326,2,10,2019,
16,43760,121,199,320,2,10,2019,
17,43760,58,237,295,2,10,2019,
18,43760,31,96,127,2,10,2019,
19,43760,34,202,236,2,10,2019,
20,43760,74,45,119,2,10,2019,
21,43760,181,358,539,2,10,2019,
22,43760,303,221,524,2,10,2019,
23,43760,114,163,277,2,10,2019,
0,43761,52,105,157,3,10,2019,
1,43761,22,4,26,3,10,2019,
2,43761,25,0,25,3,10,2019,
3,43761,94,0,94,3,10,2019,
4,43761,95,0,95,3,10,2019,
5,43761,148,1,149,3,10,2019,
6,43761,263,12,275,3,10,2019,
7,43761,197,200,397,3,10,2019,
8,43761,158,220,378,3,10,2019,
9,43761,158,94,252,3,10,2019,
10,43761,115,87,202,3,10,2019,
11,43761,79,302,381,3,10,2019,
12,43761,133,125,258,3,10,2019,
13,43761,97,25,122,3,10,2019,
14,43761,103,230,333,3,10,2019,
15,43761,152,148,300,3,10,2019,
16,43761,137,122,259,3,10,2019,
17,43761,96,164,260,3,10,2019,
18,43761,34,233,267,3,10,2019,
19,43761,19,188,207,3,10,2019,
20,43761,86,207,293,3,10,2019,
21,43761,275,44,319,3,10,2019,
22,43761,290,164,454,3,10,2019,
23,43761,244,174,418,3,10,2019,
0,43762,122,90,212,4,10,2019,
1,43762,37,0,37,4,10,2019,
2,43762,22,0,22,4,10,2019,
3,43762,63,0,63,4,10,2019,
4,43762,140,0,140,4,10,2019,
5,43762,215,0,215,4,10,2019,
6,43762,434,104,538,4,10,2019,
7,43762,372,253,625,4,10,2019,
8,43762,243,218,461,4,10,2019,
9,43762,191,278,469,4,10,2019,
10,43762,215,35,250,4,10,2019,
11,43762,152,147,299,4,10,2019,
12,43762,161,248,409,4,10,2019,
13,43762,177,108,285,4,10,2019,
14,43762,151,187,338,4,10,2019,
15,43762,183,103,286,4,10,2019,
16,43762,116,147,263,4,10,2019,
17,43762,133,327,460,4,10,2019,
18,43762,48,49,97,4,10,2019,
19,43762,20,246,266,4,10,2019,
20,43762,109,144,253,4,10,2019,
21,43762,265,193,458,4,10,2019,
22,43762,387,183,570,4,10,2019,
23,43762,320,98,418,4,10,2019,
0,43763,193,131,324,5,10,2019,
1,43763,50,84,134,5,10,2019,
2,43763,46,14,60,5,10,2019,
3,43763,91,12,103,5,10,2019,
4,43763,78,1,79,5,10,2019,
5,43763,261,0,261,5,10,2019,
6,43763,394,74,468,5,10,2019,
7,43763,286,195,481,5,10,2019,
8,43763,236,235,471,5,10,2019,
9,43763,203,342,545,5,10,2019,
10,43763,173,121,294,5,10,2019,
11,43763,133,145,278,5,10,2019,
12,43763,126,138,264,5,10,2019,
13,43763,121,54,175,5,10,2019,
14,43763,179,152,331,5,10,2019,
15,43763,183,182,365,5,10,2019,
16,43763,105,144,249,5,10,2019,
17,43763,94,335,429,5,10,2019,
18,43763,84,163,247,5,10,2019,
19,43763,43,112,155,5,10,2019,
20,43763,116,154,270,5,10,2019,
21,43763,219,218,437,5,10,2019,
22,43763,366,124,490,5,10,2019,
23,43763,205,208,413,5,10,2019,
0,43764,108,127,235,6,10,2019,
1,43764,24,14,38,6,10,2019,
2,43764,53,16,69,6,10,2019,
3,43764,64,0,64,6,10,2019,
4,43764,97,1,98,6,10,2019,
5,43764,194,0,194,6,10,2019,
6,43764,322,4,326,6,10,2019,
7,43764,283,219,502,6,10,2019,
8,43764,269,546,815,6,10,2019,
9,43764,187,127,314,6,10,2019,
10,43764,198,237,435,6,10,2019,
11,43764,107,300,407,6,10,2019,
12,43764,129,120,249,6,10,2019,
13,43764,184,98,282,6,10,2019,
14,43764,155,340,495,6,10,2019,
15,43764,181,272,453,6,10,2019,
16,43764,137,182,319,6,10,2019,
17,43764,74,253,327,6,10,2019,
18,43764,65,217,282,6,10,2019,
19,43764,79,168,247,6,10,2019,
20,43764,93,299,392,6,10,2019,
21,43764,177,221,398,6,10,2019,
22,43764,157,246,403,6,10,2019,
23,43764,183,182,365,6,10,2019,
0,43765,137,45,182,7,10,2019,
1,43765,24,48,72,7,10,2019,
2,43765,28,0,28,7,10,2019,
3,43765,36,0,36,7,10,2019,
4,43765,97,0,97,7,10,2019,
5,43765,85,0,85,7,10,2019,
6,43765,203,0,203,7,10,2019,
7,43765,275,71,346,7,10,2019,
8,43765,247,395,642,7,10,2019,
9,43765,146,528,674,7,10,2019,
10,43765,187,163,350,7,10,2019,
11,43765,176,87,263,7,10,2019,
12,43765,106,394,500,7,10,2019,
13,43765,110,183,293,7,10,2019,
14,43765,92,297,389,7,10,2019,
15,43765,145,122,267,7,10,2019,
16,43765,149,293,442,7,10,2019,
17,43765,111,178,289,7,10,2019,
18,43765,140,316,456,7,10,2019,
19,43765,45,203,248,7,10,2019,
20,43765,94,362,456,7,10,2019,
21,43765,199,143,342,7,10,2019,
22,43765,153,142,295,7,10,2019,
23,43765,155,201,356,7,10,2019,
0,43766,145,258,403,1,10,2019,
1,43766,89,121,210,1,10,2019,
2,43766,57,96,153,1,10,2019,
3,43766,16,2,18,1,10,2019,
4,43766,56,0,56,1,10,2019,
5,43766,70,0,70,1,10,2019,
6,43766,149,0,149,1,10,2019,
7,43766,244,55,299,1,10,2019,
8,43766,204,296,500,1,10,2019,
9,43766,132,364,496,1,10,2019,
10,43766,167,215,382,1,10,2019,
11,43766,140,198,338,1,10,2019,
12,43766,105,246,351,1,10,2019,
13,43766,84,281,365,1,10,2019,
14,43766,97,139,236,1,10,2019,
15,43766,127,286,413,1,10,2019,
16,43766,202,257,459,1,10,2019,
17,43766,143,234,377,1,10,2019,
18,43766,128,127,255,1,10,2019,
19,43766,58,185,243,1,10,2019,
20,43766,66,345,411,1,10,2019,
21,43766,172,173,345,1,10,2019,
22,43766,205,175,380,1,10,2019,
23,43766,157,263,420,1,10,2019,
0,43767,90,228,318,2,10,2019,
1,43767,35,156,191,2,10,2019,
2,43767,48,24,72,2,10,2019,
3,43767,33,0,33,2,10,2019,
4,43767,71,1,72,2,10,2019,
5,43767,101,0,101,2,10,2019,
6,43767,165,0,165,2,10,2019,
7,43767,255,57,312,2,10,2019,
8,43767,182,313,495,2,10,2019,
9,43767,202,282,484,2,10,2019,
10,43767,169,225,394,2,10,2019,
11,43767,164,167,331,2,10,2019,
12,43767,148,335,483,2,10,2019,
13,43767,126,207,333,2,10,2019,
14,43767,168,161,329,2,10,2019,
15,43767,87,181,268,2,10,2019,
16,43767,107,320,427,2,10,2019,
17,43767,99,95,194,2,10,2019,
18,43767,69,225,294,2,10,2019,
19,43767,50,229,279,2,10,2019,
20,43767,84,258,342,2,10,2019,
21,43767,213,88,301,2,10,2019,
22,43767,228,71,299,2,10,2019,
23,43767,168,269,437,2,10,2019,
0,43768,183,160,343,3,10,2019,
1,43768,101,101,202,3,10,2019,
2,43768,61,0,61,3,10,2019,
3,43768,57,0,57,3,10,2019,
4,43768,82,0,82,3,10,2019,
5,43768,68,0,68,3,10,2019,
6,43768,212,0,212,3,10,2019,
7,43768,318,0,318,3,10,2019,
8,43768,269,244,513,3,10,2019,
9,43768,186,197,383,3,10,2019,
10,43768,253,388,641,3,10,2019,
11,43768,237,185,422,3,10,2019,
12,43768,137,258,395,3,10,2019,
13,43768,107,263,370,3,10,2019,
14,43768,141,143,284,3,10,2019,
15,43768,147,92,239,3,10,2019,
16,43768,121,245,366,3,10,2019,
17,43768,150,115,265,3,10,2019,
18,43768,126,168,294,3,10,2019,
19,43768,60,238,298,3,10,2019,
20,43768,77,236,313,3,10,2019,
21,43768,252,205,457,3,10,2019,
22,43768,240,73,313,3,10,2019,
23,43768,317,245,562,3,10,2019,
0,43769,199,144,343,4,10,2019,
1,43769,64,81,145,4,10,2019,
2,43769,50,42,92,4,10,2019,
3,43769,75,0,75,4,10,2019,
4,43769,115,0,115,4,10,2019,
5,43769,231,0,231,4,10,2019,
6,43769,308,0,308,4,10,2019,
7,43769,320,55,375,4,10,2019,
8,43769,349,352,701,4,10,2019,
9,43769,151,311,462,4,10,2019,
10,43769,217,249,466,4,10,2019,
11,43769,235,114,349,4,10,2019,
12,43769,150,302,452,4,10,2019,
13,43769,129,122,251,4,10,2019,
14,43769,102,166,268,4,10,2019,
15,43769,93,232,325,4,10,2019,
16,43769,153,139,292,4,10,2019,
17,43769,162,60,222,4,10,2019,
18,43769,165,201,366,4,10,2019,
19,43769,124,154,278,4,10,2019,
20,43769,85,144,229,4,10,2019,
21,43769,171,152,323,4,10,2019,
22,43769,345,143,488,4,10,2019,
23,43769,254,118,372,4,10,2019,
0,43770,178,247,425,5,11,2019,
1,43770,50,29,79,5,11,2019,
2,43770,71,0,71,5,11,2019,
3,43770,155,0,155,5,11,2019,
4,43770,115,0,115,5,11,2019,
5,43770,155,0,155,5,11,2019,
6,43770,356,64,420,5,11,2019,
7,43770,353,43,396,5,11,2019,
8,43770,338,260,598,5,11,2019,
9,43770,310,169,479,5,11,2019,
10,43770,142,293,435,5,11,2019,
11,43770,129,134,263,5,11,2019,
12,43770,123,250,373,5,11,2019,
13,43770,168,0,168,5,11,2019,
14,43770,177,56,233,5,11,2019,
15,43770,177,278,455,5,11,2019,
16,43770,143,193,336,5,11,2019,
17,43770,138,76,214,5,11,2019,
18,43770,132,93,225,5,11,2019,
19,43770,99,194,293,5,11,2019,
20,43770,83,165,248,5,11,2019,
21,43770,218,146,364,5,11,2019,
22,43770,270,138,408,5,11,2019,
23,43770,264,110,374,5,11,2019,
0,43771,226,135,361,6,11,2019,
1,43771,92,50,142,6,11,2019,
2,43771,75,13,88,6,11,2019,
3,43771,107,0,107,6,11,2019,
4,43771,63,1,64,6,11,2019,
5,43771,87,1,88,6,11,2019,
6,43771,233,0,233,6,11,2019,
7,43771,317,113,430,6,11,2019,
8,43771,390,398,788,6,11,2019,
9,43771,293,246,539,6,11,2019,
10,43771,174,240,414,6,11,2019,
11,43771,153,136,289,6,11,2019,
12,43771,119,262,381,6,11,2019,
13,43771,159,65,224,6,11,2019,
14,43771,172,162,334,6,11,2019,
15,43771,167,252,419,6,11,2019,
16,43771,135,314,449,6,11,2019,
17,43771,127,121,248,6,11,2019,
18,43771,155,58,213,6,11,2019,
19,43771,61,311,372,6,11,2019,
20,43771,83,175,258,6,11,2019,
21,43771,164,230,394,6,11,2019,
22,43771,177,145,322,6,11,2019,
23,43771,151,124,275,6,11,2019,
0,43772,86,126,212,7,11,2019,
1,43772,72,12,84,7,11,2019,
2,43772,45,0,45,7,11,2019,
3,43772,72,0,72,7,11,2019,
4,43772,85,0,85,7,11,2019,
5,43772,169,0,169,7,11,2019,
6,43772,292,56,348,7,11,2019,
7,43772,282,332,614,7,11,2019,
8,43772,164,631,795,7,11,2019,
9,43772,124,301,425,7,11,2019,
10,43772,176,147,323,7,11,2019,
11,43772,183,385,568,7,11,2019,
12,43772,197,192,389,7,11,2019,
13,43772,179,301,480,7,11,2019,
14,43772,170,187,357,7,11,2019,
15,43772,128,342,470,7,11,2019,
16,43772,160,199,359,7,11,2019,
17,43772,126,254,380,7,11,2019,
18,43772,87,214,301,7,11,2019,
19,43772,62,404,466,7,11,2019,
20,43772,161,74,235,7,11,2019,
21,43772,186,201,387,7,11,2019,
22,43772,168,367,535,7,11,2019,
23,43772,148,465,613,7,11,2019,
0,43773,69,207,276,1,11,2019,
1,43773,37,0,37,1,11,2019,
2,43773,12,0,12,1,11,2019,
3,43773,69,0,69,1,11,2019,
4,43773,87,0,87,1,11,2019,
5,43773,146,0,146,1,11,2019,
6,43773,246,59,305,1,11,2019,
7,43773,214,399,613,1,11,2019,
8,43773,126,356,482,1,11,2019,
9,43773,121,358,479,1,11,2019,
10,43773,149,186,335,1,11,2019,
11,43773,143,221,364,1,11,2019,
12,43773,104,207,311,1,11,2019,
13,43773,121,272,393,1,11,2019,
14,43773,160,102,262,1,11,2019,
15,43773,180,442,622,1,11,2019,
16,43773,159,171,330,1,11,2019,
17,43773,140,352,492,1,11,2019,
18,43773,63,240,303,1,11,2019,
19,43773,43,495,538,1,11,2019,
20,43773,108,93,201,1,11,2019,
21,43773,207,146,353,1,11,2019,
22,43773,197,309,506,1,11,2019,
23,43773,61,430,491,1,11,2019,
0,43774,43,251,294,2,11,2019,
1,43774,41,14,55,2,11,2019,
2,43774,18,49,67,2,11,2019,
3,43774,48,1,49,2,11,2019,
4,43774,120,0,120,2,11,2019,
5,43774,118,1,119,2,11,2019,
6,43774,183,47,230,2,11,2019,
7,43774,236,350,586,2,11,2019,
8,43774,172,335,507,2,11,2019,
9,43774,107,179,286,2,11,2019,
10,43774,103,312,415,2,11,2019,
11,43774,100,156,256,2,11,2019,
12,43774,115,166,281,2,11,2019,
13,43774,158,227,385,2,11,2019,
14,43774,104,228,332,2,11,2019,
15,43774,123,296,419,2,11,2019,
16,43774,124,193,317,2,11,2019,
17,43774,103,223,326,2,11,2019,
18,43774,23,171,194,2,11,2019,
19,43774,30,190,220,2,11,2019,
20,43774,72,54,126,2,11,2019,
21,43774,237,340,577,2,11,2019,
22,43774,236,182,418,2,11,2019,
23,43774,152,280,432,2,11,2019,
0,43775,71,230,301,3,11,2019,
1,43775,20,23,43,3,11,2019,
2,43775,33,0,33,3,11,2019,
3,43775,54,0,54,3,11,2019,
4,43775,86,0,86,3,11,2019,
5,43775,91,0,91,3,11,2019,
6,43775,253,0,253,3,11,2019,
7,43775,170,256,426,3,11,2019,
8,43775,187,270,457,3,11,2019,
9,43775,139,239,378,3,11,2019,
10,43775,96,242,338,3,11,2019,
11,43775,155,175,330,3,11,2019,
12,43775,142,173,315,3,11,2019,
13,43775,137,107,244,3,11,2019,
14,43775,86,199,285,3,11,2019,
15,43775,121,216,337,3,11,2019,
16,43775,106,138,244,3,11,2019,
17,43775,78,90,168,3,11,2019,
18,43775,64,206,270,3,11,2019,
19,43775,40,200,240,3,11,2019,
20,43775,81,85,166,3,11,2019,
21,43775,167,164,331,3,11,2019,
22,43775,227,189,416,3,11,2019,
23,43775,149,202,351,3,11,2019,
0,43776,88,175,263,4,11,2019,
1,43776,25,0,25,4,11,2019,
2,43776,60,1,61,4,11,2019,
3,43776,149,0,149,4,11,2019,
4,43776,247,0,247,4,11,2019,
5,43776,334,2,336,4,11,2019,
6,43776,380,14,394,4,11,2019,
7,43776,332,5,337,4,11,2019,
8,43776,271,357,628,4,11,2019,
9,43776,239,265,504,4,11,2019,
10,43776,166,88,254,4,11,2019,
11,43776,279,192,471,4,11,2019,
12,43776,152,243,395,4,11,2019,
13,43776,205,146,351,4,11,2019,
14,43776,153,106,259,4,11,2019,
15,43776,106,321,427,4,11,2019,
16,43776,185,68,253,4,11,2019,
17,43776,176,166,342,4,11,2019,
18,43776,97,221,318,4,11,2019,
19,43776,50,366,416,4,11,2019,
20,43776,165,145,310,4,11,2019,
21,43776,317,164,481,4,11,2019,
22,43776,334,150,484,4,11,2019,
23,43776,299,0,299,4,11,2019,
0,43777,162,3,165,5,11,2019,
1,43777,75,3,78,5,11,2019,
2,43777,55,1,56,5,11,2019,
3,43777,127,32,159,5,11,2019,
4,43777,165,65,230,5,11,2019,
5,43777,265,26,291,5,11,2019,
6,43777,380,46,426,5,11,2019,
7,43777,318,164,482,5,11,2019,
8,43777,334,268,602,5,11,2019,
9,43777,187,161,348,5,11,2019,
10,43777,121,215,336,5,11,2019,
11,43777,227,182,409,5,11,2019,
12,43777,104,89,193,5,11,2019,
13,43777,164,226,390,5,11,2019,
14,43777,157,131,288,5,11,2019,
15,43777,175,223,398,5,11,2019,
16,43777,117,164,281,5,11,2019,
17,43777,155,76,231,5,11,2019,
18,43777,76,129,205,5,11,2019,
19,43777,81,284,365,5,11,2019,
20,43777,150,281,431,5,11,2019,
21,43777,279,226,505,5,11,2019,
22,43777,327,173,500,5,11,2019,
23,43777,207,170,377,5,11,2019,
0,43778,167,174,341,6,11,2019,
1,43778,67,123,190,6,11,2019,
2,43778,93,0,93,6,11,2019,
3,43778,130,1,131,6,11,2019,
4,43778,142,0,142,6,11,2019,
5,43778,162,0,162,6,11,2019,
6,43778,374,0,374,6,11,2019,
7,43778,316,279,595,6,11,2019,
8,43778,337,338,675,6,11,2019,
9,43778,218,365,583,6,11,2019,
10,43778,132,269,401,6,11,2019,
11,43778,122,284,406,6,11,2019,
12,43778,149,223,372,6,11,2019,
13,43778,164,172,336,6,11,2019,
14,43778,118,281,399,6,11,2019,
15,43778,152,190,342,6,11,2019,
16,43778,158,229,387,6,11,2019,
17,43778,88,425,513,6,11,2019,
18,43778,53,200,253,6,11,2019,
19,43778,48,368,416,6,11,2019,
20,43778,88,129,217,6,11,2019,
21,43778,264,71,335,6,11,2019,
22,43778,171,345,516,6,11,2019,
23,43778,157,159,316,6,11,2019,
0,43779,91,106,197,7,11,2019,
1,43779,21,0,21,7,11,2019,
2,43779,44,0,44,7,11,2019,
3,43779,81,0,81,7,11,2019,
4,43779,98,0,98,7,11,2019,
5,43779,192,0,192,7,11,2019,
6,43779,228,1,229,7,11,2019,
7,43779,230,0,230,7,11,2019,
8,43779,127,64,191,7,11,2019,
9,43779,119,387,506,7,11,2019,
10,43779,151,535,686,7,11,2019,
11,43779,185,364,549,7,11,2019,
12,43779,131,373,504,7,11,2019,
13,43779,138,190,328,7,11,2019,
14,43779,134,117,251,7,11,2019,
15,43779,143,417,560,7,11,2019,
16,43779,147,19,166,7,11,2019,
17,43779,119,204,323,7,11,2019,
18,43779,85,335,420,7,11,2019,
19,43779,72,424,496,7,11,2019,
20,43779,131,58,189,7,11,2019,
21,43779,197,122,319,7,11,2019,
22,43779,201,319,520,7,11,2019,
23,43779,102,441,543,7,11,2019,
0,43780,86,99,185,1,11,2019,
1,43780,22,214,236,1,11,2019,
2,43780,13,61,74,1,11,2019,
3,43780,59,0,59,1,11,2019,
4,43780,77,0,77,1,11,2019,
5,43780,134,0,134,1,11,2019,
6,43780,216,47,263,1,11,2019,
7,43780,187,385,572,1,11,2019,
8,43780,147,424,571,1,11,2019,
9,43780,138,316,454,1,11,2019,
10,43780,111,218,329,1,11,2019,
11,43780,115,188,303,1,11,2019,
12,43780,103,221,324,1,11,2019,
13,43780,94,265,359,1,11,2019,
14,43780,131,217,348,1,11,2019,
15,43780,175,357,532,1,11,2019,
16,43780,143,350,493,1,11,2019,
17,43780,155,149,304,1,11,2019,
18,43780,47,440,487,1,11,2019,
19,43780,17,292,309,1,11,2019,
20,43780,115,261,376,1,11,2019,
21,43780,149,79,228,1,11,2019,
22,43780,132,319,451,1,11,2019,
23,43780,73,632,705,1,11,2019,
0,43781,54,453,507,2,11,2019,
1,43781,57,14,71,2,11,2019,
2,43781,25,0,25,2,11,2019,
3,43781,105,1,106,2,11,2019,
4,43781,70,0,70,2,11,2019,
5,43781,162,0,162,2,11,2019,
6,43781,275,0,275,2,11,2019,
7,43781,192,0,192,2,11,2019,
8,43781,174,1,175,2,11,2019,
9,43781,71,219,290,2,11,2019,
10,43781,83,384,467,2,11,2019,
11,43781,94,416,510,2,11,2019,
12,43781,108,145,253,2,11,2019,
13,43781,113,206,319,2,11,2019,
14,43781,86,165,251,2,11,2019,
15,43781,112,230,342,2,11,2019,
16,43781,109,97,206,2,11,2019,
17,43781,64,288,352,2,11,2019,
18,43781,35,173,208,2,11,2019,
19,43781,30,397,427,2,11,2019,
20,43781,81,76,157,2,11,2019,
21,43781,153,0,153,2,11,2019,
22,43781,105,0,105,2,11,2019,
23,43781,59,0,59,2,11,2019,
0,43782,53,0,53,3,11,2019,
1,43782,29,0,29,3,11,2019,
2,43782,35,0,35,3,11,2019,
3,43782,0,0,0,3,11,2019,
4,43782,0,0,0,3,11,2019,
5,43782,120,0,120,3,11,2019,
6,43782,202,0,202,3,11,2019,
7,43782,236,0,236,3,11,2019,
8,43782,203,96,299,3,11,2019,
9,43782,147,562,709,3,11,2019,
10,43782,136,442,578,3,11,2019,
11,43782,174,430,604,3,11,2019,
12,43782,95,291,386,3,11,2019,
13,43782,74,101,175,3,11,2019,
14,43782,107,141,248,3,11,2019,
15,43782,65,114,179,3,11,2019,
16,43782,87,226,313,3,11,2019,
17,43782,94,185,279,3,11,2019,
18,43782,38,207,245,3,11,2019,
19,43782,30,420,450,3,11,2019,
20,43782,99,212,311,3,11,2019,
21,43782,219,224,443,3,11,2019,
22,43782,175,132,307,3,11,2019,
23,43782,117,303,420,3,11,2019,
0,43783,82,164,246,4,11,2019,
1,43783,27,80,107,4,11,2019,
2,43783,46,49,95,4,11,2019,
3,43783,88,39,127,4,11,2019,
4,43783,165,0,165,4,11,2019,
5,43783,241,0,241,4,11,2019,
6,43783,242,0,242,4,11,2019,
7,43783,245,56,301,4,11,2019,
8,43783,214,32,246,4,11,2019,
9,43783,137,390,527,4,11,2019,
10,43783,149,217,366,4,11,2019,
11,43783,147,524,671,4,11,2019,
12,43783,97,563,660,4,11,2019,
13,43783,158,263,421,4,11,2019,
14,43783,104,110,214,4,11,2019,
15,43783,74,197,271,4,11,2019,
16,43783,118,166,284,4,11,2019,
17,43783,127,198,325,4,11,2019,
18,43783,65,401,466,4,11,2019,
19,43783,17,612,629,4,11,2019,
20,43783,105,220,325,4,11,2019,
21,43783,205,163,368,4,11,2019,
22,43783,250,216,466,4,11,2019,
23,43783,153,413,566,4,11,2019,
0,43784,73,549,622,5,11,2019,
1,43784,52,46,98,5,11,2019,
2,43784,37,0,37,5,11,2019,
3,43784,139,38,177,5,11,2019,
4,43784,151,5,156,5,11,2019,
5,43784,168,0,168,5,11,2019,
6,43784,280,121,401,5,11,2019,
7,43784,297,222,519,5,11,2019,
8,43784,186,516,702,5,11,2019,
9,43784,153,374,527,5,11,2019,
10,43784,144,306,450,5,11,2019,
11,43784,85,225,310,5,11,2019,
12,43784,81,319,400,5,11,2019,
13,43784,123,133,256,5,11,2019,
14,43784,107,181,288,5,11,2019,
15,43784,78,291,369,5,11,2019,
16,43784,86,280,366,5,11,2019,
17,43784,74,192,266,5,11,2019,
18,43784,65,267,332,5,11,2019,
19,43784,32,377,409,5,11,2019,
20,43784,99,170,269,5,11,2019,
21,43784,164,368,532,5,11,2019,
22,43784,262,208,470,5,11,2019,
23,43784,185,224,409,5,11,2019,
0,43785,92,313,405,6,11,2019,
1,43785,45,18,63,6,11,2019,
2,43785,45,0,45,6,11,2019,
3,43785,113,1,114,6,11,2019,
4,43785,126,0,126,6,11,2019,
5,43785,140,3,143,6,11,2019,
6,43785,301,0,301,6,11,2019,
7,43785,311,383,694,6,11,2019,
8,43785,232,427,659,6,11,2019,
9,43785,156,276,432,6,11,2019,
10,43785,118,238,356,6,11,2019,
11,43785,88,364,452,6,11,2019,
12,43785,106,115,221,6,11,2019,
13,43785,106,262,368,6,11,2019,
14,43785,94,296,390,6,11,2019,
15,43785,145,207,352,6,11,2019,
16,43785,114,307,421,6,11,2019,
17,43785,70,167,237,6,11,2019,
18,43785,55,185,240,6,11,2019,
19,43785,31,397,428,6,11,2019,
20,43785,105,141,246,6,11,2019,
21,43785,191,280,471,6,11,2019,
22,43785,197,258,455,6,11,2019,
23,43785,136,231,367,6,11,2019,
0,43786,115,77,192,7,11,2019,
1,43786,33,0,33,7,11,2019,
2,43786,69,0,69,7,11,2019,
3,43786,95,0,95,7,11,2019,
4,43786,84,0,84,7,11,2019,
5,43786,202,1,203,7,11,2019,
6,43786,265,99,364,7,11,2019,
7,43786,278,338,616,7,11,2019,
8,43786,109,373,482,7,11,2019,
9,43786,139,321,460,7,11,2019,
10,43786,206,89,295,7,11,2019,
11,43786,212,280,492,7,11,2019,
12,43786,174,371,545,7,11,2019,
13,43786,144,224,368,7,11,2019,
14,43786,146,163,309,7,11,2019,
15,43786,192,214,406,7,11,2019,
16,43786,159,246,405,7,11,2019,
17,43786,123,221,344,7,11,2019,
18,43786,41,320,361,7,11,2019,
19,43786,61,294,355,7,11,2019,
20,43786,180,328,508,7,11,2019,
21,43786,195,46,241,7,11,2019,
22,43786,241,246,487,7,11,2019,
23,43786,145,553,698,7,11,2019,
0,43787,103,73,176,1,11,2019,
1,43787,37,74,111,1,11,2019,
2,43787,29,8,37,1,11,2019,
3,43787,79,9,88,1,11,2019,
4,43787,133,0,133,1,11,2019,
5,43787,196,0,196,1,11,2019,
6,43787,412,46,458,1,11,2019,
7,43787,350,361,711,1,11,2019,
8,43787,341,324,665,1,11,2019,
9,43787,206,154,360,1,11,2019,
10,43787,159,194,353,1,11,2019,
11,43787,165,95,260,1,11,2019,
12,43787,202,229,431,1,11,2019,
13,43787,245,135,380,1,11,2019,
14,43787,275,59,334,1,11,2019,
15,43787,416,204,620,1,11,2019,
16,43787,345,125,470,1,11,2019,
17,43787,221,146,367,1,11,2019,
18,43787,155,134,289,1,11,2019,
19,43787,84,244,328,1,11,2019,
20,43787,138,51,189,1,11,2019,
21,43787,268,107,375,1,11,2019,
22,43787,233,120,353,1,11,2019,
23,43787,131,209,340,1,11,2019,
0,43788,91,103,194,2,11,2019,
1,43788,53,52,105,2,11,2019,
2,43788,62,0,62,2,11,2019,
3,43788,96,1,97,2,11,2019,
4,43788,121,0,121,2,11,2019,
5,43788,202,0,202,2,11,2019,
6,43788,311,38,349,2,11,2019,
7,43788,306,161,467,2,11,2019,
8,43788,234,228,462,2,11,2019,
9,43788,243,229,472,2,11,2019,
10,43788,160,100,260,2,11,2019,
11,43788,125,191,316,2,11,2019,
12,43788,179,67,246,2,11,2019,
13,43788,185,302,487,2,11,2019,
14,43788,192,237,429,2,11,2019,
15,43788,220,194,414,2,11,2019,
16,43788,192,116,308,2,11,2019,
17,43788,208,186,394,2,11,2019,
18,43788,78,91,169,2,11,2019,
19,43788,44,275,319,2,11,2019,
20,43788,140,139,279,2,11,2019,
21,43788,332,226,558,2,11,2019,
22,43788,283,136,419,2,11,2019,
23,43788,209,275,484,2,11,2019,
0,43789,59,155,214,3,11,2019,
1,43789,36,33,69,3,11,2019,
2,43789,37,26,63,3,11,2019,
3,43789,66,0,66,3,11,2019,
4,43789,132,1,133,3,11,2019,
5,43789,151,0,151,3,11,2019,
6,43789,358,0,358,3,11,2019,
7,43789,263,232,495,3,11,2019,
8,43789,213,170,383,3,11,2019,
9,43789,207,249,456,3,11,2019,
10,43789,170,235,405,3,11,2019,
11,43789,166,183,349,3,11,2019,
12,43789,135,91,226,3,11,2019,
13,43789,167,249,416,3,11,2019,
14,43789,153,53,206,3,11,2019,
15,43789,169,195,364,3,11,2019,
16,43789,156,167,323,3,11,2019,
17,43789,130,231,361,3,11,2019,
18,43789,49,86,135,3,11,2019,
19,43789,49,250,299,3,11,2019,
20,43789,183,73,256,3,11,2019,
21,43789,248,145,393,3,11,2019,
22,43789,246,169,415,3,11,2019,
23,43789,136,156,292,3,11,2019,
0,43790,145,52,197,4,11,2019,
1,43790,41,51,92,4,11,2019,
2,43790,62,0,62,4,11,2019,
3,43790,157,0,157,4,11,2019,
4,43790,268,0,268,4,11,2019,
5,43790,342,0,342,4,11,2019,
6,43790,462,2,464,4,11,2019,
7,43790,357,206,563,4,11,2019,
8,43790,285,291,576,4,11,2019,
9,43790,244,275,519,4,11,2019,
10,43790,230,86,316,4,11,2019,
11,43790,237,159,396,4,11,2019,
12,43790,190,282,472,4,11,2019,
13,43790,229,144,373,4,11,2019,
14,43790,217,172,389,4,11,2019,
15,43790,193,171,364,4,11,2019,
16,43790,219,67,286,4,11,2019,
17,43790,195,211,406,4,11,2019,
18,43790,123,95,218,4,11,2019,
19,43790,82,312,394,4,11,2019,
20,43790,246,117,363,4,11,2019,
21,43790,432,168,600,4,11,2019,
22,43790,370,166,536,4,11,2019,
23,43790,247,272,519,4,11,2019,
0,43791,224,160,384,5,11,2019,
1,43791,73,18,91,5,11,2019,
2,43791,83,0,83,5,11,2019,
3,43791,280,0,280,5,11,2019,
4,43791,260,0,260,5,11,2019,
5,43791,268,0,268,5,11,2019,
6,43791,398,50,448,5,11,2019,
7,43791,382,198,580,5,11,2019,
8,43791,309,165,474,5,11,2019,
9,43791,288,254,542,5,11,2019,
10,43791,270,370,640,5,11,2019,
11,43791,284,171,455,5,11,2019,
12,43791,261,32,293,5,11,2019,
13,43791,279,189,468,5,11,2019,
14,43791,251,108,359,5,11,2019,
15,43791,221,419,640,5,11,2019,
16,43791,212,137,349,5,11,2019,
17,43791,168,215,383,5,11,2019,
18,43791,95,82,177,5,11,2019,
19,43791,98,94,192,5,11,2019,
20,43791,279,155,434,5,11,2019,
21,43791,432,255,687,5,11,2019,
22,43791,438,216,654,5,11,2019,
23,43791,457,300,757,5,11,2019,
0,43792,208,128,336,6,11,2019,
1,43792,81,114,195,6,11,2019,
2,43792,133,52,185,6,11,2019,
3,43792,262,1,263,6,11,2019,
4,43792,204,0,204,6,11,2019,
5,43792,276,1,277,6,11,2019,
6,43792,522,0,522,6,11,2019,
7,43792,646,302,948,6,11,2019,
8,43792,541,394,935,6,11,2019,
9,43792,382,234,616,6,11,2019,
10,43792,363,303,666,6,11,2019,
11,43792,304,213,517,6,11,2019,
12,43792,256,23,279,6,11,2019,
13,43792,283,335,618,6,11,2019,
14,43792,211,383,594,6,11,2019,
15,43792,264,266,530,6,11,2019,
16,43792,294,158,452,6,11,2019,
17,43792,208,117,325,6,11,2019,
18,43792,124,269,393,6,11,2019,
19,43792,83,351,434,6,11,2019,
20,43792,178,338,516,6,11,2019,
21,43792,410,146,556,6,11,2019,
22,43792,410,78,488,6,11,2019,
23,43792,292,292,584,6,11,2019,
0,43793,98,50,148,7,11,2019,
1,43793,52,22,74,7,11,2019,
2,43793,67,93,160,7,11,2019,
3,43793,162,0,162,7,11,2019,
4,43793,240,0,240,7,11,2019,
5,43793,317,0,317,7,11,2019,
6,43793,459,76,535,7,11,2019,
7,43793,386,352,738,7,11,2019,
8,43793,365,368,733,7,11,2019,
9,43793,208,330,538,7,11,2019,
10,43793,226,150,376,7,11,2019,
11,43793,331,277,608,7,11,2019,
12,43793,201,144,345,7,11,2019,
13,43793,174,362,536,7,11,2019,
14,43793,198,88,286,7,11,2019,
15,43793,209,330,539,7,11,2019,
16,43793,202,137,339,7,11,2019,
17,43793,142,144,286,7,11,2019,
18,43793,77,335,412,7,11,2019,
19,43793,91,337,428,7,11,2019,
20,43793,18,12,30,7,11,2019,
21,43793,4,22,26,7,11,2019,
22,43793,398,131,529,7,11,2019,
23,43793,157,498,655,7,11,2019,
0,43794,155,147,302,1,11,2019,
1,43794,50,47,97,1,11,2019,
2,43794,31,0,31,1,11,2019,
3,43794,85,0,85,1,11,2019,
4,43794,140,0,140,1,11,2019,
5,43794,263,0,263,1,11,2019,
6,43794,344,72,416,1,11,2019,
7,43794,341,280,621,1,11,2019,
8,43794,235,377,612,1,11,2019,
9,43794,197,292,489,1,11,2019,
10,43794,177,253,430,1,11,2019,
11,43794,238,192,430,1,11,2019,
12,43794,230,83,313,1,11,2019,
13,43794,130,311,441,1,11,2019,
14,43794,163,91,254,1,11,2019,
15,43794,158,420,578,1,11,2019,
16,43794,143,148,291,1,11,2019,
17,43794,128,176,304,1,11,2019,
18,43794,69,119,188,1,11,2019,
19,43794,38,361,399,1,11,2019,
20,43794,147,233,380,1,11,2019,
21,43794,346,73,419,1,11,2019,
22,43794,231,288,519,1,11,2019,
23,43794,175,220,395,1,11,2019,
0,43795,52,264,316,2,11,2019,
1,43795,61,59,120,2,11,2019,
2,43795,44,0,44,2,11,2019,
3,43795,79,0,79,2,11,2019,
4,43795,192,16,208,2,11,2019,
5,43795,237,0,237,2,11,2019,
6,43795,401,6,407,2,11,2019,
7,43795,298,358,656,2,11,2019,
8,43795,294,352,646,2,11,2019,
9,43795,145,192,337,2,11,2019,
10,43795,120,116,236,2,11,2019,
11,43795,126,372,498,2,11,2019,
12,43795,142,316,458,2,11,2019,
13,43795,192,180,372,2,11,2019,
14,43795,121,196,317,2,11,2019,
15,43795,153,379,532,2,11,2019,
16,43795,215,89,304,2,11,2019,
17,43795,145,290,435,2,11,2019,
18,43795,57,346,403,2,11,2019,
19,43795,127,201,328,2,11,2019,
20,43795,237,65,302,2,11,2019,
21,43795,357,281,638,2,11,2019,
22,43795,364,261,625,2,11,2019,
23,43795,218,360,578,2,11,2019,
0,43796,190,207,397,3,11,2019,
1,43796,36,42,78,3,11,2019,
2,43796,67,0,67,3,11,2019,
3,43796,107,0,107,3,11,2019,
4,43796,165,0,165,3,11,2019,
5,43796,297,0,297,3,11,2019,
6,43796,487,0,487,3,11,2019,
7,43796,377,379,756,3,11,2019,
8,43796,314,380,694,3,11,2019,
9,43796,228,342,570,3,11,2019,
10,43796,200,172,372,3,11,2019,
11,43796,225,447,672,3,11,2019,
12,43796,183,195,378,3,11,2019,
13,43796,163,272,435,3,11,2019,
14,43796,177,398,575,3,11,2019,
15,43796,165,194,359,3,11,2019,
16,43796,191,194,385,3,11,2019,
17,43796,226,245,471,3,11,2019,
18,43796,162,285,447,3,11,2019,
19,43796,111,429,540,3,11,2019,
20,43796,254,374,628,3,11,2019,
21,43796,358,116,474,3,11,2019,
22,43796,394,351,745,3,11,2019,
23,43796,193,304,497,3,11,2019,
0,43797,131,346,477,4,11,2019,
1,43797,99,68,167,4,11,2019,
2,43797,89,21,110,4,11,2019,
3,43797,237,0,237,4,11,2019,
4,43797,241,67,308,4,11,2019,
5,43797,369,3,372,4,11,2019,
6,43797,535,0,535,4,11,2019,
7,43797,473,342,815,4,11,2019,
8,43797,359,437,796,4,11,2019,
9,43797,245,423,668,4,11,2019,
10,43797,171,157,328,4,11,2019,
11,43797,191,294,485,4,11,2019,
12,43797,128,215,343,4,11,2019,
13,43797,140,168,308,4,11,2019,
14,43797,202,247,449,4,11,2019,
15,43797,156,341,497,4,11,2019,
16,43797,152,193,345,4,11,2019,
17,43797,131,231,362,4,11,2019,
18,43797,34,200,234,4,11,2019,
19,43797,43,358,401,4,11,2019,
20,43797,110,119,229,4,11,2019,
21,43797,227,294,521,4,11,2019,
22,43797,272,438,710,4,11,2019,
23,43797,191,425,616,4,11,2019,
0,43798,99,264,363,5,11,2019,
1,43798,59,61,120,5,11,2019,
2,43798,41,52,93,5,11,2019,
3,43798,92,0,92,5,11,2019,
4,43798,168,0,168,5,11,2019,
5,43798,196,0,196,5,11,2019,
6,43798,285,82,367,5,11,2019,
7,43798,410,278,688,5,11,2019,
8,43798,251,487,738,5,11,2019,
9,43798,198,163,361,5,11,2019,
10,43798,168,450,618,5,11,2019,
11,43798,195,282,477,5,11,2019,
12,43798,104,157,261,5,11,2019,
13,43798,134,195,329,5,11,2019,
14,43798,164,304,468,5,11,2019,
15,43798,157,337,494,5,11,2019,
16,43798,121,209,330,5,11,2019,
17,43798,122,341,463,5,11,2019,
18,43798,89,209,298,5,11,2019,
19,43798,74,460,534,5,11,2019,
20,43798,174,214,388,5,11,2019,
21,43798,188,221,409,5,11,2019,
22,43798,246,421,667,5,11,2019,
23,43798,183,384,567,5,11,2019,
0,43799,100,230,330,6,11,2019,
1,43799,60,137,197,6,11,2019,
2,43799,44,140,184,6,11,2019,
3,43799,79,7,86,6,11,2019,
4,43799,49,40,89,6,11,2019,
5,43799,146,0,146,6,11,2019,
6,43799,304,0,304,6,11,2019,
7,43799,345,297,642,6,11,2019,
8,43799,329,561,890,6,11,2019,
9,43799,177,414,591,6,11,2019,
10,43799,129,444,573,6,11,2019,
11,43799,159,344,503,6,11,2019,
12,43799,179,127,306,6,11,2019,
13,43799,218,346,564,6,11,2019,
14,43799,146,224,370,6,11,2019,
15,43799,195,456,651,6,11,2019,
16,43799,227,491,718,6,11,2019,
17,43799,201,388,589,6,11,2019,
18,43799,90,399,489,6,11,2019,
19,43799,106,680,786,6,11,2019,
20,43799,184,291,475,6,11,2019,
21,43799,274,320,594,6,11,2019,
22,43799,252,727,979,6,11,2019,
23,43799,209,502,711,6,11,2019,
0,43800,140,407,547,7,12,2019,
1,43800,75,76,151,7,12,2019,
2,43800,94,0,94,7,12,2019,
3,43800,149,0,149,7,12,2019,
4,43800,173,1,174,7,12,2019,
5,43800,260,1,261,7,12,2019,
6,43800,336,127,463,7,12,2019,
7,43800,324,456,780,7,12,2019,
8,43800,286,656,942,7,12,2019,
9,43800,157,483,640,7,12,2019,
10,43800,192,147,339,7,12,2019,
11,43800,239,359,598,7,12,2019,
12,43800,172,376,548,7,12,2019,
13,43800,227,398,625,7,12,2019,
14,43800,260,449,709,7,12,2019,
15,43800,209,414,623,7,12,2019,
16,43800,247,353,600,7,12,2019,
17,43800,188,309,497,7,12,2019,
18,43800,92,527,619,7,12,2019,
19,43800,119,431,550,7,12,2019,
20,43800,216,515,731,7,12,2019,
21,43800,344,194,538,7,12,2019,
22,43800,263,600,863,7,12,2019,
23,43800,168,771,939,7,12,2019,
0,43801,102,700,802,1,12,2019,
1,43801,63,63,126,1,12,2019,
2,43801,61,0,61,1,12,2019,
3,43801,86,0,86,1,12,2019,
4,43801,122,0,122,1,12,2019,
5,43801,221,0,221,1,12,2019,
6,43801,326,96,422,1,12,2019,
7,43801,304,553,857,1,12,2019,
8,43801,214,668,882,1,12,2019,
9,43801,220,370,590,1,12,2019,
10,43801,202,347,549,1,12,2019,
11,43801,148,328,476,1,12,2019,
12,43801,200,274,474,1,12,2019,
13,43801,162,202,364,1,12,2019,
14,43801,225,291,516,1,12,2019,
15,43801,214,550,764,1,12,2019,
16,43801,200,248,448,1,12,2019,
17,43801,143,279,422,1,12,2019,
18,43801,130,285,415,1,12,2019,
19,43801,117,499,616,1,12,2019,
20,43801,149,341,490,1,12,2019,
21,43801,261,275,536,1,12,2019,
22,43801,269,502,771,1,12,2019,
23,43801,113,457,570,1,12,2019,
0,43802,97,437,534,2,12,2019,
1,43802,84,162,246,2,12,2019,
2,43802,49,0,49,2,12,2019,
3,43802,91,1,92,2,12,2019,
4,43802,134,0,134,2,12,2019,
5,43802,179,3,182,2,12,2019,
6,43802,322,66,388,2,12,2019,
7,43802,253,416,669,2,12,2019,
8,43802,174,335,509,2,12,2019,
9,43802,176,366,542,2,12,2019,
10,43802,141,203,344,2,12,2019,
11,43802,121,235,356,2,12,2019,
12,43802,129,298,427,2,12,2019,
13,43802,155,90,245,2,12,2019,
14,43802,168,311,479,2,12,2019,
15,43802,147,323,470,2,12,2019,
16,43802,186,160,346,2,12,2019,
17,43802,83,277,360,2,12,2019,
18,43802,26,229,255,2,12,2019,
19,43802,43,178,221,2,12,2019,
20,43802,159,136,295,2,12,2019,
21,43802,238,349,587,2,12,2019,
22,43802,214,293,507,2,12,2019,
23,43802,199,295,494,2,12,2019,
0,43803,100,166,266,3,12,2019,
1,43803,21,66,87,3,12,2019,
2,43803,60,0,60,3,12,2019,
3,43803,73,0,73,3,12,2019,
4,43803,132,0,132,3,12,2019,
5,43803,143,0,143,3,12,2019,
6,43803,327,0,327,3,12,2019,
7,43803,247,132,379,3,12,2019,
8,43803,172,123,295,3,12,2019,
9,43803,266,232,498,3,12,2019,
10,43803,182,346,528,3,12,2019,
11,43803,148,292,440,3,12,2019,
12,43803,161,294,455,3,12,2019,
13,43803,121,277,398,3,12,2019,
14,43803,96,139,235,3,12,2019,
15,43803,128,286,414,3,12,2019,
16,43803,163,45,208,3,12,2019,
17,43803,151,280,431,3,12,2019,
18,43803,56,131,187,3,12,2019,
19,43803,64,439,503,3,12,2019,
20,43803,124,165,289,3,12,2019,
21,43803,281,38,319,3,12,2019,
22,43803,228,209,437,3,12,2019,
23,43803,219,204,423,3,12,2019,
0,43804,96,88,184,4,12,2019,
1,43804,35,2,37,4,12,2019,
2,43804,51,11,62,4,12,2019,
3,43804,103,0,103,4,12,2019,
4,43804,227,0,227,4,12,2019,
5,43804,289,1,290,4,12,2019,
6,43804,386,53,439,4,12,2019,
7,43804,318,220,538,4,12,2019,
8,43804,215,224,439,4,12,2019,
9,43804,186,301,487,4,12,2019,
10,43804,236,155,391,4,12,2019,
11,43804,172,257,429,4,12,2019,
12,43804,152,25,177,4,12,2019,
13,43804,171,202,373,4,12,2019,
14,43804,181,113,294,4,12,2019,
15,43804,120,250,370,4,12,2019,
16,43804,167,142,309,4,12,2019,
17,43804,148,130,278,4,12,2019,
18,43804,61,278,339,4,12,2019,
19,43804,74,107,181,4,12,2019,
20,43804,245,117,362,4,12,2019,
21,43804,355,134,489,4,12,2019,
22,43804,360,228,588,4,12,2019,
23,43804,211,184,395,4,12,2019,
0,43805,174,169,343,5,12,2019,
1,43805,78,47,125,5,12,2019,
2,43805,71,0,71,5,12,2019,
3,43805,159,0,159,5,12,2019,
4,43805,182,0,182,5,12,2019,
5,43805,271,0,271,5,12,2019,
6,43805,394,70,464,5,12,2019,
7,43805,350,187,537,5,12,2019,
8,43805,180,208,388,5,12,2019,
9,43805,208,262,470,5,12,2019,
10,43805,153,129,282,5,12,2019,
11,43805,140,220,360,5,12,2019,
12,43805,137,128,265,5,12,2019,
13,43805,204,138,342,5,12,2019,
14,43805,202,131,333,5,12,2019,
15,43805,118,276,394,5,12,2019,
16,43805,96,215,311,5,12,2019,
17,43805,123,139,262,5,12,2019,
18,43805,90,178,268,5,12,2019,
19,43805,104,248,352,5,12,2019,
20,43805,214,66,280,5,12,2019,
21,43805,382,130,512,5,12,2019,
22,43805,347,183,530,5,12,2019,
23,43805,186,205,391,5,12,2019,
0,43806,122,120,242,6,12,2019,
1,43806,51,44,95,6,12,2019,
2,43806,64,10,74,6,12,2019,
3,43806,86,0,86,6,12,2019,
4,43806,140,1,141,6,12,2019,
5,43806,222,0,222,6,12,2019,
6,43806,343,1,344,6,12,2019,
7,43806,354,344,698,6,12,2019,
8,43806,289,317,606,6,12,2019,
9,43806,196,313,509,6,12,2019,
10,43806,206,191,397,6,12,2019,
11,43806,151,197,348,6,12,2019,
12,43806,182,205,387,6,12,2019,
13,43806,155,131,286,6,12,2019,
14,43806,148,249,397,6,12,2019,
15,43806,133,144,277,6,12,2019,
16,43806,184,190,374,6,12,2019,
17,43806,147,200,347,6,12,2019,
18,43806,73,240,313,6,12,2019,
19,43806,109,344,453,6,12,2019,
20,43806,209,130,339,6,12,2019,
21,43806,289,95,384,6,12,2019,
22,43806,217,193,410,6,12,2019,
23,43806,193,152,345,6,12,2019,
0,43807,116,225,341,7,12,2019,
1,43807,81,0,81,7,12,2019,
2,43807,97,17,114,7,12,2019,
3,43807,132,0,132,7,12,2019,
4,43807,148,0,148,7,12,2019,
5,43807,217,0,217,7,12,2019,
6,43807,292,58,350,7,12,2019,
7,43807,306,103,409,7,12,2019,
8,43807,199,395,594,7,12,2019,
9,43807,156,188,344,7,12,2019,
10,43807,269,143,412,7,12,2019,
11,43807,159,170,329,7,12,2019,
12,43807,170,251,421,7,12,2019,
13,43807,185,267,452,7,12,2019,
14,43807,221,219,440,7,12,2019,
15,43807,223,352,575,7,12,2019,
16,43807,235,107,342,7,12,2019,
17,43807,143,337,480,7,12,2019,
18,43807,84,192,276,7,12,2019,
19,43807,106,238,344,7,12,2019,
20,43807,178,214,392,7,12,2019,
21,43807,346,79,425,7,12,2019,
22,43807,251,300,551,7,12,2019,
23,43807,133,330,463,7,12,2019,
0,43808,90,198,288,1,12,2019,
1,43808,45,6,51,1,12,2019,
2,43808,54,0,54,1,12,2019,
3,43808,73,0,73,1,12,2019,
4,43808,145,0,145,1,12,2019,
5,43808,200,0,200,1,12,2019,
6,43808,255,62,317,1,12,2019,
7,43808,262,246,508,1,12,2019,
8,43808,206,221,427,1,12,2019,
9,43808,136,222,358,1,12,2019,
10,43808,143,207,350,1,12,2019,
11,43808,147,206,353,1,12,2019,
12,43808,193,175,368,1,12,2019,
13,43808,168,126,294,1,12,2019,
14,43808,229,132,361,1,12,2019,
15,43808,192,256,448,1,12,2019,
16,43808,167,382,549,1,12,2019,
17,43808,129,122,251,1,12,2019,
18,43808,78,184,262,1,12,2019,
19,43808,123,400,523,1,12,2019,
20,43808,206,95,301,1,12,2019,
21,43808,243,143,386,1,12,2019,
22,43808,243,277,520,1,12,2019,
23,43808,137,268,405,1,12,2019,
0,43809,66,222,288,2,12,2019,
1,43809,44,65,109,2,12,2019,
2,43809,83,33,116,2,12,2019,
3,43809,128,10,138,2,12,2019,
4,43809,111,0,111,2,12,2019,
5,43809,193,1,194,2,12,2019,
6,43809,299,63,362,2,12,2019,
7,43809,236,132,368,2,12,2019,
8,43809,179,227,406,2,12,2019,
9,43809,167,281,448,2,12,2019,
10,43809,151,138,289,2,12,2019,
11,43809,156,144,300,2,12,2019,
12,43809,132,219,351,2,12,2019,
13,43809,167,102,269,2,12,2019,
14,43809,130,200,330,2,12,2019,
15,43809,139,238,377,2,12,2019,
16,43809,164,49,213,2,12,2019,
17,43809,123,248,371,2,12,2019,
18,43809,34,157,191,2,12,2019,
19,43809,57,124,181,2,12,2019,
20,43809,181,42,223,2,12,2019,
21,43809,299,171,470,2,12,2019,
22,43809,332,145,477,2,12,2019,
23,43809,202,153,355,2,12,2019,
0,43810,114,59,173,3,12,2019,
1,43810,71,34,105,3,12,2019,
2,43810,48,0,48,3,12,2019,
3,43810,109,0,109,3,12,2019,
4,43810,134,6,140,3,12,2019,
5,43810,208,2,210,3,12,2019,
6,43810,368,0,368,3,12,2019,
7,43810,219,138,357,3,12,2019,
8,43810,162,194,356,3,12,2019,
9,43810,180,216,396,3,12,2019,
10,43810,174,234,408,3,12,2019,
11,43810,189,238,427,3,12,2019,
12,43810,181,134,315,3,12,2019,
13,43810,123,193,316,3,12,2019,
14,43810,135,109,244,3,12,2019,
15,43810,149,200,349,3,12,2019,
16,43810,135,87,222,3,12,2019,
17,43810,147,139,286,3,12,2019,
18,43810,44,168,212,3,12,2019,
19,43810,51,242,293,3,12,2019,
20,43810,184,72,256,3,12,2019,
21,43810,219,53,272,3,12,2019,
22,43810,215,147,362,3,12,2019,
23,43810,219,142,361,3,12,2019,
0,43811,94,84,178,4,12,2019,
1,43811,39,30,69,4,12,2019,
2,43811,60,2,62,4,12,2019,
3,43811,122,0,122,4,12,2019,
4,43811,209,0,209,4,12,2019,
5,43811,242,0,242,4,12,2019,
6,43811,314,35,349,4,12,2019,
7,43811,289,233,522,4,12,2019,
8,43811,247,272,519,4,12,2019,
9,43811,194,270,464,4,12,2019,
10,43811,230,153,383,4,12,2019,
11,43811,156,180,336,4,12,2019,
12,43811,144,172,316,4,12,2019,
13,43811,155,102,257,4,12,2019,
14,43811,175,43,218,4,12,2019,
15,43811,168,166,334,4,12,2019,
16,43811,162,162,324,4,12,2019,
17,43811,197,124,321,4,12,2019,
18,43811,104,217,321,4,12,2019,
19,43811,65,193,258,4,12,2019,
20,43811,204,46,250,4,12,2019,
21,43811,337,137,474,4,12,2019,
22,43811,242,191,433,4,12,2019,
23,43811,282,90,372,4,12,2019,
0,43812,228,104,332,5,12,2019,
1,43812,155,10,165,5,12,2019,
2,43812,114,6,120,5,12,2019,
3,43812,183,0,183,5,12,2019,
4,43812,267,0,267,5,12,2019,
5,43812,227,0,227,5,12,2019,
6,43812,349,64,413,5,12,2019,
7,43812,279,235,514,5,12,2019,
8,43812,234,221,455,5,12,2019,
9,43812,202,204,406,5,12,2019,
10,43812,152,180,332,5,12,2019,
11,43812,173,151,324,5,12,2019,
12,43812,212,167,379,5,12,2019,
13,43812,167,123,290,5,12,2019,
14,43812,194,97,291,5,12,2019,
15,43812,192,228,420,5,12,2019,
16,43812,113,131,244,5,12,2019,
17,43812,141,130,271,5,12,2019,
18,43812,114,21,135,5,12,2019,
19,43812,123,156,279,5,12,2019,
20,43812,272,73,345,5,12,2019,
21,43812,378,227,605,5,12,2019,
22,43812,327,216,543,5,12,2019,
23,43812,335,194,529,5,12,2019,
0,43813,248,245,493,6,12,2019,
1,43813,81,20,101,6,12,2019,
2,43813,116,0,116,6,12,2019,
3,43813,170,0,170,6,12,2019,
4,43813,203,0,203,6,12,2019,
5,43813,222,0,222,6,12,2019,
6,43813,340,32,372,6,12,2019,
7,43813,357,275,632,6,12,2019,
8,43813,312,498,810,6,12,2019,
9,43813,315,437,752,6,12,2019,
10,43813,214,367,581,6,12,2019,
11,43813,203,277,480,6,12,2019,
12,43813,160,159,319,6,12,2019,
13,43813,132,137,269,6,12,2019,
14,43813,184,120,304,6,12,2019,
15,43813,186,316,502,6,12,2019,
16,43813,150,319,469,6,12,2019,
17,43813,121,146,267,6,12,2019,
18,43813,110,169,279,6,12,2019,
19,43813,107,509,616,6,12,2019,
20,43813,211,268,479,6,12,2019,
21,43813,345,241,586,6,12,2019,
22,43813,326,77,403,6,12,2019,
23,43813,166,203,369,6,12,2019,
0,43814,111,186,297,7,12,2019,
1,43814,66,78,144,7,12,2019,
2,43814,78,67,145,7,12,2019,
3,43814,181,0,181,7,12,2019,
4,43814,180,7,187,7,12,2019,
5,43814,248,0,248,7,12,2019,
6,43814,344,70,414,7,12,2019,
7,43814,232,260,492,7,12,2019,
8,43814,108,421,529,7,12,2019,
9,43814,199,319,518,7,12,2019,
10,43814,282,190,472,7,12,2019,
11,43814,229,324,553,7,12,2019,
12,43814,163,375,538,7,12,2019,
13,43814,227,224,451,7,12,2019,
14,43814,215,233,448,7,12,2019,
15,43814,244,215,459,7,12,2019,
16,43814,250,77,327,7,12,2019,
17,43814,171,315,486,7,12,2019,
18,43814,131,250,381,7,12,2019,
19,43814,136,517,653,7,12,2019,
20,43814,252,124,376,7,12,2019,
21,43814,280,199,479,7,12,2019,
22,43814,293,348,641,7,12,2019,
23,43814,181,424,605,7,12,2019,
0,43815,100,237,337,1,12,2019,
1,43815,46,34,80,1,12,2019,
2,43815,54,19,73,1,12,2019,
3,43815,155,1,156,1,12,2019,
4,43815,231,14,245,1,12,2019,
5,43815,239,2,241,1,12,2019,
6,43815,335,56,391,1,12,2019,
7,43815,270,247,517,1,12,2019,
8,43815,244,470,714,1,12,2019,
9,43815,204,298,502,1,12,2019,
10,43815,243,299,542,1,12,2019,
11,43815,174,258,432,1,12,2019,
12,43815,168,89,257,1,12,2019,
13,43815,173,138,311,1,12,2019,
14,43815,224,99,323,1,12,2019,
15,43815,218,211,429,1,12,2019,
16,43815,258,331,589,1,12,2019,
17,43815,159,280,439,1,12,2019,
18,43815,76,327,403,1,12,2019,
19,43815,83,459,542,1,12,2019,
20,43815,193,114,307,1,12,2019,
21,43815,307,45,352,1,12,2019,
22,43815,318,251,569,1,12,2019,
23,43815,223,307,530,1,12,2019,
0,43816,108,263,371,2,12,2019,
1,43816,113,93,206,2,12,2019,
2,43816,95,2,97,2,12,2019,
3,43816,191,1,192,2,12,2019,
4,43816,247,0,247,2,12,2019,
5,43816,321,0,321,2,12,2019,
6,43816,311,43,354,2,12,2019,
7,43816,319,242,561,2,12,2019,
8,43816,189,248,437,2,12,2019,
9,43816,162,322,484,2,12,2019,
10,43816,141,282,423,2,12,2019,
11,43816,206,131,337,2,12,2019,
12,43816,179,159,338,2,12,2019,
13,43816,141,224,365,2,12,2019,
14,43816,159,301,460,2,12,2019,
15,43816,183,210,393,2,12,2019,
16,43816,130,133,263,2,12,2019,
17,43816,115,227,342,2,12,2019,
18,43816,63,163,226,2,12,2019,
19,43816,156,341,497,2,12,2019,
20,43816,232,84,316,2,12,2019,
21,43816,360,127,487,2,12,2019,
22,43816,356,271,627,2,12,2019,
23,43816,238,91,329,2,12,2019,
0,43817,156,266,422,3,12,2019,
1,43817,74,119,193,3,12,2019,
2,43817,102,5,107,3,12,2019,
3,43817,158,0,158,3,12,2019,
4,43817,244,0,244,3,12,2019,
5,43817,266,8,274,3,12,2019,
6,43817,358,0,358,3,12,2019,
7,43817,234,181,415,3,12,2019,
8,43817,315,458,773,3,12,2019,
9,43817,289,309,598,3,12,2019,
10,43817,306,303,609,3,12,2019,
11,43817,256,303,559,3,12,2019,
12,43817,273,282,555,3,12,2019,
13,43817,177,230,407,3,12,2019,
14,43817,197,138,335,3,12,2019,
15,43817,214,313,527,3,12,2019,
16,43817,156,117,273,3,12,2019,
17,43817,192,243,435,3,12,2019,
18,43817,158,162,320,3,12,2019,
19,43817,124,335,459,3,12,2019,
20,43817,274,156,430,3,12,2019,
21,43817,437,134,571,3,12,2019,
22,43817,370,300,670,3,12,2019,
23,43817,319,132,451,3,12,2019,
0,43818,163,325,488,4,12,2019,
1,43818,88,123,211,4,12,2019,
2,43818,114,7,121,4,12,2019,
3,43818,187,0,187,4,12,2019,
4,43818,329,0,329,4,12,2019,
5,43818,344,2,346,4,12,2019,
6,43818,412,145,557,4,12,2019,
7,43818,411,173,584,4,12,2019,
8,43818,225,552,777,4,12,2019,
9,43818,189,415,604,4,12,2019,
10,43818,230,258,488,4,12,2019,
11,43818,189,262,451,4,12,2019,
12,43818,222,215,437,4,12,2019,
13,43818,194,197,391,4,12,2019,
14,43818,218,286,504,4,12,2019,
15,43818,218,222,440,4,12,2019,
16,43818,199,133,332,4,12,2019,
17,43818,173,266,439,4,12,2019,
18,43818,168,232,400,4,12,2019,
19,43818,147,335,482,4,12,2019,
20,43818,372,197,569,4,12,2019,
21,43818,486,147,633,4,12,2019,
22,43818,568,327,895,4,12,2019,
23,43818,575,244,819,4,12,2019,
0,43819,226,215,441,5,12,2019,
1,43819,144,330,474,5,12,2019,
2,43819,179,19,198,5,12,2019,
3,43819,274,27,301,5,12,2019,
4,43819,304,8,312,5,12,2019,
5,43819,339,0,339,5,12,2019,
6,43819,386,99,485,5,12,2019,
7,43819,343,140,483,5,12,2019,
8,43819,298,505,803,5,12,2019,
9,43819,223,468,691,5,12,2019,
10,43819,310,382,692,5,12,2019,
11,43819,255,103,358,5,12,2019,
12,43819,273,278,551,5,12,2019,
13,43819,250,216,466,5,12,2019,
14,43819,277,206,483,5,12,2019,
15,43819,265,367,632,5,12,2019,
16,43819,202,221,423,5,12,2019,
17,43819,221,430,651,5,12,2019,
18,43819,172,193,365,5,12,2019,
19,43819,218,338,556,5,12,2019,
20,43819,481,217,698,5,12,2019,
21,43819,606,159,765,5,12,2019,
22,43819,649,400,1049,5,12,2019,
23,43819,477,406,883,5,12,2019,
0,43820,246,366,612,6,12,2019,
1,43820,247,227,474,6,12,2019,
2,43820,195,70,265,6,12,2019,
3,43820,205,46,251,6,12,2019,
4,43820,298,1,299,6,12,2019,
5,43820,357,0,357,6,12,2019,
6,43820,454,0,454,6,12,2019,
7,43820,516,346,862,6,12,2019,
8,43820,556,607,1163,6,12,2019,
9,43820,333,670,1003,6,12,2019,
10,43820,350,450,800,6,12,2019,
11,43820,350,305,655,6,12,2019,
12,43820,312,573,885,6,12,2019,
13,43820,245,134,379,6,12,2019,
14,43820,275,498,773,6,12,2019,
15,43820,260,207,467,6,12,2019,
16,43820,419,383,802,6,12,2019,
17,43820,206,497,703,6,12,2019,
18,43820,259,356,615,6,12,2019,
19,43820,176,333,509,6,12,2019,
20,43820,380,228,608,6,12,2019,
21,43820,368,308,676,6,12,2019,
22,43820,539,313,852,6,12,2019,
23,43820,318,180,498,6,12,2019,
0,43821,116,332,448,7,12,2019,
1,43821,118,160,278,7,12,2019,
2,43821,180,47,227,7,12,2019,
3,43821,201,23,224,7,12,2019,
4,43821,281,73,354,7,12,2019,
5,43821,364,97,461,7,12,2019,
6,43821,429,91,520,7,12,2019,
7,43821,303,347,650,7,12,2019,
8,43821,268,671,939,7,12,2019,
9,43821,291,317,608,7,12,2019,
10,43821,398,372,770,7,12,2019,
11,43821,335,401,736,7,12,2019,
12,43821,288,372,660,7,12,2019,
13,43821,251,296,547,7,12,2019,
14,43821,289,344,633,7,12,2019,
15,43821,216,327,543,7,12,2019,
16,43821,289,141,430,7,12,2019,
17,43821,181,330,511,7,12,2019,
18,43821,183,288,471,7,12,2019,
19,43821,234,485,719,7,12,2019,
20,43821,293,94,387,7,12,2019,
21,43821,503,234,737,7,12,2019,
22,43821,311,330,641,7,12,2019,
23,43821,216,423,639,7,12,2019,
0,43822,102,324,426,1,12,2019,
1,43822,75,257,332,1,12,2019,
2,43822,117,3,120,1,12,2019,
3,43822,202,1,203,1,12,2019,
4,43822,177,0,177,1,12,2019,
5,43822,292,65,357,1,12,2019,
6,43822,436,63,499,1,12,2019,
7,43822,365,208,573,1,12,2019,
8,43822,336,611,947,1,12,2019,
9,43822,338,431,769,1,12,2019,
10,43822,257,341,598,1,12,2019,
11,43822,271,325,596,1,12,2019,
12,43822,223,361,584,1,12,2019,
13,43822,269,137,406,1,12,2019,
14,43822,232,170,402,1,12,2019,
15,43822,252,350,602,1,12,2019,
16,43822,223,106,329,1,12,2019,
17,43822,170,437,607,1,12,2019,
18,43822,144,237,381,1,12,2019,
19,43822,175,368,543,1,12,2019,
20,43822,292,275,567,1,12,2019,
21,43822,437,254,691,1,12,2019,
22,43822,334,274,608,1,12,2019,
23,43822,199,395,594,1,12,2019,
0,43823,86,375,461,2,12,2019,
1,43823,118,198,316,2,12,2019,
2,43823,108,30,138,2,12,2019,
3,43823,184,37,221,2,12,2019,
4,43823,261,1,262,2,12,2019,
5,43823,311,0,311,2,12,2019,
6,43823,416,80,496,2,12,2019,
7,43823,355,351,706,2,12,2019,
8,43823,286,586,872,2,12,2019,
9,43823,213,415,628,2,12,2019,
10,43823,239,310,549,2,12,2019,
11,43823,203,241,444,2,12,2019,
12,43823,269,132,401,2,12,2019,
13,43823,195,334,529,2,12,2019,
14,43823,159,296,455,2,12,2019,
15,43823,110,273,383,2,12,2019,
16,43823,95,50,145,2,12,2019,
17,43823,78,325,403,2,12,2019,
18,43823,92,172,264,2,12,2019,
19,43823,105,127,232,2,12,2019,
20,43823,299,39,338,2,12,2019,
21,43823,243,217,460,2,12,2019,
22,43823,247,276,523,2,12,2019,
23,43823,220,193,413,2,12,2019,
0,43824,121,123,244,3,12,2019,
1,43824,42,83,125,3,12,2019,
2,43824,121,0,121,3,12,2019,
3,43824,154,0,154,3,12,2019,
4,43824,302,0,302,3,12,2019,
5,43824,333,0,333,3,12,2019,
6,43824,393,0,393,3,12,2019,
7,43824,418,171,589,3,12,2019,
8,43824,251,547,798,3,12,2019,
9,43824,236,539,775,3,12,2019,
10,43824,268,494,762,3,12,2019,
11,43824,366,333,699,3,12,2019,
12,43824,324,378,702,3,12,2019,
13,43824,304,260,564,3,12,2019,
14,43824,245,254,499,3,12,2019,
15,43824,245,292,537,3,12,2019,
16,43824,262,359,621,3,12,2019,
17,43824,186,75,261,3,12,2019,
18,43824,111,590,701,3,12,2019,
19,43824,160,516,676,3,12,2019,
20,43824,248,143,391,3,12,2019,
21,43824,396,284,680,3,12,2019,
22,43824,434,326,760,3,12,2019,
23,43824,299,426,725,3,12,2019,
0,43825,121,433,554,4,12,2019,
1,43825,62,261,323,4,12,2019,
2,43825,67,38,105,4,12,2019,
3,43825,194,7,201,4,12,2019,
4,43825,347,61,408,4,12,2019,
5,43825,362,4,366,4,12,2019,
6,43825,480,85,565,4,12,2019,
7,43825,597,218,815,4,12,2019,
8,43825,570,548,1118,4,12,2019,
9,43825,370,679,1049,4,12,2019,
10,43825,351,606,957,4,12,2019,
11,43825,226,307,533,4,12,2019,
12,43825,294,404,698,4,12,2019,
13,43825,281,352,633,4,12,2019,
14,43825,270,222,492,4,12,2019,
15,43825,347,339,686,4,12,2019,
16,43825,317,240,557,4,12,2019,
17,43825,267,432,699,4,12,2019,
18,43825,175,518,693,4,12,2019,
19,43825,144,448,592,4,12,2019,
20,43825,318,170,488,4,12,2019,
21,43825,424,192,616,4,12,2019,
22,43825,442,474,916,4,12,2019,
23,43825,313,358,671,4,12,2019,
0,43826,176,574,750,5,12,2019,
1,43826,150,445,595,5,12,2019,
2,43826,138,22,160,5,12,2019,
3,43826,185,0,185,5,12,2019,
4,43826,361,35,396,5,12,2019,
5,43826,316,13,329,5,12,2019,
6,43826,459,65,524,5,12,2019,
7,43826,432,275,707,5,12,2019,
8,43826,356,478,834,5,12,2019,
9,43826,277,707,984,5,12,2019,
10,43826,261,456,717,5,12,2019,
11,43826,226,386,612,5,12,2019,
12,43826,258,334,592,5,12,2019,
13,43826,310,276,586,5,12,2019,
14,43826,247,366,613,5,12,2019,
15,43826,275,387,662,5,12,2019,
16,43826,270,450,720,5,12,2019,
17,43826,240,511,751,5,12,2019,
18,43826,126,357,483,5,12,2019,
19,43826,198,457,655,5,12,2019,
20,43826,270,408,678,5,12,2019,
21,43826,434,198,632,5,12,2019,
22,43826,512,486,998,5,12,2019,
23,43826,500,475,975,5,12,2019,
0,43827,236,508,744,6,12,2019,
1,43827,99,378,477,6,12,2019,
2,43827,116,0,116,6,12,2019,
3,43827,244,76,320,6,12,2019,
4,43827,290,1,291,6,12,2019,
5,43827,258,0,258,6,12,2019,
6,43827,394,0,394,6,12,2019,
7,43827,474,391,865,6,12,2019,
8,43827,562,786,1348,6,12,2019,
9,43827,376,742,1118,6,12,2019,
10,43827,267,574,841,6,12,2019,
11,43827,259,392,651,6,12,2019,
12,43827,322,470,792,6,12,2019,
13,43827,245,368,613,6,12,2019,
14,43827,252,216,468,6,12,2019,
15,43827,257,502,759,6,12,2019,
16,43827,205,474,679,6,12,2019,
17,43827,201,413,614,6,12,2019,
18,43827,122,438,560,6,12,2019,
19,43827,116,511,627,6,12,2019,
20,43827,285,381,666,6,12,2019,
21,43827,340,260,600,6,12,2019,
22,43827,331,398,729,6,12,2019,
23,43827,223,371,594,6,12,2019,
0,43828,163,534,697,7,12,2019,
1,43828,89,239,328,7,12,2019,
2,43828,109,1,110,7,12,2019,
3,43828,191,0,191,7,12,2019,
4,43828,217,0,217,7,12,2019,
5,43828,309,0,309,7,12,2019,
6,43828,388,103,491,7,12,2019,
7,43828,317,374,691,7,12,2019,
8,43828,244,740,984,7,12,2019,
9,43828,274,490,764,7,12,2019,
10,43828,299,257,556,7,12,2019,
11,43828,301,270,571,7,12,2019,
12,43828,246,563,809,7,12,2019,
13,43828,266,510,776,7,12,2019,
14,43828,222,127,349,7,12,2019,
15,43828,262,556,818,7,12,2019,
16,43828,230,219,449,7,12,2019,
17,43828,237,316,553,7,12,2019,
18,43828,145,371,516,7,12,2019,
19,43828,159,626,785,7,12,2019,
20,43828,251,106,357,7,12,2019,
21,43828,359,242,601,7,12,2019,
22,43828,385,532,917,7,12,2019,
23,43828,255,504,759,7,12,2019,
0,43829,97,568,665,1,12,2019,
1,43829,69,298,367,1,12,2019,
2,43829,65,64,129,1,12,2019,
3,43829,131,0,131,1,12,2019,
4,43829,155,0,155,1,12,2019,
5,43829,251,0,251,1,12,2019,
6,43829,440,79,519,1,12,2019,
7,43829,394,394,788,1,12,2019,
8,43829,311,581,892,1,12,2019,
9,43829,245,728,973,1,12,2019,
10,43829,160,434,594,1,12,2019,
11,43829,230,512,742,1,12,2019,
12,43829,228,318,546,1,12,2019,
13,43829,216,176,392,1,12,2019,
14,43829,242,218,460,1,12,2019,
15,43829,313,345,658,1,12,2019,
16,43829,376,420,796,1,12,2019,
17,43829,181,329,510,1,12,2019,
18,43829,164,334,498,1,12,2019,
19,43829,126,769,895,1,12,2019,
20,43829,222,351,573,1,12,2019,
21,43829,415,291,706,1,12,2019,
22,43829,330,227,557,1,12,2019,
23,43829,206,374,580,1,12,2019,
0,43830,153,522,675,2,12,2019,
1,43830,87,704,791,2,12,2019,
2,43830,64,50,114,2,12,2019,
3,43830,131,38,169,2,12,2019,
4,43830,161,43,204,2,12,2019,
5,43830,337,0,337,2,12,2019,
6,43830,412,90,502,2,12,2019,
7,43830,407,349,756,2,12,2019,
8,43830,329,733,1062,2,12,2019,
9,43830,217,416,633,2,12,2019,
10,43830,205,286,491,2,12,2019,
11,43830,169,304,473,2,12,2019,
12,43830,192,303,495,2,12,2019,
13,43830,251,245,496,2,12,2019,
14,43830,162,372,534,2,12,2019,
15,43830,134,420,554,2,12,2019,
16,43830,178,226,404,2,12,2019,
17,43830,51,214,265,2,12,2019,
18,43830,74,396,470,2,12,2019,
19,43830,132,162,294,2,12,2019,
20,43830,230,181,411,2,12,2019,
21,43830,267,352,619,2,12,2019,
22,43830,170,218,388,2,12,2019,
23,43830,84,460,544,2,12,2019,
0,43831,46,183,229,3,1,2020,
1,43831,56,3,59,3,1,2020,
2,43831,51,0,51,3,1,2020,
3,43831,105,1,106,3,1,2020,
4,43831,173,1,174,3,1,2020,
5,43831,211,0,211,3,1,2020,
6,43831,375,0,375,3,1,2020,
7,43831,348,310,658,3,1,2020,
8,43831,259,651,910,3,1,2020,
9,43831,250,475,725,3,1,2020,
10,43831,310,368,678,3,1,2020,
11,43831,302,460,762,3,1,2020,
12,43831,297,344,641,3,1,2020,
13,43831,219,316,535,3,1,2020,
14,43831,207,287,494,3,1,2020,
15,43831,265,409,674,3,1,2020,
16,43831,306,260,566,3,1,2020,
17,43831,241,239,480,3,1,2020,
18,43831,109,311,420,3,1,2020,
19,43831,145,570,715,3,1,2020,
20,43831,218,224,442,3,1,2020,
21,43831,357,277,634,3,1,2020,
22,43831,339,227,566,3,1,2020,
23,43831,178,639,817,3,1,2020,
0,43832,89,379,468,4,1,2020,
1,43832,59,358,417,4,1,2020,
2,43832,62,13,75,4,1,2020,
3,43832,122,0,122,4,1,2020,
4,43832,240,0,240,4,1,2020,
5,43832,259,0,259,4,1,2020,
6,43832,497,28,525,4,1,2020,
7,43832,420,289,709,4,1,2020,
8,43832,304,561,865,4,1,2020,
9,43832,303,525,828,4,1,2020,
10,43832,271,208,479,4,1,2020,
11,43832,253,310,563,4,1,2020,
12,43832,256,250,506,4,1,2020,
13,43832,347,494,841,4,1,2020,
14,43832,282,262,544,4,1,2020,
15,43832,305,408,713,4,1,2020,
16,43832,355,145,500,4,1,2020,
17,43832,305,469,774,4,1,2020,
18,43832,178,561,739,4,1,2020,
19,43832,167,225,392,4,1,2020,
20,43832,263,507,770,4,1,2020,
21,43832,430,96,526,4,1,2020,
22,43832,489,470,959,4,1,2020,
23,43832,299,421,720,4,1,2020,
0,43833,145,449,594,5,1,2020,
1,43833,49,466,515,5,1,2020,
2,43833,41,160,201,5,1,2020,
3,43833,132,0,132,5,1,2020,
4,43833,225,1,226,5,1,2020,
5,43833,291,17,308,5,1,2020,
6,43833,478,102,580,5,1,2020,
7,43833,459,269,728,5,1,2020,
8,43833,238,458,696,5,1,2020,
9,43833,263,701,964,5,1,2020,
10,43833,210,439,649,5,1,2020,
11,43833,242,486,728,5,1,2020,
12,43833,311,185,496,5,1,2020,
13,43833,336,298,634,5,1,2020,
14,43833,329,271,600,5,1,2020,
15,43833,553,277,830,5,1,2020,
16,43833,353,476,829,5,1,2020,
17,43833,260,312,572,5,1,2020,
18,43833,190,557,747,5,1,2020,
19,43833,203,544,747,5,1,2020,
20,43833,350,284,634,5,1,2020,
21,43833,397,340,737,5,1,2020,
22,43833,554,462,1016,5,1,2020,
23,43833,360,612,972,5,1,2020,
0,43834,117,601,718,6,1,2020,
1,43834,58,414,472,6,1,2020,
2,43834,55,140,195,6,1,2020,
3,43834,164,73,237,6,1,2020,
4,43834,199,26,225,6,1,2020,
5,43834,265,0,265,6,1,2020,
6,43834,553,3,556,6,1,2020,
7,43834,397,472,869,6,1,2020,
8,43834,374,737,1111,6,1,2020,
9,43834,329,764,1093,6,1,2020,
10,43834,296,394,690,6,1,2020,
11,43834,311,420,731,6,1,2020,
12,43834,327,405,732,6,1,2020,
13,43834,348,276,624,6,1,2020,
14,43834,336,607,943,6,1,2020,
15,43834,434,401,835,6,1,2020,
16,43834,427,394,821,6,1,2020,
17,43834,376,499,875,6,1,2020,
18,43834,199,464,663,6,1,2020,
19,43834,175,691,866,6,1,2020,
20,43834,342,358,700,6,1,2020,
21,43834,557,314,871,6,1,2020,
22,43834,490,707,1197,6,1,2020,
23,43834,298,506,804,6,1,2020,
0,43835,171,504,675,7,1,2020,
1,43835,80,311,391,7,1,2020,
2,43835,162,3,165,7,1,2020,
3,43835,194,15,209,7,1,2020,
4,43835,231,89,320,7,1,2020,
5,43835,330,163,493,7,1,2020,
6,43835,433,278,711,7,1,2020,
7,43835,333,318,651,7,1,2020,
8,43835,251,441,692,7,1,2020,
9,43835,188,331,519,7,1,2020,
10,43835,230,394,624,7,1,2020,
11,43835,282,342,624,7,1,2020,
12,43835,270,530,800,7,1,2020,
13,43835,239,219,458,7,1,2020,
14,43835,250,403,653,7,1,2020,
15,43835,396,503,899,7,1,2020,
16,43835,388,417,805,7,1,2020,
17,43835,315,131,446,7,1,2020,
18,43835,170,232,402,7,1,2020,
19,43835,204,586,790,7,1,2020,
20,43835,256,359,615,7,1,2020,
21,43835,359,757,1116,7,1,2020,
22,43835,333,476,809,7,1,2020,
23,43835,207,448,655,7,1,2020,
0,43836,113,506,619,1,1,2020,
1,43836,52,725,777,1,1,2020,
2,43836,44,238,282,1,1,2020,
3,43836,96,211,307,1,1,2020,
4,43836,113,212,325,1,1,2020,
5,43836,226,116,342,1,1,2020,
6,43836,344,3,347,1,1,2020,
7,43836,390,325,715,1,1,2020,
8,43836,260,547,807,1,1,2020,
9,43836,238,730,968,1,1,2020,
10,43836,206,567,773,1,1,2020,
11,43836,177,344,521,1,1,2020,
12,43836,207,250,457,1,1,2020,
13,43836,303,228,531,1,1,2020,
14,43836,256,139,395,1,1,2020,
15,43836,335,519,854,1,1,2020,
16,43836,323,397,720,1,1,2020,
17,43836,254,341,595,1,1,2020,
18,43836,99,370,469,1,1,2020,
19,43836,90,530,620,1,1,2020,
20,43836,211,369,580,1,1,2020,
21,43836,325,183,508,1,1,2020,
22,43836,302,438,740,1,1,2020,
23,43836,167,469,636,1,1,2020,
0,43837,79,461,540,2,1,2020,
1,43837,55,488,543,2,1,2020,
2,43837,56,71,127,2,1,2020,
3,43837,101,2,103,2,1,2020,
4,43837,134,0,134,2,1,2020,
5,43837,244,90,334,2,1,2020,
6,43837,318,77,395,2,1,2020,
7,43837,349,288,637,2,1,2020,
8,43837,253,584,837,2,1,2020,
9,43837,226,467,693,2,1,2020,
10,43837,267,271,538,2,1,2020,
11,43837,171,277,448,2,1,2020,
12,43837,199,327,526,2,1,2020,
13,43837,301,457,758,2,1,2020,
14,43837,223,218,441,2,1,2020,
15,43837,197,325,522,2,1,2020,
16,43837,201,169,370,2,1,2020,
17,43837,85,308,393,2,1,2020,
18,43837,50,277,327,2,1,2020,
19,43837,75,285,360,2,1,2020,
20,43837,214,190,404,2,1,2020,
21,43837,326,335,661,2,1,2020,
22,43837,205,391,596,2,1,2020,
23,43837,228,514,742,2,1,2020,
0,43838,75,396,471,3,1,2020,
1,43838,41,225,266,3,1,2020,
2,43838,53,0,53,3,1,2020,
3,43838,75,0,75,3,1,2020,
4,43838,124,0,124,3,1,2020,
5,43838,185,0,185,3,1,2020,
6,43838,316,0,316,3,1,2020,
7,43838,192,134,326,3,1,2020,
8,43838,157,573,730,3,1,2020,
9,43838,205,386,591,3,1,2020,
10,43838,210,398,608,3,1,2020,
11,43838,206,357,563,3,1,2020,
12,43838,210,207,417,3,1,2020,
13,43838,126,451,577,3,1,2020,
14,43838,140,225,365,3,1,2020,
15,43838,144,463,607,3,1,2020,
16,43838,156,204,360,3,1,2020,
17,43838,113,238,351,3,1,2020,
18,43838,59,125,184,3,1,2020,
19,43838,39,349,388,3,1,2020,
20,43838,161,336,497,3,1,2020,
21,43838,293,133,426,3,1,2020,
22,43838,230,256,486,3,1,2020,
23,43838,155,395,550,3,1,2020,
0,43839,102,264,366,4,1,2020,
1,43839,63,117,180,4,1,2020,
2,43839,39,0,39,4,1,2020,
3,43839,133,0,133,4,1,2020,
4,43839,247,0,247,4,1,2020,
5,43839,259,1,260,4,1,2020,
6,43839,364,58,422,4,1,2020,
7,43839,363,123,486,4,1,2020,
8,43839,214,537,751,4,1,2020,
9,43839,134,273,407,4,1,2020,
10,43839,157,308,465,4,1,2020,
11,43839,191,275,466,4,1,2020,
12,43839,136,100,236,4,1,2020,
13,43839,140,348,488,4,1,2020,
14,43839,176,155,331,4,1,2020,
15,43839,147,413,560,4,1,2020,
16,43839,117,215,332,4,1,2020,
17,43839,122,105,227,4,1,2020,
18,43839,90,172,262,4,1,2020,
19,43839,66,411,477,4,1,2020,
20,43839,190,301,491,4,1,2020,
21,43839,255,135,390,4,1,2020,
22,43839,305,194,499,4,1,2020,
23,43839,206,300,506,4,1,2020,
0,43840,106,464,570,5,1,2020,
1,43840,51,211,262,5,1,2020,
2,43840,44,112,156,5,1,2020,
3,43840,109,0,109,5,1,2020,
4,43840,205,0,205,5,1,2020,
5,43840,229,0,229,5,1,2020,
6,43840,332,26,358,5,1,2020,
7,43840,298,119,417,5,1,2020,
8,43840,202,558,760,5,1,2020,
9,43840,150,419,569,5,1,2020,
10,43840,152,244,396,5,1,2020,
11,43840,178,344,522,5,1,2020,
12,43840,138,201,339,5,1,2020,
13,43840,187,271,458,5,1,2020,
14,43840,190,91,281,5,1,2020,
15,43840,96,415,511,5,1,2020,
16,43840,120,338,458,5,1,2020,
17,43840,82,256,338,5,1,2020,
18,43840,94,104,198,5,1,2020,
19,43840,93,362,455,5,1,2020,
20,43840,133,290,423,5,1,2020,
21,43840,239,194,433,5,1,2020,
22,43840,390,373,763,5,1,2020,
23,43840,262,355,617,5,1,2020,
0,43841,126,517,643,6,1,2020,
1,43841,47,117,164,6,1,2020,
2,43841,60,54,114,6,1,2020,
3,43841,97,1,98,6,1,2020,
4,43841,95,0,95,6,1,2020,
5,43841,157,0,157,6,1,2020,
6,43841,335,1,336,6,1,2020,
7,43841,249,283,532,6,1,2020,
8,43841,216,544,760,6,1,2020,
9,43841,166,444,610,6,1,2020,
10,43841,210,392,602,6,1,2020,
11,43841,132,265,397,6,1,2020,
12,43841,143,307,450,6,1,2020,
13,43841,175,170,345,6,1,2020,
14,43841,212,206,418,6,1,2020,
15,43841,124,404,528,6,1,2020,
16,43841,114,472,586,6,1,2020,
17,43841,90,336,426,6,1,2020,
18,43841,66,347,413,6,1,2020,
19,43841,52,430,482,6,1,2020,
20,43841,143,468,611,6,1,2020,
21,43841,213,127,340,6,1,2020,
22,43841,210,383,593,6,1,2020,
23,43841,131,409,540,6,1,2020,
0,43842,97,433,530,7,1,2020,
1,43842,38,10,48,7,1,2020,
2,43842,54,0,54,7,1,2020,
3,43842,91,0,91,7,1,2020,
4,43842,104,0,104,7,1,2020,
5,43842,217,2,219,7,1,2020,
6,43842,277,87,364,7,1,2020,
7,43842,210,231,441,7,1,2020,
8,43842,132,670,802,7,1,2020,
9,43842,123,536,659,7,1,2020,
10,43842,143,262,405,7,1,2020,
11,43842,133,377,510,7,1,2020,
12,43842,147,360,507,7,1,2020,
13,43842,175,265,440,7,1,2020,
14,43842,193,214,407,7,1,2020,
15,43842,201,450,651,7,1,2020,
16,43842,209,245,454,7,1,2020,
17,43842,135,246,381,7,1,2020,
18,43842,70,394,464,7,1,2020,
19,43842,48,605,653,7,1,2020,
20,43842,147,309,456,7,1,2020,
21,43842,196,131,327,7,1,2020,
22,43842,167,367,534,7,1,2020,
23,43842,106,504,610,7,1,2020,
0,43843,73,458,531,1,1,2020,
1,43843,43,165,208,1,1,2020,
2,43843,21,68,89,1,1,2020,
3,43843,46,0,46,1,1,2020,
4,43843,84,0,84,1,1,2020,
5,43843,126,0,126,1,1,2020,
6,43843,250,104,354,1,1,2020,
7,43843,163,283,446,1,1,2020,
8,43843,118,698,816,1,1,2020,
9,43843,99,309,408,1,1,2020,
10,43843,102,269,371,1,1,2020,
11,43843,87,221,308,1,1,2020,
12,43843,58,201,259,1,1,2020,
13,43843,123,275,398,1,1,2020,
14,43843,136,96,232,1,1,2020,
15,43843,106,465,571,1,1,2020,
16,43843,82,410,492,1,1,2020,
17,43843,86,112,198,1,1,2020,
18,43843,32,341,373,1,1,2020,
19,43843,47,491,538,1,1,2020,
20,43843,72,73,145,1,1,2020,
21,43843,199,218,417,1,1,2020,
22,43843,153,338,491,1,1,2020,
23,43843,60,391,451,1,1,2020,
0,43844,44,474,518,2,1,2020,
1,43844,29,108,137,2,1,2020,
2,43844,27,18,45,2,1,2020,
3,43844,56,1,57,2,1,2020,
4,43844,64,0,64,2,1,2020,
5,43844,117,0,117,2,1,2020,
6,43844,231,60,291,2,1,2020,
7,43844,235,298,533,2,1,2020,
8,43844,149,546,695,2,1,2020,
9,43844,78,397,475,2,1,2020,
10,43844,72,272,344,2,1,2020,
11,43844,90,293,383,2,1,2020,
12,43844,75,152,227,2,1,2020,
13,43844,111,251,362,2,1,2020,
14,43844,87,201,288,2,1,2020,
15,43844,74,380,454,2,1,2020,
16,43844,80,182,262,2,1,2020,
17,43844,31,234,265,2,1,2020,
18,43844,32,232,264,2,1,2020,
19,43844,49,248,297,2,1,2020,
20,43844,124,57,181,2,1,2020,
21,43844,224,147,371,2,1,2020,
22,43844,239,324,563,2,1,2020,
23,43844,190,293,483,2,1,2020,
0,43845,113,436,549,3,1,2020,
1,43845,31,94,125,3,1,2020,
2,43845,40,0,40,3,1,2020,
3,43845,48,0,48,3,1,2020,
4,43845,69,0,69,3,1,2020,
5,43845,135,0,135,3,1,2020,
6,43845,265,0,265,3,1,2020,
7,43845,258,322,580,3,1,2020,
8,43845,153,438,591,3,1,2020,
9,43845,155,305,460,3,1,2020,
10,43845,103,292,395,3,1,2020,
11,43845,185,274,459,3,1,2020,
12,43845,124,258,382,3,1,2020,
13,43845,127,135,262,3,1,2020,
14,43845,101,55,156,3,1,2020,
15,43845,150,424,574,3,1,2020,
16,43845,93,159,252,3,1,2020,
17,43845,91,238,329,3,1,2020,
18,43845,14,45,59,3,1,2020,
19,43845,24,428,452,3,1,2020,
20,43845,99,102,201,3,1,2020,
21,43845,279,158,437,3,1,2020,
22,43845,219,214,433,3,1,2020,
23,43845,159,316,475,3,1,2020,
0,43846,131,153,284,4,1,2020,
1,43846,41,26,67,4,1,2020,
2,43846,56,0,56,4,1,2020,
3,43846,72,0,72,4,1,2020,
4,43846,307,0,307,4,1,2020,
5,43846,288,0,288,4,1,2020,
6,43846,379,102,481,4,1,2020,
7,43846,348,164,512,4,1,2020,
8,43846,239,535,774,4,1,2020,
9,43846,209,263,472,4,1,2020,
10,43846,206,256,462,4,1,2020,
11,43846,179,194,373,4,1,2020,
12,43846,150,183,333,4,1,2020,
13,43846,179,126,305,4,1,2020,
14,43846,113,191,304,4,1,2020,
15,43846,138,285,423,4,1,2020,
16,43846,188,91,279,4,1,2020,
17,43846,127,256,383,4,1,2020,
18,43846,48,158,206,4,1,2020,
19,43846,55,314,369,4,1,2020,
20,43846,161,187,348,4,1,2020,
21,43846,367,228,595,4,1,2020,
22,43846,352,180,532,4,1,2020,
23,43846,282,140,422,4,1,2020,
0,43847,156,292,448,5,1,2020,
1,43847,60,44,104,5,1,2020,
2,43847,45,0,45,5,1,2020,
3,43847,161,0,161,5,1,2020,
4,43847,202,0,202,5,1,2020,
5,43847,262,0,262,5,1,2020,
6,43847,432,99,531,5,1,2020,
7,43847,380,203,583,5,1,2020,
8,43847,292,498,790,5,1,2020,
9,43847,210,297,507,5,1,2020,
10,43847,200,247,447,5,1,2020,
11,43847,192,179,371,5,1,2020,
12,43847,160,246,406,5,1,2020,
13,43847,185,295,480,5,1,2020,
14,43847,200,164,364,5,1,2020,
15,43847,149,371,520,5,1,2020,
16,43847,135,212,347,5,1,2020,
17,43847,162,157,319,5,1,2020,
18,43847,107,218,325,5,1,2020,
19,43847,56,333,389,5,1,2020,
20,43847,169,113,282,5,1,2020,
21,43847,339,235,574,5,1,2020,
22,43847,368,165,533,5,1,2020,
23,43847,275,304,579,5,1,2020,
0,43848,172,211,383,6,1,2020,
1,43848,101,14,115,6,1,2020,
2,43848,59,0,59,6,1,2020,
3,43848,139,1,140,6,1,2020,
4,43848,159,0,159,6,1,2020,
5,43848,145,0,145,6,1,2020,
6,43848,397,0,397,6,1,2020,
7,43848,362,259,621,6,1,2020,
8,43848,290,461,751,6,1,2020,
9,43848,212,374,586,6,1,2020,
10,43848,173,320,493,6,1,2020,
11,43848,103,374,477,6,1,2020,
12,43848,110,149,259,6,1,2020,
13,43848,160,247,407,6,1,2020,
14,43848,150,157,307,6,1,2020,
15,43848,109,323,432,6,1,2020,
16,43848,116,204,320,6,1,2020,
17,43848,80,274,354,6,1,2020,
18,43848,38,147,185,6,1,2020,
19,43848,34,528,562,6,1,2020,
20,43848,132,121,253,6,1,2020,
21,43848,257,161,418,6,1,2020,
22,43848,162,288,450,6,1,2020,
23,43848,129,341,470,6,1,2020,
0,43849,91,141,232,7,1,2020,
1,43849,22,0,22,7,1,2020,
2,43849,75,16,91,7,1,2020,
3,43849,119,8,127,7,1,2020,
4,43849,89,0,89,7,1,2020,
5,43849,156,1,157,7,1,2020,
6,43849,270,71,341,7,1,2020,
7,43849,206,312,518,7,1,2020,
8,43849,154,542,696,7,1,2020,
9,43849,152,332,484,7,1,2020,
10,43849,111,280,391,7,1,2020,
11,43849,142,250,392,7,1,2020,
12,43849,114,250,364,7,1,2020,
13,43849,143,202,345,7,1,2020,
14,43849,200,290,490,7,1,2020,
15,43849,180,260,440,7,1,2020,
16,43849,162,224,386,7,1,2020,
17,43849,165,213,378,7,1,2020,
18,43849,62,439,501,7,1,2020,
19,43849,59,619,678,7,1,2020,
20,43849,145,43,188,7,1,2020,
21,43849,191,147,338,7,1,2020,
22,43849,150,242,392,7,1,2020,
23,43849,101,526,627,7,1,2020,
0,43850,72,279,351,1,1,2020,
1,43850,34,219,253,1,1,2020,
2,43850,25,0,25,1,1,2020,
3,43850,49,0,49,1,1,2020,
4,43850,54,0,54,1,1,2020,
5,43850,139,0,139,1,1,2020,
6,43850,219,116,335,1,1,2020,
7,43850,141,418,559,1,1,2020,
8,43850,122,497,619,1,1,2020,
9,43850,82,359,441,1,1,2020,
10,43850,92,193,285,1,1,2020,
11,43850,122,213,335,1,1,2020,
12,43850,84,203,287,1,1,2020,
13,43850,107,161,268,1,1,2020,
14,43850,147,193,340,1,1,2020,
15,43850,158,595,753,1,1,2020,
16,43850,122,364,486,1,1,2020,
17,43850,128,326,454,1,1,2020,
18,43850,55,326,381,1,1,2020,
19,43850,36,370,406,1,1,2020,
20,43850,95,414,509,1,1,2020,
21,43850,134,136,270,1,1,2020,
22,43850,108,456,564,1,1,2020,
23,43850,44,330,374,1,1,2020,
0,43851,50,583,633,2,1,2020,
1,43851,37,119,156,2,1,2020,
2,43851,47,0,47,2,1,2020,
3,43851,56,1,57,2,1,2020,
4,43851,59,0,59,2,1,2020,
5,43851,114,0,114,2,1,2020,
6,43851,188,55,243,2,1,2020,
7,43851,203,296,499,2,1,2020,
8,43851,133,431,564,2,1,2020,
9,43851,87,320,407,2,1,2020,
10,43851,85,223,308,2,1,2020,
11,43851,83,226,309,2,1,2020,
12,43851,91,181,272,2,1,2020,
13,43851,114,173,287,2,1,2020,
14,43851,88,218,306,2,1,2020,
15,43851,65,373,438,2,1,2020,
16,43851,74,204,278,2,1,2020,
17,43851,37,318,355,2,1,2020,
18,43851,20,176,196,2,1,2020,
19,43851,41,190,231,2,1,2020,
20,43851,135,93,228,2,1,2020,
21,43851,208,238,446,2,1,2020,
22,43851,210,370,580,2,1,2020,
23,43851,222,265,487,2,1,2020,
0,43852,84,165,249,3,1,2020,
1,43852,30,69,99,3,1,2020,
2,43852,28,0,28,3,1,2020,
3,43852,57,20,77,3,1,2020,
4,43852,74,0,74,3,1,2020,
5,43852,123,0,123,3,1,2020,
6,43852,269,0,269,3,1,2020,
7,43852,165,266,431,3,1,2020,
8,43852,126,343,469,3,1,2020,
9,43852,125,245,370,3,1,2020,
10,43852,108,213,321,3,1,2020,
11,43852,148,200,348,3,1,2020,
12,43852,100,297,397,3,1,2020,
13,43852,82,128,210,3,1,2020,
14,43852,126,52,178,3,1,2020,
15,43852,86,356,442,3,1,2020,
16,43852,97,163,260,3,1,2020,
17,43852,112,226,338,3,1,2020,
18,43852,16,65,81,3,1,2020,
19,43852,43,363,406,3,1,2020,
20,43852,149,134,283,3,1,2020,
21,43852,254,195,449,3,1,2020,
22,43852,200,136,336,3,1,2020,
23,43852,211,237,448,3,1,2020,
0,43853,123,186,309,4,1,2020,
1,43853,45,26,71,4,1,2020,
2,43853,79,0,79,4,1,2020,
3,43853,79,0,79,4,1,2020,
4,43853,230,0,230,4,1,2020,
5,43853,199,1,200,4,1,2020,
6,43853,282,74,356,4,1,2020,
7,43853,256,322,578,4,1,2020,
8,43853,206,241,447,4,1,2020,
9,43853,169,231,400,4,1,2020,
10,43853,134,316,450,4,1,2020,
11,43853,171,222,393,4,1,2020,
12,43853,100,36,136,4,1,2020,
13,43853,105,230,335,4,1,2020,
14,43853,103,133,236,4,1,2020,
15,43853,129,337,466,4,1,2020,
16,43853,131,44,175,4,1,2020,
17,43853,145,203,348,4,1,2020,
18,43853,67,150,217,4,1,2020,
19,43853,66,442,508,4,1,2020,
20,43853,125,146,271,4,1,2020,
21,43853,350,230,580,4,1,2020,
22,43853,294,179,473,4,1,2020,
23,43853,253,140,393,4,1,2020,
0,43854,113,211,324,5,1,2020,
1,43854,67,63,130,5,1,2020,
2,43854,78,21,99,5,1,2020,
3,43854,125,0,125,5,1,2020,
4,43854,137,0,137,5,1,2020,
5,43854,240,2,242,5,1,2020,
6,43854,428,89,517,5,1,2020,
7,43854,296,186,482,5,1,2020,
8,43854,230,377,607,5,1,2020,
9,43854,192,254,446,5,1,2020,
10,43854,123,215,338,5,1,2020,
11,43854,195,144,339,5,1,2020,
12,43854,116,150,266,5,1,2020,
13,43854,95,71,166,5,1,2020,
14,43854,142,240,382,5,1,2020,
15,43854,149,256,405,5,1,2020,
16,43854,87,223,310,5,1,2020,
17,43854,126,199,325,5,1,2020,
18,43854,102,53,155,5,1,2020,
19,43854,74,315,389,5,1,2020,
20,43854,141,13,154,5,1,2020,
21,43854,217,0,217,5,1,2020,
22,43854,142,3,145,5,1,2020,
23,43854,115,9,124,5,1,2020,
0,43855,35,5,40,6,1,2020,
1,43855,16,0,16,6,1,2020,
2,43855,45,9,54,6,1,2020,
3,43855,116,2,118,6,1,2020,
4,43855,101,0,101,6,1,2020,
5,43855,159,1,160,6,1,2020,
6,43855,311,5,316,6,1,2020,
7,43855,273,0,273,6,1,2020,
8,43855,242,9,251,6,1,2020,
9,43855,206,4,210,6,1,2020,
10,43855,241,36,277,6,1,2020,
11,43855,107,147,254,6,1,2020,
12,43855,115,368,483,6,1,2020,
13,43855,104,315,419,6,1,2020,
14,43855,118,352,470,6,1,2020,
15,43855,145,505,650,6,1,2020,
16,43855,123,227,350,6,1,2020,
17,43855,91,104,195,6,1,2020,
18,43855,73,194,267,6,1,2020,
19,43855,87,268,355,6,1,2020,
20,43855,151,244,395,6,1,2020,
21,43855,231,323,554,6,1,2020,
22,43855,174,542,716,6,1,2020,
23,43855,166,22,188,6,1,2020,
0,43856,68,124,192,7,1,2020,
1,43856,29,14,43,7,1,2020,
2,43856,47,52,99,7,1,2020,
3,43856,73,57,130,7,1,2020,
4,43856,87,22,109,7,1,2020,
5,43856,135,5,140,7,1,2020,
6,43856,301,0,301,7,1,2020,
7,43856,218,32,250,7,1,2020,
8,43856,159,303,462,7,1,2020,
9,43856,200,325,525,7,1,2020,
10,43856,153,328,481,7,1,2020,
11,43856,135,506,641,7,1,2020,
12,43856,111,394,505,7,1,2020,
13,43856,182,75,257,7,1,2020,
14,43856,169,335,504,7,1,2020,
15,43856,138,301,439,7,1,2020,
16,43856,212,101,313,7,1,2020,
17,43856,161,289,450,7,1,2020,
18,43856,67,335,402,7,1,2020,
19,43856,53,430,483,7,1,2020,
20,43856,125,179,304,7,1,2020,
21,43856,207,186,393,7,1,2020,
22,43856,117,163,280,7,1,2020,
23,43856,133,292,425,7,1,2020,
0,43857,43,380,423,1,1,2020,
1,43857,34,430,464,1,1,2020,
2,43857,4,45,49,1,1,2020,
3,43857,28,52,80,1,1,2020,
4,43857,70,0,70,1,1,2020,
5,43857,86,49,135,1,1,2020,
6,43857,218,53,271,1,1,2020,
7,43857,175,296,471,1,1,2020,
8,43857,151,430,581,1,1,2020,
9,43857,114,314,428,1,1,2020,
10,43857,102,194,296,1,1,2020,
11,43857,112,176,288,1,1,2020,
12,43857,95,78,173,1,1,2020,
13,43857,116,281,397,1,1,2020,
14,43857,170,90,260,1,1,2020,
15,43857,139,335,474,1,1,2020,
16,43857,72,336,408,1,1,2020,
17,43857,92,175,267,1,1,2020,
18,43857,38,146,184,1,1,2020,
19,43857,16,461,477,1,1,2020,
20,43857,87,246,333,1,1,2020,
21,43857,161,158,319,1,1,2020,
22,43857,185,194,379,1,1,2020,
23,43857,73,297,370,1,1,2020,
0,43858,42,316,358,2,1,2020,
1,43858,45,106,151,2,1,2020,
2,43858,33,5,38,2,1,2020,
3,43858,33,1,34,2,1,2020,
4,43858,60,0,60,2,1,2020,
5,43858,102,0,102,2,1,2020,
6,43858,252,66,318,2,1,2020,
7,43858,209,251,460,2,1,2020,
8,43858,121,336,457,2,1,2020,
9,43858,95,257,352,2,1,2020,
10,43858,75,106,181,2,1,2020,
11,43858,68,138,206,2,1,2020,
12,43858,120,118,238,2,1,2020,
13,43858,121,291,412,2,1,2020,
14,43858,85,199,284,2,1,2020,
15,43858,91,317,408,2,1,2020,
16,43858,101,233,334,2,1,2020,
17,43858,39,241,280,2,1,2020,
18,43858,20,46,66,2,1,2020,
19,43858,40,285,325,2,1,2020,
20,43858,141,23,164,2,1,2020,
21,43858,214,149,363,2,1,2020,
22,43858,219,282,501,2,1,2020,
23,43858,169,281,450,2,1,2020,
0,43859,112,139,251,3,1,2020,
1,43859,18,76,94,3,1,2020,
2,43859,23,0,23,3,1,2020,
3,43859,42,0,42,3,1,2020,
4,43859,85,0,85,3,1,2020,
5,43859,115,0,115,3,1,2020,
6,43859,253,0,253,3,1,2020,
7,43859,185,145,330,3,1,2020,
8,43859,132,370,502,3,1,2020,
9,43859,94,367,461,3,1,2020,
10,43859,137,295,432,3,1,2020,
11,43859,122,225,347,3,1,2020,
12,43859,96,213,309,3,1,2020,
13,43859,127,187,314,3,1,2020,
14,43859,103,89,192,3,1,2020,
15,43859,107,385,492,3,1,2020,
16,43859,101,211,312,3,1,2020,
17,43859,104,181,285,3,1,2020,
18,43859,71,98,169,3,1,2020,
19,43859,56,357,413,3,1,2020,
20,43859,92,155,247,3,1,2020,
21,43859,263,204,467,3,1,2020,
22,43859,242,131,373,3,1,2020,
23,43859,172,103,275,3,1,2020,
0,43860,50,197,247,4,1,2020,
1,43860,33,8,41,4,1,2020,
2,43860,50,0,50,4,1,2020,
3,43860,119,41,160,4,1,2020,
4,43860,174,0,174,4,1,2020,
5,43860,257,0,257,4,1,2020,
6,43860,260,101,361,4,1,2020,
7,43860,248,316,564,4,1,2020,
8,43860,269,383,652,4,1,2020,
9,43860,169,448,617,4,1,2020,
10,43860,148,115,263,4,1,2020,
11,43860,163,330,493,4,1,2020,
12,43860,102,275,377,4,1,2020,
13,43860,124,300,424,4,1,2020,
14,43860,171,155,326,4,1,2020,
15,43860,140,144,284,4,1,2020,
16,43860,156,41,197,4,1,2020,
17,43860,123,474,597,4,1,2020,
18,43860,70,402,472,4,1,2020,
19,43860,59,469,528,4,1,2020,
20,43860,152,171,323,4,1,2020,
21,43860,301,299,600,4,1,2020,
22,43860,300,253,553,4,1,2020,
23,43860,243,369,612,4,1,2020,
0,43861,128,352,480,5,1,2020,
1,43861,58,67,125,5,1,2020,
2,43861,56,34,90,5,1,2020,
3,43861,117,0,117,5,1,2020,
4,43861,124,0,124,5,1,2020,
5,43861,233,1,234,5,1,2020,
6,43861,352,100,452,5,1,2020,
7,43861,185,348,533,5,1,2020,
8,43861,166,463,629,5,1,2020,
9,43861,239,339,578,5,1,2020,
10,43861,97,338,435,5,1,2020,
11,43861,96,257,353,5,1,2020,
12,43861,80,261,341,5,1,2020,
13,43861,135,198,333,5,1,2020,
14,43861,125,220,345,5,1,2020,
15,43861,77,370,447,5,1,2020,
16,43861,93,137,230,5,1,2020,
17,43861,111,322,433,5,1,2020,
18,43861,72,172,244,5,1,2020,
19,43861,44,438,482,5,1,2020,
20,43861,148,164,312,5,1,2020,
21,43861,271,235,506,5,1,2020,
22,43861,274,339,613,5,1,2020,
23,43861,245,301,546,5,1,2020,
0,43862,79,175,254,6,2,2020,
1,43862,21,183,204,6,2,2020,
2,43862,6,20,26,6,2,2020,
3,43862,58,1,59,6,2,2020,
4,43862,113,2,115,6,2,2020,
5,43862,164,6,170,6,2,2020,
6,43862,318,1,319,6,2,2020,
7,43862,303,317,620,6,2,2020,
8,43862,140,447,587,6,2,2020,
9,43862,165,268,433,6,2,2020,
10,43862,140,271,411,6,2,2020,
11,43862,84,257,341,6,2,2020,
12,43862,95,137,232,6,2,2020,
13,43862,118,261,379,6,2,2020,
14,43862,138,350,488,6,2,2020,
15,43862,132,256,388,6,2,2020,
16,43862,56,170,226,6,2,2020,
17,43862,43,340,383,6,2,2020,
18,43862,48,182,230,6,2,2020,
19,43862,56,399,455,6,2,2020,
20,43862,96,297,393,6,2,2020,
21,43862,193,53,246,6,2,2020,
22,43862,186,394,580,6,2,2020,
23,43862,134,227,361,6,2,2020,
0,43863,70,86,156,7,2,2020,
1,43863,22,62,84,7,2,2020,
2,43863,55,0,55,7,2,2020,
3,43863,69,0,69,7,2,2020,
4,43863,82,0,82,7,2,2020,
5,43863,126,0,126,7,2,2020,
6,43863,253,64,317,7,2,2020,
7,43863,232,320,552,7,2,2020,
8,43863,88,498,586,7,2,2020,
9,43863,100,296,396,7,2,2020,
10,43863,118,250,368,7,2,2020,
11,43863,98,199,297,7,2,2020,
12,43863,110,346,456,7,2,2020,
13,43863,105,8,113,7,2,2020,
14,43863,157,196,353,7,2,2020,
15,43863,159,335,494,7,2,2020,
16,43863,153,212,365,7,2,2020,
17,43863,82,323,405,7,2,2020,
18,43863,46,420,466,7,2,2020,
19,43863,70,403,473,7,2,2020,
20,43863,107,154,261,7,2,2020,
21,43863,143,99,242,7,2,2020,
22,43863,186,212,398,7,2,2020,
23,43863,138,424,562,7,2,2020,
0,43864,56,178,234,1,2,2020,
1,43864,45,99,144,1,2,2020,
2,43864,21,0,21,1,2,2020,
3,43864,38,0,38,1,2,2020,
4,43864,89,0,89,1,2,2020,
5,43864,150,0,150,1,2,2020,
6,43864,323,80,403,1,2,2020,
7,43864,342,400,742,1,2,2020,
8,43864,204,368,572,1,2,2020,
9,43864,261,87,348,1,2,2020,
10,43864,167,160,327,1,2,2020,
11,43864,209,277,486,1,2,2020,
12,43864,156,64,220,1,2,2020,
13,43864,300,193,493,1,2,2020,
14,43864,288,221,509,1,2,2020,
15,43864,300,182,482,1,2,2020,
16,43864,353,116,469,1,2,2020,
17,43864,284,181,465,1,2,2020,
18,43864,102,274,376,1,2,2020,
19,43864,76,339,415,1,2,2020,
20,43864,191,105,296,1,2,2020,
21,43864,267,97,364,1,2,2020,
22,43864,264,138,402,1,2,2020,
23,43864,114,208,322,1,2,2020,
0,43865,74,186,260,2,2,2020,
1,43865,17,77,94,2,2,2020,
2,43865,13,80,93,2,2,2020,
3,43865,59,0,59,2,2,2020,
4,43865,87,0,87,2,2,2020,
5,43865,182,0,182,2,2,2020,
6,43865,375,61,436,2,2,2020,
7,43865,314,330,644,2,2,2020,
8,43865,244,184,428,2,2,2020,
9,43865,215,201,416,2,2,2020,
10,43865,134,123,257,2,2,2020,
11,43865,111,226,337,2,2,2020,
12,43865,146,185,331,2,2,2020,
13,43865,237,112,349,2,2,2020,
14,43865,198,191,389,2,2,2020,
15,43865,191,240,431,2,2,2020,
16,43865,249,180,429,2,2,2020,
17,43865,100,223,323,2,2,2020,
18,43865,54,102,156,2,2,2020,
19,43865,34,212,246,2,2,2020,
20,43865,167,97,264,2,2,2020,
21,43865,198,118,316,2,2,2020,
22,43865,178,233,411,2,2,2020,
23,43865,163,232,395,2,2,2020,
0,43866,76,208,284,3,2,2020,
1,43866,16,77,93,3,2,2020,
2,43866,28,12,40,3,2,2020,
3,43866,61,0,61,3,2,2020,
4,43866,85,0,85,3,2,2020,
5,43866,88,0,88,3,2,2020,
6,43866,297,1,298,3,2,2020,
7,43866,201,248,449,3,2,2020,
8,43866,165,196,361,3,2,2020,
9,43866,145,363,508,3,2,2020,
10,43866,145,235,380,3,2,2020,
11,43866,137,217,354,3,2,2020,
12,43866,158,167,325,3,2,2020,
13,43866,122,147,269,3,2,2020,
14,43866,109,56,165,3,2,2020,
15,43866,152,240,392,3,2,2020,
16,43866,141,159,300,3,2,2020,
17,43866,169,97,266,3,2,2020,
18,43866,47,54,101,3,2,2020,
19,43866,26,229,255,3,2,2020,
20,43866,112,146,258,3,2,2020,
21,43866,223,140,363,3,2,2020,
22,43866,251,146,397,3,2,2020,
23,43866,121,126,247,3,2,2020,
0,43867,77,126,203,4,2,2020,
1,43867,27,49,76,4,2,2020,
2,43867,45,0,45,4,2,2020,
3,43867,111,32,143,4,2,2020,
4,43867,224,4,228,4,2,2020,
5,43867,275,0,275,4,2,2020,
6,43867,275,55,330,4,2,2020,
7,43867,341,127,468,4,2,2020,
8,43867,219,430,649,4,2,2020,
9,43867,184,235,419,4,2,2020,
10,43867,103,56,159,4,2,2020,
11,43867,199,242,441,4,2,2020,
12,43867,91,177,268,4,2,2020,
13,43867,113,189,302,4,2,2020,
14,43867,152,103,255,4,2,2020,
15,43867,144,229,373,4,2,2020,
16,43867,178,107,285,4,2,2020,
17,43867,123,153,276,4,2,2020,
18,43867,77,144,221,4,2,2020,
19,43867,39,376,415,4,2,2020,
20,43867,131,183,314,4,2,2020,
21,43867,317,116,433,4,2,2020,
22,43867,363,90,453,4,2,2020,
23,43867,209,197,406,4,2,2020,
0,43868,132,162,294,5,2,2020,
1,43868,52,40,92,5,2,2020,
2,43868,60,0,60,5,2,2020,
3,43868,110,0,110,5,2,2020,
4,43868,117,1,118,5,2,2020,
5,43868,224,0,224,5,2,2020,
6,43868,346,71,417,5,2,2020,
7,43868,350,264,614,5,2,2020,
8,43868,191,341,532,5,2,2020,
9,43868,162,236,398,5,2,2020,
10,43868,162,158,320,5,2,2020,
11,43868,125,154,279,5,2,2020,
12,43868,144,171,315,5,2,2020,
13,43868,158,200,358,5,2,2020,
14,43868,173,113,286,5,2,2020,
15,43868,84,259,343,5,2,2020,
16,43868,99,254,353,5,2,2020,
17,43868,129,154,283,5,2,2020,
18,43868,78,57,135,5,2,2020,
19,43868,70,325,395,5,2,2020,
20,43868,124,208,332,5,2,2020,
21,43868,291,178,469,5,2,2020,
22,43868,328,169,497,5,2,2020,
23,43868,250,179,429,5,2,2020,
0,43869,130,164,294,6,2,2020,
1,43869,63,15,78,6,2,2020,
2,43869,41,1,42,6,2,2020,
3,43869,92,0,92,6,2,2020,
4,43869,91,0,91,6,2,2020,
5,43869,187,1,188,6,2,2020,
6,43869,356,0,356,6,2,2020,
7,43869,362,317,679,6,2,2020,
8,43869,319,455,774,6,2,2020,
9,43869,219,474,693,6,2,2020,
10,43869,160,175,335,6,2,2020,
11,43869,94,173,267,6,2,2020,
12,43869,87,279,366,6,2,2020,
13,43869,161,111,272,6,2,2020,
14,43869,173,368,541,6,2,2020,
15,43869,149,282,431,6,2,2020,
16,43869,159,216,375,6,2,2020,
17,43869,119,121,240,6,2,2020,
18,43869,64,173,237,6,2,2020,
19,43869,57,360,417,6,2,2020,
20,43869,111,183,294,6,2,2020,
21,43869,181,160,341,6,2,2020,
22,43869,177,269,446,6,2,2020,
23,43869,131,258,389,6,2,2020,
0,43870,60,66,126,7,2,2020,
1,43870,43,0,43,7,2,2020,
2,43870,24,0,24,7,2,2020,
3,43870,87,0,87,7,2,2020,
4,43870,100,0,100,7,2,2020,
5,43870,170,0,170,7,2,2020,
6,43870,329,79,408,7,2,2020,
7,43870,253,361,614,7,2,2020,
8,43870,200,467,667,7,2,2020,
9,43870,149,213,362,7,2,2020,
10,43870,161,205,366,7,2,2020,
11,43870,141,258,399,7,2,2020,
12,43870,139,269,408,7,2,2020,
13,43870,184,210,394,7,2,2020,
14,43870,230,185,415,7,2,2020,
15,43870,165,224,389,7,2,2020,
16,43870,215,313,528,7,2,2020,
17,43870,145,188,333,7,2,2020,
18,43870,50,341,391,7,2,2020,
19,43870,47,543,590,7,2,2020,
20,43870,134,101,235,7,2,2020,
21,43870,174,62,236,7,2,2020,
22,43870,200,299,499,7,2,2020,
23,43870,88,381,469,7,2,2020,
0,43871,79,173,252,1,2,2020,
1,43871,29,109,138,1,2,2020,
2,43871,5,0,5,1,2,2020,
3,43871,36,0,36,1,2,2020,
4,43871,73,0,73,1,2,2020,
5,43871,110,1,111,1,2,2020,
6,43871,233,74,307,1,2,2020,
7,43871,188,345,533,1,2,2020,
8,43871,141,353,494,1,2,2020,
9,43871,101,301,402,1,2,2020,
10,43871,90,163,253,1,2,2020,
11,43871,81,168,249,1,2,2020,
12,43871,92,209,301,1,2,2020,
13,43871,148,128,276,1,2,2020,
14,43871,176,159,335,1,2,2020,
15,43871,102,420,522,1,2,2020,
16,43871,144,160,304,1,2,2020,
17,43871,124,209,333,1,2,2020,
18,43871,32,218,250,1,2,2020,
19,43871,40,391,431,1,2,2020,
20,43871,85,146,231,1,2,2020,
21,43871,124,185,309,1,2,2020,
22,43871,118,232,350,1,2,2020,
23,43871,69,218,287,1,2,2020,
0,43872,16,278,294,2,2,2020,
1,43872,17,30,47,2,2,2020,
2,43872,50,0,50,2,2,2020,
3,43872,53,0,53,2,2,2020,
4,43872,74,1,75,2,2,2020,
5,43872,128,0,128,2,2,2020,
6,43872,240,62,302,2,2,2020,
7,43872,217,334,551,2,2,2020,
8,43872,153,163,316,2,2,2020,
9,43872,65,188,253,2,2,2020,
10,43872,70,58,128,2,2,2020,
11,43872,71,168,239,2,2,2020,
12,43872,135,234,369,2,2,2020,
13,43872,107,85,192,2,2,2020,
14,43872,101,237,338,2,2,2020,
15,43872,81,291,372,2,2,2020,
16,43872,63,121,184,2,2,2020,
17,43872,98,174,272,2,2,2020,
18,43872,23,109,132,2,2,2020,
19,43872,41,174,215,2,2,2020,
20,43872,132,45,177,2,2,2020,
21,43872,261,193,454,2,2,2020,
22,43872,251,226,477,2,2,2020,
23,43872,239,200,439,2,2,2020,
0,43873,113,96,209,3,2,2020,
1,43873,57,32,89,3,2,2020,
2,43873,7,0,7,3,2,2020,
3,43873,0,0,0,3,2,2020,
4,43873,57,2,59,3,2,2020,
5,43873,169,0,169,3,2,2020,
6,43873,570,0,570,3,2,2020,
7,43873,257,224,481,3,2,2020,
8,43873,165,189,354,3,2,2020,
9,43873,145,227,372,3,2,2020,
10,43873,150,286,436,3,2,2020,
11,43873,217,191,408,3,2,2020,
12,43873,143,148,291,3,2,2020,
13,43873,97,177,274,3,2,2020,
14,43873,143,129,272,3,2,2020,
15,43873,122,174,296,3,2,2020,
16,43873,127,289,416,3,2,2020,
17,43873,102,102,204,3,2,2020,
18,43873,63,106,169,3,2,2020,
19,43873,41,258,299,3,2,2020,
20,43873,160,80,240,3,2,2020,
21,43873,327,142,469,3,2,2020,
22,43873,289,119,408,3,2,2020,
23,43873,200,181,381,3,2,2020,
0,43874,161,62,223,4,2,2020,
1,43874,54,0,54,4,2,2020,
2,43874,64,0,64,4,2,2020,
3,43874,187,0,187,4,2,2020,
4,43874,314,1,315,4,2,2020,
5,43874,367,0,367,4,2,2020,
6,43874,492,74,566,4,2,2020,
7,43874,388,345,733,4,2,2020,
8,43874,273,236,509,4,2,2020,
9,43874,197,187,384,4,2,2020,
10,43874,205,145,350,4,2,2020,
11,43874,252,226,478,4,2,2020,
12,43874,203,142,345,4,2,2020,
13,43874,170,162,332,4,2,2020,
14,43874,171,264,435,4,2,2020,
15,43874,249,143,392,4,2,2020,
16,43874,247,109,356,4,2,2020,
17,43874,201,116,317,4,2,2020,
18,43874,124,202,326,4,2,2020,
19,43874,52,454,506,4,2,2020,
20,43874,179,90,269,4,2,2020,
21,43874,436,81,517,4,2,2020,
22,43874,451,65,516,4,2,2020,
23,43874,345,260,605,4,2,2020,
0,43875,261,124,385,5,2,2020,
1,43875,104,22,126,5,2,2020,
2,43875,63,1,64,5,2,2020,
3,43875,208,0,208,5,2,2020,
4,43875,293,0,293,5,2,2020,
5,43875,284,0,284,5,2,2020,
6,43875,471,69,540,5,2,2020,
7,43875,567,189,756,5,2,2020,
8,43875,261,319,580,5,2,2020,
9,43875,338,281,619,5,2,2020,
10,43875,244,146,390,5,2,2020,
11,43875,215,132,347,5,2,2020,
12,43875,165,132,297,5,2,2020,
13,43875,236,188,424,5,2,2020,
14,43875,251,136,387,5,2,2020,
15,43875,154,200,354,5,2,2020,
16,43875,168,146,314,5,2,2020,
17,43875,186,90,276,5,2,2020,
18,43875,139,202,341,5,2,2020,
19,43875,39,222,261,5,2,2020,
20,43875,175,174,349,5,2,2020,
21,43875,306,178,484,5,2,2020,
22,43875,465,164,629,5,2,2020,
23,43875,365,119,484,5,2,2020,
0,43876,272,206,478,6,2,2020,
1,43876,101,39,140,6,2,2020,
2,43876,35,46,81,6,2,2020,
3,43876,158,0,158,6,2,2020,
4,43876,222,0,222,6,2,2020,
5,43876,216,0,216,6,2,2020,
6,43876,465,1,466,6,2,2020,
7,43876,554,250,804,6,2,2020,
8,43876,407,459,866,6,2,2020,
9,43876,330,321,651,6,2,2020,
10,43876,233,225,458,6,2,2020,
11,43876,227,255,482,6,2,2020,
12,43876,164,190,354,6,2,2020,
13,43876,192,186,378,6,2,2020,
14,43876,212,251,463,6,2,2020,
15,43876,224,169,393,6,2,2020,
16,43876,158,325,483,6,2,2020,
17,43876,123,202,325,6,2,2020,
18,43876,79,194,273,6,2,2020,
19,43876,51,356,407,6,2,2020,
20,43876,167,184,351,6,2,2020,
21,43876,285,56,341,6,2,2020,
22,43876,290,392,682,6,2,2020,
23,43876,179,282,461,6,2,2020,
0,43877,159,102,261,7,2,2020,
1,43877,46,0,46,7,2,2020,
2,43877,63,0,63,7,2,2020,
3,43877,136,0,136,7,2,2020,
4,43877,116,0,116,7,2,2020,
5,43877,165,0,165,7,2,2020,
6,43877,368,76,444,7,2,2020,
7,43877,287,297,584,7,2,2020,
8,43877,244,412,656,7,2,2020,
9,43877,120,254,374,7,2,2020,
10,43877,155,215,370,7,2,2020,
11,43877,215,209,424,7,2,2020,
12,43877,159,326,485,7,2,2020,
13,43877,217,170,387,7,2,2020,
14,43877,193,192,385,7,2,2020,
15,43877,151,404,555,7,2,2020,
16,43877,185,121,306,7,2,2020,
17,43877,176,268,444,7,2,2020,
18,43877,54,391,445,7,2,2020,
19,43877,53,391,444,7,2,2020,
20,43877,140,165,305,7,2,2020,
21,43877,162,110,272,7,2,2020,
22,43877,222,125,347,7,2,2020,
23,43877,160,362,522,7,2,2020,
0,43878,93,6,99,1,2,2020,
1,43878,64,4,68,1,2,2020,
2,43878,20,0,20,1,2,2020,
3,43878,40,0,40,1,2,2020,
4,43878,77,0,77,1,2,2020,
5,43878,132,0,132,1,2,2020,
6,43878,247,0,247,1,2,2020,
7,43878,235,0,235,1,2,2020,
8,43878,193,208,401,1,2,2020,
9,43878,165,634,799,1,2,2020,
10,43878,142,443,585,1,2,2020,
11,43878,155,395,550,1,2,2020,
12,43878,66,351,417,1,2,2020,
13,43878,157,191,348,1,2,2020,
14,43878,152,114,266,1,2,2020,
15,43878,151,269,420,1,2,2020,
16,43878,168,498,666,1,2,2020,
17,43878,111,170,281,1,2,2020,
18,43878,37,472,509,1,2,2020,
19,43878,24,708,732,1,2,2020,
20,43878,78,302,380,1,2,2020,
21,43878,174,46,220,1,2,2020,
22,43878,152,305,457,1,2,2020,
23,43878,104,311,415,1,2,2020,
0,43879,65,864,929,2,2,2020,
1,43879,10,430,440,2,2,2020,
2,43879,25,234,259,2,2,2020,
3,43879,67,1,68,2,2,2020,
4,43879,89,0,89,2,2,2020,
5,43879,159,0,159,2,2,2020,
6,43879,227,84,311,2,2,2020,
7,43879,250,198,448,2,2,2020,
8,43879,148,518,666,2,2,2020,
9,43879,137,439,576,2,2,2020,
10,43879,117,179,296,2,2,2020,
11,43879,70,144,214,2,2,2020,
12,43879,79,131,210,2,2,2020,
13,43879,136,340,476,2,2,2020,
14,43879,75,259,334,2,2,2020,
15,43879,120,165,285,2,2,2020,
16,43879,97,479,576,2,2,2020,
17,43879,78,162,240,2,2,2020,
18,43879,25,196,221,2,2,2020,
19,43879,32,358,390,2,2,2020,
20,43879,147,96,243,2,2,2020,
21,43879,251,211,462,2,2,2020,
22,43879,244,441,685,2,2,2020,
23,43879,208,305,513,2,2,2020,
0,43880,101,263,364,3,2,2020,
1,43880,39,55,94,3,2,2020,
2,43880,61,0,61,3,2,2020,
3,43880,138,0,138,3,2,2020,
4,43880,103,0,103,3,2,2020,
5,43880,162,0,162,3,2,2020,
6,43880,403,0,403,3,2,2020,
7,43880,248,225,473,3,2,2020,
8,43880,185,438,623,3,2,2020,
9,43880,216,241,457,3,2,2020,
10,43880,193,334,527,3,2,2020,
11,43880,161,195,356,3,2,2020,
12,43880,100,211,311,3,2,2020,
13,43880,122,144,266,3,2,2020,
14,43880,124,175,299,3,2,2020,
15,43880,118,179,297,3,2,2020,
16,43880,80,438,518,3,2,2020,
17,43880,103,164,267,3,2,2020,
18,43880,49,198,247,3,2,2020,
19,43880,26,378,404,3,2,2020,
20,43880,116,80,196,3,2,2020,
21,43880,234,52,286,3,2,2020,
22,43880,364,212,576,3,2,2020,
23,43880,184,250,434,3,2,2020,
0,43881,123,99,222,4,2,2020,
1,43881,60,58,118,4,2,2020,
2,43881,43,4,47,4,2,2020,
3,43881,152,0,152,4,2,2020,
4,43881,285,3,288,4,2,2020,
5,43881,406,0,406,4,2,2020,
6,43881,399,65,464,4,2,2020,
7,43881,334,392,726,4,2,2020,
8,43881,216,250,466,4,2,2020,
9,43881,118,245,363,4,2,2020,
10,43881,208,67,275,4,2,2020,
11,43881,238,227,465,4,2,2020,
12,43881,136,167,303,4,2,2020,
13,43881,164,119,283,4,2,2020,
14,43881,184,281,465,4,2,2020,
15,43881,154,276,430,4,2,2020,
16,43881,150,117,267,4,2,2020,
17,43881,194,135,329,4,2,2020,
18,43881,108,178,286,4,2,2020,
19,43881,41,389,430,4,2,2020,
20,43881,139,156,295,4,2,2020,
21,43881,360,181,541,4,2,2020,
22,43881,370,147,517,4,2,2020,
23,43881,268,188,456,4,2,2020,
0,43882,214,148,362,5,2,2020,
1,43882,105,0,105,5,2,2020,
2,43882,83,0,83,5,2,2020,
3,43882,173,0,173,5,2,2020,
4,43882,178,0,178,5,2,2020,
5,43882,254,0,254,5,2,2020,
6,43882,406,76,482,5,2,2020,
7,43882,350,218,568,5,2,2020,
8,43882,226,372,598,5,2,2020,
9,43882,190,158,348,5,2,2020,
10,43882,187,241,428,5,2,2020,
11,43882,235,200,435,5,2,2020,
12,43882,105,211,316,5,2,2020,
13,43882,210,96,306,5,2,2020,
14,43882,152,102,254,5,2,2020,
15,43882,107,307,414,5,2,2020,
16,43882,120,238,358,5,2,2020,
17,43882,166,295,461,5,2,2020,
18,43882,89,127,216,5,2,2020,
19,43882,64,333,397,5,2,2020,
20,43882,128,37,165,5,2,2020,
21,43882,380,249,629,5,2,2020,
22,43882,352,172,524,5,2,2020,
23,43882,194,215,409,5,2,2020,
0,43883,180,334,514,6,2,2020,
1,43883,61,73,134,6,2,2020,
2,43883,57,0,57,6,2,2020,
3,43883,96,0,96,6,2,2020,
4,43883,125,0,125,6,2,2020,
5,43883,195,0,195,6,2,2020,
6,43883,423,1,424,6,2,2020,
7,43883,404,297,701,6,2,2020,
8,43883,269,524,793,6,2,2020,
9,43883,228,384,612,6,2,2020,
10,43883,156,225,381,6,2,2020,
11,43883,122,212,334,6,2,2020,
12,43883,109,279,388,6,2,2020,
13,43883,138,135,273,6,2,2020,
14,43883,178,438,616,6,2,2020,
15,43883,162,348,510,6,2,2020,
16,43883,107,249,356,6,2,2020,
17,43883,70,359,429,6,2,2020,
18,43883,56,177,233,6,2,2020,
19,43883,63,363,426,6,2,2020,
20,43883,100,369,469,6,2,2020,
21,43883,157,109,266,6,2,2020,
22,43883,174,336,510,6,2,2020,
23,43883,118,318,436,6,2,2020,
0,43884,66,162,228,7,2,2020,
1,43884,27,4,31,7,2,2020,
2,43884,35,0,35,7,2,2020,
3,43884,97,0,97,7,2,2020,
4,43884,105,0,105,7,2,2020,
5,43884,163,1,164,7,2,2020,
6,43884,280,79,359,7,2,2020,
7,43884,251,231,482,7,2,2020,
8,43884,98,575,673,7,2,2020,
9,43884,113,263,376,7,2,2020,
10,43884,137,186,323,7,2,2020,
11,43884,139,185,324,7,2,2020,
12,43884,102,310,412,7,2,2020,
13,43884,177,238,415,7,2,2020,
14,43884,227,131,358,7,2,2020,
15,43884,143,387,530,7,2,2020,
16,43884,217,360,577,7,2,2020,
17,43884,169,250,419,7,2,2020,
18,43884,52,379,431,7,2,2020,
19,43884,32,493,525,7,2,2020,
20,43884,103,165,268,7,2,2020,
21,43884,160,216,376,7,2,2020,
22,43884,198,110,308,7,2,2020,
23,43884,87,485,572,7,2,2020,
0,43885,60,431,491,1,2,2020,
1,43885,14,183,197,1,2,2020,
2,43885,12,32,44,1,2,2020,
3,43885,26,1,27,1,2,2020,
4,43885,62,0,62,1,2,2020,
5,43885,92,0,92,1,2,2020,
6,43885,223,63,286,1,2,2020,
7,43885,189,405,594,1,2,2020,
8,43885,91,405,496,1,2,2020,
9,43885,131,187,318,1,2,2020,
10,43885,83,318,401,1,2,2020,
11,43885,121,204,325,1,2,2020,
12,43885,109,157,266,1,2,2020,
13,43885,73,159,232,1,2,2020,
14,43885,169,223,392,1,2,2020,
15,43885,123,351,474,1,2,2020,
16,43885,95,258,353,1,2,2020,
17,43885,112,205,317,1,2,2020,
18,43885,42,266,308,1,2,2020,
19,43885,39,521,560,1,2,2020,
20,43885,79,99,178,1,2,2020,
21,43885,104,165,269,1,2,2020,
22,43885,112,122,234,1,2,2020,
23,43885,72,386,458,1,2,2020,
0,43886,36,339,375,2,2,2020,
1,43886,24,53,77,2,2,2020,
2,43886,42,5,47,2,2,2020,
3,43886,59,0,59,2,2,2020,
4,43886,34,0,34,2,2,2020,
5,43886,78,0,78,2,2,2020,
6,43886,234,60,294,2,2,2020,
7,43886,241,329,570,2,2,2020,
8,43886,173,285,458,2,2,2020,
9,43886,75,275,350,2,2,2020,
10,43886,83,116,199,2,2,2020,
11,43886,84,140,224,2,2,2020,
12,43886,84,228,312,2,2,2020,
13,43886,112,118,230,2,2,2020,
14,43886,114,253,367,2,2,2020,
15,43886,80,211,291,2,2,2020,
16,43886,83,175,258,2,2,2020,
17,43886,59,161,220,2,2,2020,
18,43886,42,186,228,2,2,2020,
19,43886,24,238,262,2,2,2020,
20,43886,99,133,232,2,2,2020,
21,43886,265,156,421,2,2,2020,
22,43886,235,256,491,2,2,2020,
23,43886,141,123,264,2,2,2020,
0,43887,71,289,360,3,2,2020,
1,43887,11,40,51,3,2,2020,
2,43887,31,0,31,3,2,2020,
3,43887,24,0,24,3,2,2020,
4,43887,53,0,53,3,2,2020,
5,43887,122,1,123,3,2,2020,
6,43887,266,0,266,3,2,2020,
7,43887,170,181,351,3,2,2020,
8,43887,125,327,452,3,2,2020,
9,43887,155,276,431,3,2,2020,
10,43887,157,239,396,3,2,2020,
11,43887,167,259,426,3,2,2020,
12,43887,127,123,250,3,2,2020,
13,43887,128,279,407,3,2,2020,
14,43887,112,62,174,3,2,2020,
15,43887,66,231,297,3,2,2020,
16,43887,68,294,362,3,2,2020,
17,43887,73,241,314,3,2,2020,
18,43887,29,112,141,3,2,2020,
19,43887,27,399,426,3,2,2020,
20,43887,118,149,267,3,2,2020,
21,43887,247,121,368,3,2,2020,
22,43887,220,209,429,3,2,2020,
23,43887,173,225,398,3,2,2020,
0,43888,108,255,363,4,2,2020,
1,43888,54,0,54,4,2,2020,
2,43888,46,54,100,4,2,2020,
3,43888,96,3,99,4,2,2020,
4,43888,251,0,251,4,2,2020,
5,43888,267,0,267,4,2,2020,
6,43888,354,61,415,4,2,2020,
7,43888,242,198,440,4,2,2020,
8,43888,170,437,607,4,2,2020,
9,43888,179,284,463,4,2,2020,
10,43888,263,157,420,4,2,2020,
11,43888,190,275,465,4,2,2020,
12,43888,94,58,152,4,2,2020,
13,43888,147,253,400,4,2,2020,
14,43888,161,177,338,4,2,2020,
15,43888,124,191,315,4,2,2020,
16,43888,150,127,277,4,2,2020,
17,43888,116,185,301,4,2,2020,
18,43888,86,102,188,4,2,2020,
19,43888,43,285,328,4,2,2020,
20,43888,130,216,346,4,2,2020,
21,43888,283,182,465,4,2,2020,
22,43888,315,70,385,4,2,2020,
23,43888,262,262,524,4,2,2020,
0,43889,121,167,288,5,2,2020,
1,43889,71,63,134,5,2,2020,
2,43889,72,0,72,5,2,2020,
3,43889,129,0,129,5,2,2020,
4,43889,147,0,147,5,2,2020,
5,43889,199,0,199,5,2,2020,
6,43889,378,87,465,5,2,2020,
7,43889,305,241,546,5,2,2020,
8,43889,229,262,491,5,2,2020,
9,43889,227,306,533,5,2,2020,
10,43889,161,191,352,5,2,2020,
11,43889,173,275,448,5,2,2020,
12,43889,123,167,290,5,2,2020,
13,43889,113,223,336,5,2,2020,
14,43889,157,133,290,5,2,2020,
15,43889,89,209,298,5,2,2020,
16,43889,87,160,247,5,2,2020,
17,43889,96,111,207,5,2,2020,
18,43889,92,182,274,5,2,2020,
19,43889,50,360,410,5,2,2020,
20,43889,140,65,205,5,2,2020,
21,43889,324,178,502,5,2,2020,
22,43889,254,209,463,5,2,2020,
23,43889,180,231,411,5,2,2020,
0,43890,157,107,264,6,2,2020,
1,43890,25,10,35,6,2,2020,
2,43890,62,0,62,6,2,2020,
3,43890,87,0,87,6,2,2020,
4,43890,76,0,76,6,2,2020,
5,43890,161,0,161,6,2,2020,
6,43890,342,0,342,6,2,2020,
7,43890,423,185,608,6,2,2020,
8,43890,286,526,812,6,2,2020,
9,43890,211,270,481,6,2,2020,
10,43890,143,261,404,6,2,2020,
11,43890,94,223,317,6,2,2020,
12,43890,92,151,243,6,2,2020,
13,43890,134,221,355,6,2,2020,
14,43890,175,265,440,6,2,2020,
15,43890,117,320,437,6,2,2020,
16,43890,105,109,214,6,2,2020,
17,43890,69,252,321,6,2,2020,
18,43890,44,273,317,6,2,2020,
19,43890,33,319,352,6,2,2020,
20,43890,100,278,378,6,2,2020,
21,43890,202,220,422,6,2,2020,
22,43890,148,137,285,6,2,2020,
23,43890,128,369,497,6,2,2020,
0,43891,112,224,336,7,3,2020,
1,43891,33,37,70,7,3,2020,
2,43891,47,7,54,7,3,2020,
3,43891,105,0,105,7,3,2020,
4,43891,76,0,76,7,3,2020,
5,43891,143,0,143,7,3,2020,
6,43891,275,74,349,7,3,2020,
7,43891,232,216,448,7,3,2020,
8,43891,98,576,674,7,3,2020,
9,43891,91,295,386,7,3,2020,
10,43891,179,196,375,7,3,2020,
11,43891,168,217,385,7,3,2020,
12,43891,126,349,475,7,3,2020,
13,43891,181,272,453,7,3,2020,
14,43891,205,67,272,7,3,2020,
15,43891,158,261,419,7,3,2020,
16,43891,159,490,649,7,3,2020,
17,43891,139,193,332,7,3,2020,
18,43891,43,241,284,7,3,2020,
19,43891,43,546,589,7,3,2020,
20,43891,60,119,179,7,3,2020,
21,43891,153,198,351,7,3,2020,
22,43891,198,241,439,7,3,2020,
23,43891,125,470,595,7,3,2020,
0,43892,65,309,374,1,3,2020,
1,43892,22,49,71,1,3,2020,
2,43892,22,0,22,1,3,2020,
3,43892,43,38,81,1,3,2020,
4,43892,66,0,66,1,3,2020,
5,43892,117,0,117,1,3,2020,
6,43892,227,76,303,1,3,2020,
7,43892,202,316,518,1,3,2020,
8,43892,109,511,620,1,3,2020,
9,43892,104,119,223,1,3,2020,
10,43892,72,273,345,1,3,2020,
11,43892,82,202,284,1,3,2020,
12,43892,88,212,300,1,3,2020,
13,43892,92,90,182,1,3,2020,
14,43892,191,51,242,1,3,2020,
15,43892,141,499,640,1,3,2020,
16,43892,78,342,420,1,3,2020,
17,43892,76,191,267,1,3,2020,
18,43892,28,278,306,1,3,2020,
19,43892,15,450,465,1,3,2020,
20,43892,56,106,162,1,3,2020,
21,43892,113,134,247,1,3,2020,
22,43892,96,173,269,1,3,2020,
23,43892,69,269,338,1,3,2020,
0,43893,23,314,337,2,3,2020,
1,43893,19,27,46,2,3,2020,
2,43893,26,0,26,2,3,2020,
3,43893,47,0,47,2,3,2020,
4,43893,48,0,48,2,3,2020,
5,43893,95,0,95,2,3,2020,
6,43893,187,69,256,2,3,2020,
7,43893,176,310,486,2,3,2020,
8,43893,151,200,351,2,3,2020,
9,43893,97,170,267,2,3,2020,
10,43893,71,147,218,2,3,2020,
11,43893,58,203,261,2,3,2020,
12,43893,104,116,220,2,3,2020,
13,43893,114,129,243,2,3,2020,
14,43893,83,162,245,2,3,2020,
15,43893,94,284,378,2,3,2020,
16,43893,58,220,278,2,3,2020,
17,43893,48,150,198,2,3,2020,
18,43893,24,106,130,2,3,2020,
19,43893,24,220,244,2,3,2020,
20,43893,81,36,117,2,3,2020,
21,43893,205,158,363,2,3,2020,
22,43893,197,276,473,2,3,2020,
23,43893,126,244,370,2,3,2020,
0,43894,60,105,165,3,3,2020,
1,43894,23,24,47,3,3,2020,
2,43894,36,20,56,3,3,2020,
3,43894,63,64,127,3,3,2020,
4,43894,36,2,38,3,3,2020,
5,43894,92,0,92,3,3,2020,
6,43894,249,0,249,3,3,2020,
7,43894,192,201,393,3,3,2020,
8,43894,136,292,428,3,3,2020,
9,43894,122,144,266,3,3,2020,
10,43894,123,259,382,3,3,2020,
11,43894,139,145,284,3,3,2020,
12,43894,105,198,303,3,3,2020,
13,43894,112,56,168,3,3,2020,
14,43894,134,89,223,3,3,2020,
15,43894,84,299,383,3,3,2020,
16,43894,59,202,261,3,3,2020,
17,43894,72,192,264,3,3,2020,
18,43894,30,152,182,3,3,2020,
19,43894,33,273,306,3,3,2020,
20,43894,96,70,166,3,3,2020,
21,43894,206,145,351,3,3,2020,
22,43894,194,168,362,3,3,2020,
23,43894,185,198,383,3,3,2020,
0,43895,106,10,116,4,3,2020,
1,43895,32,2,34,4,3,2020,
2,43895,60,8,68,4,3,2020,
3,43895,101,11,112,4,3,2020,
4,43895,247,0,247,4,3,2020,
5,43895,234,0,234,4,3,2020,
6,43895,343,0,343,4,3,2020,
7,43895,347,0,347,4,3,2020,
8,43895,211,231,442,4,3,2020,
9,43895,116,341,457,4,3,2020,
10,43895,160,363,523,4,3,2020,
11,43895,178,194,372,4,3,2020,
12,43895,104,167,271,4,3,2020,
13,43895,111,189,300,4,3,2020,
14,43895,103,148,251,4,3,2020,
15,43895,170,114,284,4,3,2020,
16,43895,121,38,159,4,3,2020,
17,43895,123,249,372,4,3,2020,
18,43895,84,252,336,4,3,2020,
19,43895,27,248,275,4,3,2020,
20,43895,130,107,237,4,3,2020,
21,43895,310,100,410,4,3,2020,
22,43895,314,102,416,4,3,2020,
23,43895,231,152,383,4,3,2020,
0,43896,178,184,362,5,3,2020,
1,43896,104,28,132,5,3,2020,
2,43896,47,0,47,5,3,2020,
3,43896,106,0,106,5,3,2020,
4,43896,140,6,146,5,3,2020,
5,43896,191,12,203,5,3,2020,
6,43896,338,19,357,5,3,2020,
7,43896,255,3,258,5,3,2020,
8,43896,205,126,331,5,3,2020,
9,43896,161,206,367,5,3,2020,
10,43896,118,142,260,5,3,2020,
11,43896,188,78,266,5,3,2020,
12,43896,138,60,198,5,3,2020,
13,43896,141,34,175,5,3,2020,
14,43896,128,368,496,5,3,2020,
15,43896,87,160,247,5,3,2020,
16,43896,113,285,398,5,3,2020,
17,43896,112,146,258,5,3,2020,
18,43896,60,154,214,5,3,2020,
19,43896,45,305,350,5,3,2020,
20,43896,147,55,202,5,3,2020,
21,43896,284,100,384,5,3,2020,
22,43896,285,277,562,5,3,2020,
23,43896,229,282,511,5,3,2020,
0,43897,129,153,282,6,3,2020,
1,43897,47,64,111,6,3,2020,
2,43897,31,111,142,6,3,2020,
3,43897,77,0,77,6,3,2020,
4,43897,90,0,90,6,3,2020,
5,43897,153,0,153,6,3,2020,
6,43897,358,3,361,6,3,2020,
7,43897,365,234,599,6,3,2020,
8,43897,162,408,570,6,3,2020,
9,43897,138,229,367,6,3,2020,
10,43897,114,218,332,6,3,2020,
11,43897,106,204,310,6,3,2020,
12,43897,78,168,246,6,3,2020,
13,43897,91,121,212,6,3,2020,
14,43897,134,245,379,6,3,2020,
15,43897,110,241,351,6,3,2020,
16,43897,88,255,343,6,3,2020,
17,43897,76,270,346,6,3,2020,
18,43897,41,108,149,6,3,2020,
19,43897,53,428,481,6,3,2020,
20,43897,135,159,294,6,3,2020,
21,43897,172,37,209,6,3,2020,
22,43897,161,262,423,6,3,2020,
23,43897,74,209,283,6,3,2020,
0,43898,12,97,109,7,3,2020,
1,43898,33,0,33,7,3,2020,
2,43898,0,0,0,7,3,2020,
3,43898,130,0,130,7,3,2020,
4,43898,88,0,88,7,3,2020,
5,43898,132,0,132,7,3,2020,
6,43898,220,0,220,7,3,2020,
7,43898,243,74,317,7,3,2020,
8,43898,224,328,552,7,3,2020,
9,43898,66,296,362,7,3,2020,
10,43898,120,247,367,7,3,2020,
11,43898,193,108,301,7,3,2020,
12,43898,97,323,420,7,3,2020,
13,43898,94,316,410,7,3,2020,
14,43898,141,38,179,7,3,2020,
15,43898,141,260,401,7,3,2020,
16,43898,143,496,639,7,3,2020,
17,43898,144,186,330,7,3,2020,
18,43898,120,228,348,7,3,2020,
19,43898,30,345,375,7,3,2020,
20,43898,62,354,416,7,3,2020,
21,43898,129,127,256,7,3,2020,
22,43898,168,166,334,7,3,2020,
23,43898,183,299,482,7,3,2020,
0,43899,58,334,392,1,3,2020,
1,43899,51,110,161,1,3,2020,
2,43899,25,45,70,1,3,2020,
3,43899,39,29,68,1,3,2020,
4,43899,43,0,43,1,3,2020,
5,43899,77,0,77,1,3,2020,
6,43899,219,0,219,1,3,2020,
7,43899,220,124,344,1,3,2020,
8,43899,179,404,583,1,3,2020,
9,43899,108,384,492,1,3,2020,
10,43899,121,172,293,1,3,2020,
11,43899,130,196,326,1,3,2020,
12,43899,105,196,301,1,3,2020,
13,43899,92,171,263,1,3,2020,
14,43899,201,103,304,1,3,2020,
15,43899,116,263,379,1,3,2020,
16,43899,119,311,430,1,3,2020,
17,43899,75,145,220,1,3,2020,
18,43899,119,187,306,1,3,2020,
19,43899,59,261,320,1,3,2020,
20,43899,42,343,385,1,3,2020,
21,43899,103,113,216,1,3,2020,
22,43899,119,293,412,1,3,2020,
23,43899,102,134,236,1,3,2020,
0,43900,41,237,278,2,3,2020,
1,43900,23,118,141,2,3,2020,
2,43900,25,34,59,2,3,2020,
3,43900,61,8,69,2,3,2020,
4,43900,37,0,37,2,3,2020,
5,43900,97,3,100,2,3,2020,
6,43900,202,0,202,2,3,2020,
7,43900,231,175,406,2,3,2020,
8,43900,194,233,427,2,3,2020,
9,43900,91,212,303,2,3,2020,
10,43900,62,223,285,2,3,2020,
11,43900,103,85,188,2,3,2020,
12,43900,92,134,226,2,3,2020,
13,43900,85,283,368,2,3,2020,
14,43900,113,151,264,2,3,2020,
15,43900,102,211,313,2,3,2020,
16,43900,70,306,376,2,3,2020,
17,43900,53,144,197,2,3,2020,
18,43900,52,61,113,2,3,2020,
19,43900,32,147,179,2,3,2020,
20,43900,52,161,213,2,3,2020,
21,43900,172,153,325,2,3,2020,
22,43900,194,131,325,2,3,2020,
23,43900,180,221,401,2,3,2020,
0,43901,134,143,277,3,3,2020,
1,43901,38,80,118,3,3,2020,
2,43901,19,11,30,3,3,2020,
3,43901,84,0,84,3,3,2020,
4,43901,62,18,80,3,3,2020,
5,43901,89,2,91,3,3,2020,
6,43901,214,0,214,3,3,2020,
7,43901,217,108,325,3,3,2020,
8,43901,199,232,431,3,3,2020,
9,43901,112,357,469,3,3,2020,
10,43901,91,183,274,3,3,2020,
11,43901,158,194,352,3,3,2020,
12,43901,95,133,228,3,3,2020,
13,43901,129,315,444,3,3,2020,
14,43901,112,23,135,3,3,2020,
15,43901,105,326,431,3,3,2020,
16,43901,69,138,207,3,3,2020,
17,43901,106,94,200,3,3,2020,
18,43901,139,155,294,3,3,2020,
19,43901,42,301,343,3,3,2020,
20,43901,93,145,238,3,3,2020,
21,43901,179,168,347,3,3,2020,
22,43901,266,144,410,3,3,2020,
23,43901,203,240,443,3,3,2020,
0,43902,116,139,255,4,3,2020,
1,43902,37,13,50,4,3,2020,
2,43902,61,0,61,4,3,2020,
3,43902,86,0,86,4,3,2020,
4,43902,153,0,153,4,3,2020,
5,43902,218,0,218,4,3,2020,
6,43902,339,0,339,4,3,2020,
7,43902,304,188,492,4,3,2020,
8,43902,254,222,476,4,3,2020,
9,43902,131,242,373,4,3,2020,
10,43902,124,5,129,4,3,2020,
11,43902,190,175,365,4,3,2020,
12,43902,118,187,305,4,3,2020,
13,43902,114,418,532,4,3,2020,
14,43902,133,238,371,4,3,2020,
15,43902,75,116,191,4,3,2020,
16,43902,96,116,212,4,3,2020,
17,43902,204,133,337,4,3,2020,
18,43902,68,230,298,4,3,2020,
19,43902,76,248,324,4,3,2020,
20,43902,100,191,291,4,3,2020,
21,43902,285,174,459,4,3,2020,
22,43902,302,238,540,4,3,2020,
23,43902,245,163,408,4,3,2020,
0,43903,161,254,415,5,3,2020,
1,43903,75,102,177,5,3,2020,
2,43903,84,46,130,5,3,2020,
3,43903,136,0,136,5,3,2020,
4,43903,141,0,141,5,3,2020,
5,43903,145,3,148,5,3,2020,
6,43903,282,1,283,5,3,2020,
7,43903,238,167,405,5,3,2020,
8,43903,255,187,442,5,3,2020,
9,43903,128,366,494,5,3,2020,
10,43903,100,186,286,5,3,2020,
11,43903,204,154,358,5,3,2020,
12,43903,165,87,252,5,3,2020,
13,43903,158,201,359,5,3,2020,
14,43903,140,81,221,5,3,2020,
15,43903,64,375,439,5,3,2020,
16,43903,78,161,239,5,3,2020,
17,43903,126,120,246,5,3,2020,
18,43903,98,111,209,5,3,2020,
19,43903,46,294,340,5,3,2020,
20,43903,104,143,247,5,3,2020,
21,43903,241,161,402,5,3,2020,
22,43903,322,124,446,5,3,2020,
23,43903,211,312,523,5,3,2020,
0,43904,162,135,297,6,3,2020,
1,43904,56,86,142,6,3,2020,
2,43904,73,23,96,6,3,2020,
3,43904,74,1,75,6,3,2020,
4,43904,44,0,44,6,3,2020,
5,43904,112,0,112,6,3,2020,
6,43904,276,0,276,6,3,2020,
7,43904,308,157,465,6,3,2020,
8,43904,311,241,552,6,3,2020,
9,43904,123,442,565,6,3,2020,
10,43904,155,161,316,6,3,2020,
11,43904,182,105,287,6,3,2020,
12,43904,103,140,243,6,3,2020,
13,43904,90,274,364,6,3,2020,
14,43904,137,89,226,6,3,2020,
15,43904,105,379,484,6,3,2020,
16,43904,81,134,215,6,3,2020,
17,43904,101,70,171,6,3,2020,
18,43904,68,153,221,6,3,2020,
19,43904,96,274,370,6,3,2020,
20,43904,130,170,300,6,3,2020,
21,43904,263,159,422,6,3,2020,
22,43904,246,128,374,6,3,2020,
23,43904,151,199,350,6,3,2020,
0,43905,70,210,280,7,3,2020,
1,43905,49,48,97,7,3,2020,
2,43905,59,2,61,7,3,2020,
3,43905,86,0,86,7,3,2020,
4,43905,100,0,100,7,3,2020,
5,43905,148,0,148,7,3,2020,
6,43905,289,0,289,7,3,2020,
7,43905,273,295,568,7,3,2020,
8,43905,222,281,503,7,3,2020,
9,43905,78,333,411,7,3,2020,
10,43905,152,128,280,7,3,2020,
11,43905,211,81,292,7,3,2020,
12,43905,168,61,229,7,3,2020,
13,43905,172,259,431,7,3,2020,
14,43905,180,266,446,7,3,2020,
15,43905,139,167,306,7,3,2020,
16,43905,107,334,441,7,3,2020,
17,43905,176,179,355,7,3,2020,
18,43905,98,207,305,7,3,2020,
19,43905,83,391,474,7,3,2020,
20,43905,85,125,210,7,3,2020,
21,43905,159,163,322,7,3,2020,
22,43905,208,236,444,7,3,2020,
23,43905,151,322,473,7,3,2020,
0,43906,121,330,451,1,3,2020,
1,43906,48,60,108,1,3,2020,
2,43906,26,73,99,1,3,2020,
3,43906,41,18,59,1,3,2020,
4,43906,50,0,50,1,3,2020,
5,43906,86,0,86,1,3,2020,
6,43906,252,0,252,1,3,2020,
7,43906,319,117,436,1,3,2020,
8,43906,245,281,526,1,3,2020,
9,43906,142,333,475,1,3,2020,
10,43906,107,121,228,1,3,2020,
11,43906,164,69,233,1,3,2020,
12,43906,96,177,273,1,3,2020,
13,43906,106,59,165,1,3,2020,
14,43906,215,152,367,1,3,2020,
15,43906,198,273,471,1,3,2020,
16,43906,110,22,132,1,3,2020,
17,43906,139,103,242,1,3,2020,
18,43906,158,88,246,1,3,2020,
19,43906,62,234,296,1,3,2020,
20,43906,60,191,251,1,3,2020,
21,43906,143,59,202,1,3,2020,
22,43906,215,185,400,1,3,2020,
23,43906,106,100,206,1,3,2020,
0,43907,78,116,194,2,3,2020,
1,43907,18,89,107,2,3,2020,
2,43907,54,86,140,2,3,2020,
3,43907,63,1,64,2,3,2020,
4,43907,95,0,95,2,3,2020,
5,43907,81,14,95,2,3,2020,
6,43907,248,0,248,2,3,2020,
7,43907,307,54,361,2,3,2020,
8,43907,204,121,325,2,3,2020,
9,43907,92,171,263,2,3,2020,
10,43907,109,69,178,2,3,2020,
11,43907,123,161,284,2,3,2020,
12,43907,92,157,249,2,3,2020,
13,43907,136,131,267,2,3,2020,
14,43907,164,32,196,2,3,2020,
15,43907,112,262,374,2,3,2020,
16,43907,99,77,176,2,3,2020,
17,43907,97,188,285,2,3,2020,
18,43907,31,101,132,2,3,2020,
19,43907,42,121,163,2,3,2020,
20,43907,140,36,176,2,3,2020,
21,43907,181,29,210,2,3,2020,
22,43907,233,99,332,2,3,2020,
23,43907,223,297,520,2,3,2020,
0,43908,96,127,223,3,3,2020,
1,43908,24,125,149,3,3,2020,
2,43908,18,13,31,3,3,2020,
3,43908,57,0,57,3,3,2020,
4,43908,34,0,34,3,3,2020,
5,43908,81,0,81,3,3,2020,
6,43908,188,0,188,3,3,2020,
7,43908,201,94,295,3,3,2020,
8,43908,180,165,345,3,3,2020,
9,43908,100,198,298,3,3,2020,
10,43908,148,156,304,3,3,2020,
11,43908,128,95,223,3,3,2020,
12,43908,117,103,220,3,3,2020,
13,43908,73,218,291,3,3,2020,
14,43908,90,38,128,3,3,2020,
15,43908,66,175,241,3,3,2020,
16,43908,75,95,170,3,3,2020,
17,43908,86,124,210,3,3,2020,
18,43908,57,48,105,3,3,2020,
19,43908,59,139,198,3,3,2020,
20,43908,67,236,303,3,3,2020,
21,43908,156,84,240,3,3,2020,
22,43908,120,94,214,3,3,2020,
23,43908,81,120,201,3,3,2020,
0,43909,44,123,167,4,3,2020,
1,43909,22,44,66,4,3,2020,
2,43909,21,0,21,4,3,2020,
3,43909,72,0,72,4,3,2020,
4,43909,79,0,79,4,3,2020,
5,43909,51,0,51,4,3,2020,
6,43909,158,0,158,4,3,2020,
7,43909,187,77,264,4,3,2020,
8,43909,119,119,238,4,3,2020,
9,43909,76,132,208,4,3,2020,
10,43909,75,79,154,4,3,2020,
11,43909,51,75,126,4,3,2020,
12,43909,70,75,145,4,3,2020,
13,43909,90,81,171,4,3,2020,
14,43909,78,70,148,4,3,2020,
15,43909,54,185,239,4,3,2020,
16,43909,52,100,152,4,3,2020,
17,43909,65,57,122,4,3,2020,
18,43909,46,96,142,4,3,2020,
19,43909,40,165,205,4,3,2020,
20,43909,69,94,163,4,3,2020,
21,43909,114,36,150,4,3,2020,
22,43909,158,171,329,4,3,2020,
23,43909,114,119,233,4,3,2020,
0,43910,68,115,183,5,3,2020,
1,43910,53,21,74,5,3,2020,
2,43910,26,0,26,5,3,2020,
3,43910,61,0,61,5,3,2020,
4,43910,37,0,37,5,3,2020,
5,43910,57,4,61,5,3,2020,
6,43910,144,0,144,5,3,2020,
7,43910,122,116,238,5,3,2020,
8,43910,72,145,217,5,3,2020,
9,43910,67,190,257,5,3,2020,
10,43910,54,165,219,5,3,2020,
11,43910,80,108,188,5,3,2020,
12,43910,71,33,104,5,3,2020,
13,43910,102,125,227,5,3,2020,
14,43910,89,88,177,5,3,2020,
15,43910,72,174,246,5,3,2020,
16,43910,57,165,222,5,3,2020,
17,43910,62,105,167,5,3,2020,
18,43910,78,64,142,5,3,2020,
19,43910,51,308,359,5,3,2020,
20,43910,124,179,303,5,3,2020,
21,43910,224,153,377,5,3,2020,
22,43910,165,159,324,5,3,2020,
23,43910,109,318,427,5,3,2020,
0,43911,28,215,243,6,3,2020,
1,43911,15,49,64,6,3,2020,
2,43911,11,0,11,6,3,2020,
3,43911,15,0,15,6,3,2020,
4,43911,17,0,17,6,3,2020,
5,43911,35,0,35,6,3,2020,
6,43911,100,0,100,6,3,2020,
7,43911,111,193,304,6,3,2020,
8,43911,75,231,306,6,3,2020,
9,43911,59,321,380,6,3,2020,
10,43911,52,44,96,6,3,2020,
11,43911,57,167,224,6,3,2020,
12,43911,53,183,236,6,3,2020,
13,43911,89,247,336,6,3,2020,
14,43911,76,86,162,6,3,2020,
15,43911,33,187,220,6,3,2020,
16,43911,35,298,333,6,3,2020,
17,43911,27,87,114,6,3,2020,
18,43911,25,57,82,6,3,2020,
19,43911,31,287,318,6,3,2020,
20,43911,81,300,381,6,3,2020,
21,43911,74,83,157,6,3,2020,
22,43911,72,147,219,6,3,2020,
23,43911,26,266,292,6,3,2020,
0,43912,19,150,169,7,3,2020,
1,43912,11,27,38,7,3,2020,
2,43912,20,0,20,7,3,2020,
3,43912,27,0,27,7,3,2020,
4,43912,28,0,28,7,3,2020,
5,43912,58,0,58,7,3,2020,
6,43912,105,0,105,7,3,2020,
7,43912,115,184,299,7,3,2020,
8,43912,49,311,360,7,3,2020,
9,43912,43,345,388,7,3,2020,
10,43912,64,134,198,7,3,2020,
11,43912,74,90,164,7,3,2020,
12,43912,46,146,192,7,3,2020,
13,43912,68,197,265,7,3,2020,
14,43912,61,35,96,7,3,2020,
15,43912,39,149,188,7,3,2020,
16,43912,38,109,147,7,3,2020,
17,43912,48,186,234,7,3,2020,
18,43912,19,156,175,7,3,2020,
19,43912,15,192,207,7,3,2020,
20,43912,18,94,112,7,3,2020,
21,43912,38,74,112,7,3,2020,
22,43912,43,128,171,7,3,2020,
23,43912,15,230,245,7,3,2020,
0,43913,24,84,108,1,3,2020,
1,43913,9,24,33,1,3,2020,
2,43913,7,17,24,1,3,2020,
3,43913,10,0,10,1,3,2020,
4,43913,17,0,17,1,3,2020,
5,43913,28,0,28,1,3,2020,
6,43913,36,0,36,1,3,2020,
7,43913,39,54,93,1,3,2020,
8,43913,49,91,140,1,3,2020,
9,43913,36,173,209,1,3,2020,
10,43913,31,76,107,1,3,2020,
11,43913,24,98,122,1,3,2020,
12,43913,27,37,64,1,3,2020,
13,43913,34,94,128,1,3,2020,
14,43913,41,19,60,1,3,2020,
15,43913,37,160,197,1,3,2020,
16,43913,16,83,99,1,3,2020,
17,43913,24,88,112,1,3,2020,
18,43913,14,53,67,1,3,2020,
19,43913,11,186,197,1,3,2020,
20,43913,24,72,96,1,3,2020,
21,43913,20,70,90,1,3,2020,
22,43913,34,76,110,1,3,2020,
23,43913,15,62,77,1,3,2020,
0,43914,6,107,113,2,3,2020,
1,43914,5,24,29,2,3,2020,
2,43914,16,0,16,2,3,2020,
3,43914,26,0,26,2,3,2020,
4,43914,20,0,20,2,3,2020,
5,43914,27,0,27,2,3,2020,
6,43914,62,0,62,2,3,2020,
7,43914,83,24,107,2,3,2020,
8,43914,54,67,121,2,3,2020,
9,43914,22,153,175,2,3,2020,
10,43914,25,50,75,2,3,2020,
11,43914,25,37,62,2,3,2020,
12,43914,15,123,138,2,3,2020,
13,43914,20,41,61,2,3,2020,
14,43914,25,17,42,2,3,2020,
15,43914,20,161,181,2,3,2020,
16,43914,6,85,91,2,3,2020,
17,43914,4,63,67,2,3,2020,
18,43914,12,26,38,2,3,2020,
19,43914,9,57,66,2,3,2020,
20,43914,28,12,40,2,3,2020,
21,43914,30,84,114,2,3,2020,
22,43914,22,68,90,2,3,2020,
23,43914,20,67,87,2,3,2020,
0,43915,6,39,45,3,3,2020,
1,43915,10,5,15,3,3,2020,
2,43915,8,12,20,3,3,2020,
3,43915,12,0,12,3,3,2020,
4,43915,7,0,7,3,3,2020,
5,43915,22,0,22,3,3,2020,
6,43915,35,0,35,3,3,2020,
7,43915,35,14,49,3,3,2020,
8,43915,32,10,42,3,3,2020,
9,43915,26,152,178,3,3,2020,
10,43915,15,6,21,3,3,2020,
11,43915,18,37,55,3,3,2020,
12,43915,7,46,53,3,3,2020,
13,43915,16,33,49,3,3,2020,
14,43915,23,0,23,3,3,2020,
15,43915,4,93,97,3,3,2020,
16,43915,10,15,25,3,3,2020,
17,43915,5,20,25,3,3,2020,
18,43915,11,72,83,3,3,2020,
19,43915,7,109,116,3,3,2020,
20,43915,25,14,39,3,3,2020,
21,43915,30,77,107,3,3,2020,
22,43915,52,24,76,3,3,2020,
23,43915,27,37,64,3,3,2020,
0,43916,2,17,19,4,3,2020,
1,43916,13,0,13,4,3,2020,
2,43916,5,0,5,4,3,2020,
3,43916,6,8,14,4,3,2020,
4,43916,6,4,10,4,3,2020,
5,43916,16,0,16,4,3,2020,
6,43916,52,0,52,4,3,2020,
7,43916,67,73,140,4,3,2020,
8,43916,58,65,123,4,3,2020,
9,43916,25,69,94,4,3,2020,
10,43916,23,13,36,4,3,2020,
11,43916,14,42,56,4,3,2020,
12,43916,5,36,41,4,3,2020,
13,43916,3,48,51,4,3,2020,
14,43916,9,31,40,4,3,2020,
15,43916,11,58,69,4,3,2020,
16,43916,11,35,46,4,3,2020,
17,43916,16,29,45,4,3,2020,
18,43916,11,25,36,4,3,2020,
19,43916,9,69,78,4,3,2020,
20,43916,11,28,39,4,3,2020,
21,43916,27,79,106,4,3,2020,
22,43916,26,8,34,4,3,2020,
23,43916,21,60,81,4,3,2020,
0,43917,9,30,39,5,3,2020,
1,43917,8,9,17,5,3,2020,
2,43917,10,0,10,5,3,2020,
3,43917,26,0,26,5,3,2020,
4,43917,31,0,31,5,3,2020,
5,43917,8,0,8,5,3,2020,
6,43917,62,0,62,5,3,2020,
7,43917,44,10,54,5,3,2020,
8,43917,32,23,55,5,3,2020,
9,43917,18,5,23,5,3,2020,
10,43917,10,49,59,5,3,2020,
11,43917,25,35,60,5,3,2020,
12,43917,26,50,76,5,3,2020,
13,43917,51,71,122,5,3,2020,
14,43917,18,36,54,5,3,2020,
15,43917,10,67,77,5,3,2020,
16,43917,4,28,32,5,3,2020,
17,43917,5,25,30,5,3,2020,
18,43917,7,24,31,5,3,2020,
19,43917,12,40,52,5,3,2020,
20,43917,17,15,32,5,3,2020,
21,43917,82,64,146,5,3,2020,
22,43917,23,61,84,5,3,2020,
23,43917,24,59,83,5,3,2020,
0,43918,15,36,51,6,3,2020,
1,43918,8,34,42,6,3,2020,
2,43918,9,0,9,6,3,2020,
3,43918,17,0,17,6,3,2020,
4,43918,26,0,26,6,3,2020,
5,43918,20,1,21,6,3,2020,
6,43918,98,0,98,6,3,2020,
7,43918,59,0,59,6,3,2020,
8,43918,42,36,78,6,3,2020,
9,43918,43,91,134,6,3,2020,
10,43918,23,8,31,6,3,2020,
11,43918,21,33,54,6,3,2020,
12,43918,27,92,119,6,3,2020,
13,43918,34,79,113,6,3,2020,
14,43918,43,65,108,6,3,2020,
15,43918,8,106,114,6,3,2020,
16,43918,12,144,156,6,3,2020,
17,43918,17,72,89,6,3,2020,
18,43918,3,0,3,6,3,2020,
19,43918,10,70,80,6,3,2020,
20,43918,23,0,23,6,3,2020,
21,43918,43,80,123,6,3,2020,
22,43918,24,42,66,6,3,2020,
23,43918,18,168,186,6,3,2020,
0,43919,13,51,64,7,3,2020,
1,43919,5,0,5,7,3,2020,
2,43919,27,0,27,7,3,2020,
3,43919,12,0,12,7,3,2020,
4,43919,11,0,11,7,3,2020,
5,43919,15,0,15,7,3,2020,
6,43919,26,0,26,7,3,2020,
7,43919,38,17,55,7,3,2020,
8,43919,32,56,88,7,3,2020,
9,43919,31,119,150,7,3,2020,
10,43919,50,56,106,7,3,2020,
11,43919,32,30,62,7,3,2020,
12,43919,47,142,189,7,3,2020,
13,43919,35,91,126,7,3,2020,
14,43919,34,0,34,7,3,2020,
15,43919,15,44,59,7,3,2020,
16,43919,17,42,59,7,3,2020,
17,43919,20,9,29,7,3,2020,
18,43919,10,29,39,7,3,2020,
19,43919,13,83,96,7,3,2020,
20,43919,8,24,32,7,3,2020,
21,43919,28,49,77,7,3,2020,
22,43919,29,47,76,7,3,2020,
23,43919,24,72,96,7,3,2020,
0,43920,12,35,47,1,3,2020,
1,43920,5,21,26,1,3,2020,
2,43920,0,8,8,1,3,2020,
3,43920,3,0,3,1,3,2020,
4,43920,5,0,5,1,3,2020,
5,43920,11,0,11,1,3,2020,
6,43920,45,0,45,1,3,2020,
7,43920,33,39,72,1,3,2020,
8,43920,13,76,89,1,3,2020,
9,43920,34,66,100,1,3,2020,
10,43920,17,42,59,1,3,2020,
11,43920,13,18,31,1,3,2020,
12,43920,32,35,67,1,3,2020,
13,43920,14,50,64,1,3,2020,
14,43920,8,0,8,1,3,2020,
15,43920,25,65,90,1,3,2020,
16,43920,0,19,19,1,3,2020,
17,43920,24,9,33,1,3,2020,
18,43920,8,42,50,1,3,2020,
19,43920,7,97,104,1,3,2020,
20,43920,13,35,48,1,3,2020,
21,43920,23,69,92,1,3,2020,
22,43920,25,2,27,1,3,2020,
23,43920,18,12,30,1,3,2020,
0,43921,10,105,115,2,3,2020,
1,43921,1,60,61,2,3,2020,
2,43921,2,1,3,2,3,2020,
3,43921,11,0,11,2,3,2020,
4,43921,11,0,11,2,3,2020,
5,43921,23,0,23,2,3,2020,
6,43921,51,0,51,2,3,2020,
7,43921,28,50,78,2,3,2020,
8,43921,31,42,73,2,3,2020,
9,43921,16,16,32,2,3,2020,
10,43921,21,42,63,2,3,2020,
11,43921,10,25,35,2,3,2020,
12,43921,8,48,56,2,3,2020,
13,43921,9,0,9,2,3,2020,
14,43921,20,0,20,2,3,2020,
15,43921,9,36,45,2,3,2020,
16,43921,6,5,11,2,3,2020,
17,43921,15,13,28,2,3,2020,
18,43921,14,14,28,2,3,2020,
19,43921,9,74,83,2,3,2020,
20,43921,18,0,18,2,3,2020,
21,43921,25,37,62,2,3,2020,
22,43921,47,10,57,2,3,2020,
23,43921,33,61,94,2,3,2020,
0,43922,29,21,50,3,4,2020,
1,43922,2,12,14,3,4,2020,
2,43922,9,15,24,3,4,2020,
3,43922,0,0,0,3,4,2020,
4,43922,1,0,1,3,4,2020,
5,43922,18,0,18,3,4,2020,
6,43922,24,0,24,3,4,2020,
7,43922,20,61,81,3,4,2020,
8,43922,15,49,64,3,4,2020,
9,43922,23,31,54,3,4,2020,
10,43922,20,21,41,3,4,2020,
11,43922,14,3,17,3,4,2020,
12,43922,10,14,24,3,4,2020,
13,43922,29,5,34,3,4,2020,
14,43922,24,77,101,3,4,2020,
15,43922,29,72,101,3,4,2020,
16,43922,23,4,27,3,4,2020,
17,43922,34,2,36,3,4,2020,
18,43922,7,21,28,3,4,2020,
19,43922,9,30,39,3,4,2020,
20,43922,12,56,68,3,4,2020,
21,43922,27,17,44,3,4,2020,
22,43922,25,36,61,3,4,2020,
23,43922,29,13,42,3,4,2020,
0,43923,17,7,24,4,4,2020,
1,43923,6,20,26,4,4,2020,
2,43923,4,0,4,4,4,2020,
3,43923,19,0,19,4,4,2020,
4,43923,11,0,11,4,4,2020,
5,43923,17,0,17,4,4,2020,
6,43923,22,0,22,4,4,2020,
7,43923,26,23,49,4,4,2020,
8,43923,9,28,37,4,4,2020,
9,43923,11,40,51,4,4,2020,
10,43923,22,2,24,4,4,2020,
11,43923,15,0,15,4,4,2020,
12,43923,5,12,17,4,4,2020,
13,43923,32,79,111,4,4,2020,
14,43923,17,27,44,4,4,2020,
15,43923,11,13,24,4,4,2020,
16,43923,16,1,17,4,4,2020,
17,43923,13,5,18,4,4,2020,
18,43923,19,40,59,4,4,2020,
19,43923,20,65,85,4,4,2020,
20,43923,29,21,50,4,4,2020,
21,43923,50,2,52,4,4,2020,
22,43923,47,26,73,4,4,2020,
23,43923,33,10,43,4,4,2020,
0,43924,15,33,48,5,4,2020,
1,43924,9,0,9,5,4,2020,
2,43924,9,0,9,5,4,2020,
3,43924,7,0,7,5,4,2020,
4,43924,10,0,10,5,4,2020,
5,43924,40,0,40,5,4,2020,
6,43924,45,0,45,5,4,2020,
7,43924,55,103,158,5,4,2020,
8,43924,28,30,58,5,4,2020,
9,43924,4,64,68,5,4,2020,
10,43924,16,65,81,5,4,2020,
11,43924,10,0,10,5,4,2020,
12,43924,11,6,17,5,4,2020,
13,43924,13,32,45,5,4,2020,
14,43924,22,0,22,5,4,2020,
15,43924,11,74,85,5,4,2020,
16,43924,8,6,14,5,4,2020,
17,43924,1,0,1,5,4,2020,
18,43924,8,8,16,5,4,2020,
19,43924,7,3,10,5,4,2020,
20,43924,19,43,62,5,4,2020,
21,43924,43,18,61,5,4,2020,
22,43924,11,65,76,5,4,2020,
23,43924,32,5,37,5,4,2020,
0,43925,26,60,86,6,4,2020,
1,43925,4,0,4,6,4,2020,
2,43925,19,0,19,6,4,2020,
3,43925,17,0,17,6,4,2020,
4,43925,6,0,6,6,4,2020,
5,43925,17,0,17,6,4,2020,
6,43925,69,0,69,6,4,2020,
7,43925,48,45,93,6,4,2020,
8,43925,21,41,62,6,4,2020,
9,43925,39,76,115,6,4,2020,
10,43925,26,7,33,6,4,2020,
11,43925,4,19,23,6,4,2020,
12,43925,13,47,60,6,4,2020,
13,43925,10,12,22,6,4,2020,
14,43925,26,1,27,6,4,2020,
15,43925,8,16,24,6,4,2020,
16,43925,7,49,56,6,4,2020,
17,43925,7,1,8,6,4,2020,
18,43925,15,6,21,6,4,2020,
19,43925,22,30,52,6,4,2020,
20,43925,20,7,27,6,4,2020,
21,43925,35,14,49,6,4,2020,
22,43925,51,27,78,6,4,2020,
23,43925,51,8,59,6,4,2020,
0,43926,29,16,45,7,4,2020,
1,43926,10,2,12,7,4,2020,
2,43926,4,1,5,7,4,2020,
3,43926,21,0,21,7,4,2020,
4,43926,24,0,24,7,4,2020,
5,43926,45,0,45,7,4,2020,
6,43926,59,57,116,7,4,2020,
7,43926,38,89,127,7,4,2020,
8,43926,18,19,37,7,4,2020,
9,43926,20,94,114,7,4,2020,
10,43926,17,15,32,7,4,2020,
11,43926,10,53,63,7,4,2020,
12,43926,9,18,27,7,4,2020,
13,43926,6,21,27,7,4,2020,
14,43926,8,36,44,7,4,2020,
15,43926,12,29,41,7,4,2020,
16,43926,22,6,28,7,4,2020,
17,43926,17,10,27,7,4,2020,
18,43926,9,51,60,7,4,2020,
19,43926,4,28,32,7,4,2020,
20,43926,23,10,33,7,4,2020,
21,43926,32,0,32,7,4,2020,
22,43926,25,3,28,7,4,2020,
23,43926,18,43,61,7,4,2020,
0,43927,14,22,36,1,4,2020,
1,43927,4,0,4,1,4,2020,
2,43927,3,0,3,1,4,2020,
3,43927,5,0,5,1,4,2020,
4,43927,22,0,22,1,4,2020,
5,43927,23,0,23,1,4,2020,
6,43927,48,18,66,1,4,2020,
7,43927,41,61,102,1,4,2020,
8,43927,9,60,69,1,4,2020,
9,43927,13,31,44,1,4,2020,
10,43927,4,0,4,1,4,2020,
11,43927,10,40,50,1,4,2020,
12,43927,10,0,10,1,4,2020,
13,43927,5,16,21,1,4,2020,
14,43927,4,18,22,1,4,2020,
15,43927,8,10,18,1,4,2020,
16,43927,16,5,21,1,4,2020,
17,43927,23,3,26,1,4,2020,
18,43927,9,36,45,1,4,2020,
19,43927,10,23,33,1,4,2020,
20,43927,24,25,49,1,4,2020,
21,43927,35,18,53,1,4,2020,
22,43927,28,10,38,1,4,2020,
23,43927,14,16,30,1,4,2020,
0,43928,16,8,24,2,4,2020,
1,43928,3,0,3,2,4,2020,
2,43928,14,0,14,2,4,2020,
3,43928,5,0,5,2,4,2020,
4,43928,2,0,2,2,4,2020,
5,43928,20,0,20,2,4,2020,
6,43928,30,12,42,2,4,2020,
7,43928,21,38,59,2,4,2020,
8,43928,11,23,34,2,4,2020,
9,43928,3,36,39,2,4,2020,
10,43928,7,0,7,2,4,2020,
11,43928,4,0,4,2,4,2020,
12,43928,15,15,30,2,4,2020,
13,43928,1,34,35,2,4,2020,
14,43928,14,16,30,2,4,2020,
15,43928,0,0,0,2,4,2020,
16,43928,4,0,4,2,4,2020,
17,43928,8,2,10,2,4,2020,
18,43928,14,39,53,2,4,2020,
19,43928,13,1,14,2,4,2020,
20,43928,11,1,12,2,4,2020,
21,43928,34,5,39,2,4,2020,
22,43928,34,1,35,2,4,2020,
23,43928,18,13,31,2,4,2020,
0,43929,25,1,26,3,4,2020,
1,43929,0,0,0,3,4,2020,
2,43929,1,0,1,3,4,2020,
3,43929,0,0,0,3,4,2020,
4,43929,5,0,5,3,4,2020,
5,43929,17,0,17,3,4,2020,
6,43929,36,40,76,3,4,2020,
7,43929,14,69,83,3,4,2020,
8,43929,26,3,29,3,4,2020,
9,43929,16,4,20,3,4,2020,
10,43929,9,28,37,3,4,2020,
11,43929,5,10,15,3,4,2020,
12,43929,4,0,4,3,4,2020,
13,43929,0,6,6,3,4,2020,
14,43929,2,32,34,3,4,2020,
15,43929,7,42,49,3,4,2020,
16,43929,12,0,12,3,4,2020,
17,43929,15,0,15,3,4,2020,
18,43929,12,44,56,3,4,2020,
19,43929,15,1,16,3,4,2020,
20,43929,19,13,32,3,4,2020,
21,43929,28,22,50,3,4,2020,
22,43929,28,3,31,3,4,2020,
23,43929,20,1,21,3,4,2020,
0,43930,23,13,36,4,4,2020,
1,43930,1,0,1,4,4,2020,
2,43930,8,0,8,4,4,2020,
3,43930,7,0,7,4,4,2020,
4,43930,3,0,3,4,4,2020,
5,43930,8,0,8,4,4,2020,
6,43930,7,2,9,4,4,2020,
7,43930,23,71,94,4,4,2020,
8,43930,15,37,52,4,4,2020,
9,43930,11,1,12,4,4,2020,
10,43930,13,4,17,4,4,2020,
11,43930,10,32,42,4,4,2020,
12,43930,2,3,5,4,4,2020,
13,43930,3,37,40,4,4,2020,
14,43930,1,0,1,4,4,2020,
15,43930,6,0,6,4,4,2020,
16,43930,7,0,7,4,4,2020,
17,43930,7,1,8,4,4,2020,
18,43930,1,69,70,4,4,2020,
19,43930,11,16,27,4,4,2020,
20,43930,28,15,43,4,4,2020,
21,43930,25,16,41,4,4,2020,
22,43930,42,0,42,4,4,2020,
23,43930,25,10,35,4,4,2020,
0,43931,18,8,26,5,4,2020,
1,43931,7,0,7,5,4,2020,
2,43931,3,0,3,5,4,2020,
3,43931,0,0,0,5,4,2020,
4,43931,1,0,1,5,4,2020,
5,43931,21,1,22,5,4,2020,
6,43931,41,50,91,5,4,2020,
7,43931,36,70,106,5,4,2020,
8,43931,18,8,26,5,4,2020,
9,43931,14,0,14,5,4,2020,
10,43931,9,6,15,5,4,2020,
11,43931,2,46,48,5,4,2020,
12,43931,4,0,4,5,4,2020,
13,43931,0,0,0,5,4,2020,
14,43931,0,36,36,5,4,2020,
15,43931,2,6,8,5,4,2020,
16,43931,4,0,4,5,4,2020,
17,43931,11,0,11,5,4,2020,
18,43931,6,28,34,5,4,2020,
19,43931,13,3,16,5,4,2020,
20,43931,29,17,46,5,4,2020,
21,43931,43,0,43,5,4,2020,
22,43931,46,1,47,5,4,2020,
23,43931,31,10,41,5,4,2020,
0,43932,9,12,21,6,4,2020,
1,43932,5,0,5,6,4,2020,
2,43932,0,0,0,6,4,2020,
3,43932,0,0,0,6,4,2020,
4,43932,0,0,0,6,4,2020,
5,43932,0,0,0,6,4,2020,
6,43932,2,30,32,6,4,2020,
7,43932,6,36,42,6,4,2020,
8,43932,12,1,13,6,4,2020,
9,43932,22,80,102,6,4,2020,
10,43932,17,6,23,6,4,2020,
11,43932,20,19,39,6,4,2020,
12,43932,8,0,8,6,4,2020,
13,43932,3,1,4,6,4,2020,
14,43932,5,5,10,6,4,2020,
15,43932,14,0,14,6,4,2020,
16,43932,3,0,3,6,4,2020,
17,43932,8,0,8,6,4,2020,
18,43932,8,99,107,6,4,2020,
19,43932,11,0,11,6,4,2020,
20,43932,6,0,6,6,4,2020,
21,43932,47,0,47,6,4,2020,
22,43932,32,0,32,6,4,2020,
23,43932,50,41,91,6,4,2020,
0,43933,14,8,22,7,4,2020,
1,43933,3,0,3,7,4,2020,
2,43933,4,0,4,7,4,2020,
3,43933,5,0,5,7,4,2020,
4,43933,14,0,14,7,4,2020,
5,43933,14,0,14,7,4,2020,
6,43933,20,14,34,7,4,2020,
7,43933,12,54,66,7,4,2020,
8,43933,16,15,31,7,4,2020,
9,43933,25,65,90,7,4,2020,
10,43933,12,55,67,7,4,2020,
11,43933,14,26,40,7,4,2020,
12,43933,10,6,16,7,4,2020,
13,43933,2,15,17,7,4,2020,
14,43933,4,26,30,7,4,2020,
15,43933,4,15,19,7,4,2020,
16,43933,7,0,7,7,4,2020,
17,43933,7,5,12,7,4,2020,
18,43933,7,82,89,7,4,2020,
19,43933,7,3,10,7,4,2020,
20,43933,21,27,48,7,4,2020,
21,43933,35,1,36,7,4,2020,
22,43933,16,19,35,7,4,2020,
23,43933,6,74,80,7,4,2020,
0,43934,7,12,19,1,4,2020,
1,43934,2,6,8,1,4,2020,
2,43934,4,0,4,1,4,2020,
3,43934,0,0,0,1,4,2020,
4,43934,1,0,1,1,4,2020,
5,43934,9,0,9,1,4,2020,
6,43934,16,0,16,1,4,2020,
7,43934,28,52,80,1,4,2020,
8,43934,5,27,32,1,4,2020,
9,43934,5,63,68,1,4,2020,
10,43934,12,1,13,1,4,2020,
11,43934,3,15,18,1,4,2020,
12,43934,7,8,15,1,4,2020,
13,43934,4,8,12,1,4,2020,
14,43934,2,10,12,1,4,2020,
15,43934,7,0,7,1,4,2020,
16,43934,16,0,16,1,4,2020,
17,43934,20,0,20,1,4,2020,
18,43934,3,58,61,1,4,2020,
19,43934,11,0,11,1,4,2020,
20,43934,19,11,30,1,4,2020,
21,43934,30,0,30,1,4,2020,
22,43934,18,0,18,1,4,2020,
23,43934,15,10,25,1,4,2020,
0,43935,11,22,33,2,4,2020,
1,43935,0,9,9,2,4,2020,
2,43935,0,0,0,2,4,2020,
3,43935,0,0,0,2,4,2020,
4,43935,10,0,10,2,4,2020,
5,43935,19,0,19,2,4,2020,
6,43935,19,64,83,2,4,2020,
7,43935,16,20,36,2,4,2020,
8,43935,7,25,32,2,4,2020,
9,43935,6,41,47,2,4,2020,
10,43935,6,7,13,2,4,2020,
11,43935,6,12,18,2,4,2020,
12,43935,3,21,24,2,4,2020,
13,43935,4,11,15,2,4,2020,
14,43935,1,0,1,2,4,2020,
15,43935,1,0,1,2,4,2020,
16,43935,3,0,3,2,4,2020,
17,43935,0,6,6,2,4,2020,
18,43935,4,14,18,2,4,2020,
19,43935,6,0,6,2,4,2020,
20,43935,33,0,33,2,4,2020,
21,43935,23,10,33,2,4,2020,
22,43935,26,0,26,2,4,2020,
23,43935,24,9,33,2,4,2020,
0,43936,23,0,23,3,4,2020,
1,43936,0,0,0,3,4,2020,
2,43936,0,0,0,3,4,2020,
3,43936,2,0,2,3,4,2020,
4,43936,2,0,2,3,4,2020,
5,43936,17,0,17,3,4,2020,
6,43936,34,14,48,3,4,2020,
7,43936,11,98,109,3,4,2020,
8,43936,9,7,16,3,4,2020,
9,43936,9,38,47,3,4,2020,
10,43936,5,4,9,3,4,2020,
11,43936,1,17,18,3,4,2020,
12,43936,2,23,25,3,4,2020,
13,43936,4,6,10,3,4,2020,
14,43936,1,0,1,3,4,2020,
15,43936,6,5,11,3,4,2020,
16,43936,11,0,11,3,4,2020,
17,43936,8,0,8,3,4,2020,
18,43936,5,32,37,3,4,2020,
19,43936,7,21,28,3,4,2020,
20,43936,24,0,24,3,4,2020,
21,43936,30,0,30,3,4,2020,
22,43936,38,2,40,3,4,2020,
23,43936,20,26,46,3,4,2020,
0,43937,14,2,16,4,4,2020,
1,43937,4,0,4,4,4,2020,
2,43937,2,0,2,4,4,2020,
3,43937,16,0,16,4,4,2020,
4,43937,8,0,8,4,4,2020,
5,43937,2,0,2,4,4,2020,
6,43937,3,43,46,4,4,2020,
7,43937,14,0,14,4,4,2020,
8,43937,12,40,52,4,4,2020,
9,43937,34,0,34,4,4,2020,
10,43937,21,8,29,4,4,2020,
11,43937,6,63,69,4,4,2020,
12,43937,14,5,19,4,4,2020,
13,43937,3,29,32,4,4,2020,
14,43937,2,4,6,4,4,2020,
15,43937,4,0,4,4,4,2020,
16,43937,9,0,9,4,4,2020,
17,43937,12,0,12,4,4,2020,
18,43937,7,19,26,4,4,2020,
19,43937,14,33,47,4,4,2020,
20,43937,20,0,20,4,4,2020,
21,43937,52,0,52,4,4,2020,
22,43937,59,2,61,4,4,2020,
23,43937,41,0,41,4,4,2020,
0,43938,8,19,27,5,4,2020,
1,43938,2,0,2,5,4,2020,
2,43938,2,0,2,5,4,2020,
3,43938,1,0,1,5,4,2020,
4,43938,5,0,5,5,4,2020,
5,43938,20,0,20,5,4,2020,
6,43938,29,0,29,5,4,2020,
7,43938,28,86,114,5,4,2020,
8,43938,21,86,107,5,4,2020,
9,43938,19,9,28,5,4,2020,
10,43938,10,52,62,5,4,2020,
11,43938,1,28,29,5,4,2020,
12,43938,0,4,4,5,4,2020,
13,43938,0,46,46,5,4,2020,
14,43938,10,29,39,5,4,2020,
15,43938,1,9,10,5,4,2020,
16,43938,15,0,15,5,4,2020,
17,43938,21,0,21,5,4,2020,
18,43938,13,25,38,5,4,2020,
19,43938,9,14,23,5,4,2020,
20,43938,28,0,28,5,4,2020,
21,43938,41,0,41,5,4,2020,
22,43938,21,3,24,5,4,2020,
23,43938,22,6,28,5,4,2020,
0,43939,10,27,37,6,4,2020,
1,43939,0,0,0,6,4,2020,
2,43939,0,0,0,6,4,2020,
3,43939,0,0,0,6,4,2020,
4,43939,0,0,0,6,4,2020,
5,43939,0,0,0,6,4,2020,
6,43939,4,41,45,6,4,2020,
7,43939,8,17,25,6,4,2020,
8,43939,28,14,42,6,4,2020,
9,43939,32,91,123,6,4,2020,
10,43939,14,8,22,6,4,2020,
11,43939,3,26,29,6,4,2020,
12,43939,0,0,0,6,4,2020,
13,43939,8,0,8,6,4,2020,
14,43939,14,0,14,6,4,2020,
15,43939,13,0,13,6,4,2020,
16,43939,5,0,5,6,4,2020,
17,43939,3,7,10,6,4,2020,
18,43939,12,36,48,6,4,2020,
19,43939,13,47,60,6,4,2020,
20,43939,31,0,31,6,4,2020,
21,43939,29,0,29,6,4,2020,
22,43939,15,0,15,6,4,2020,
23,43939,11,53,64,6,4,2020,
0,43940,5,19,24,7,4,2020,
1,43940,9,1,10,7,4,2020,
2,43940,5,0,5,7,4,2020,
3,43940,18,0,18,7,4,2020,
4,43940,19,0,19,7,4,2020,
5,43940,56,0,56,7,4,2020,
6,43940,22,11,33,7,4,2020,
7,43940,37,57,94,7,4,2020,
8,43940,16,30,46,7,4,2020,
9,43940,34,16,50,7,4,2020,
10,43940,21,29,50,7,4,2020,
11,43940,9,43,52,7,4,2020,
12,43940,11,11,22,7,4,2020,
13,43940,1,54,55,7,4,2020,
14,43940,3,39,42,7,4,2020,
15,43940,3,24,27,7,4,2020,
16,43940,20,0,20,7,4,2020,
17,43940,6,2,8,7,4,2020,
18,43940,8,27,35,7,4,2020,
19,43940,9,12,21,7,4,2020,
20,43940,20,1,21,7,4,2020,
21,43940,37,6,43,7,4,2020,
22,43940,49,75,124,7,4,2020,
23,43940,25,15,40,7,4,2020,
0,43941,5,20,25,1,4,2020,
1,43941,0,0,0,1,4,2020,
2,43941,0,0,0,1,4,2020,
3,43941,0,0,0,1,4,2020,
4,43941,1,0,1,1,4,2020,
5,43941,16,0,16,1,4,2020,
6,43941,19,39,58,1,4,2020,
7,43941,34,2,36,1,4,2020,
8,43941,12,33,45,1,4,2020,
9,43941,15,13,28,1,4,2020,
10,43941,23,10,33,1,4,2020,
11,43941,10,0,10,1,4,2020,
12,43941,2,42,44,1,4,2020,
13,43941,0,31,31,1,4,2020,
14,43941,2,5,7,1,4,2020,
15,43941,10,0,10,1,4,2020,
16,43941,9,0,9,1,4,2020,
17,43941,9,0,9,1,4,2020,
18,43941,9,66,75,1,4,2020,
19,43941,16,9,25,1,4,2020,
20,43941,6,0,6,1,4,2020,
21,43941,9,0,9,1,4,2020,
22,43941,14,1,15,1,4,2020,
23,43941,5,31,36,1,4,2020,
0,43942,14,17,31,2,4,2020,
1,43942,1,0,1,2,4,2020,
2,43942,0,0,0,2,4,2020,
3,43942,0,0,0,2,4,2020,
4,43942,1,0,1,2,4,2020,
5,43942,2,0,2,2,4,2020,
6,43942,15,0,15,2,4,2020,
7,43942,33,0,33,2,4,2020,
8,43942,14,7,21,2,4,2020,
9,43942,8,35,43,2,4,2020,
10,43942,11,13,24,2,4,2020,
11,43942,2,1,3,2,4,2020,
12,43942,16,49,65,2,4,2020,
13,43942,11,16,27,2,4,2020,
14,43942,1,0,1,2,4,2020,
15,43942,3,0,3,2,4,2020,
16,43942,6,0,6,2,4,2020,
17,43942,4,1,5,2,4,2020,
18,43942,1,25,26,2,4,2020,
19,43942,3,0,3,2,4,2020,
20,43942,21,0,21,2,4,2020,
21,43942,22,52,74,2,4,2020,
22,43942,29,0,29,2,4,2020,
23,43942,20,9,29,2,4,2020,
0,43943,7,34,41,3,4,2020,
1,43943,4,0,4,3,4,2020,
2,43943,0,0,0,3,4,2020,
3,43943,1,0,1,3,4,2020,
4,43943,6,0,6,3,4,2020,
5,43943,2,0,2,3,4,2020,
6,43943,8,0,8,3,4,2020,
7,43943,0,58,58,3,4,2020,
8,43943,8,3,11,3,4,2020,
9,43943,11,35,46,3,4,2020,
10,43943,9,41,50,3,4,2020,
11,43943,5,0,5,3,4,2020,
12,43943,0,15,15,3,4,2020,
13,43943,0,9,9,3,4,2020,
14,43943,0,0,0,3,4,2020,
15,43943,0,8,8,3,4,2020,
16,43943,1,0,1,3,4,2020,
17,43943,0,0,0,3,4,2020,
18,43943,3,0,3,3,4,2020,
19,43943,8,8,16,3,4,2020,
20,43943,31,7,38,3,4,2020,
21,43943,28,0,28,3,4,2020,
22,43943,34,0,34,3,4,2020,
23,43943,18,0,18,3,4,2020,
0,43944,13,0,13,4,4,2020,
1,43944,5,0,5,4,4,2020,
2,43944,10,0,10,4,4,2020,
3,43944,3,0,3,4,4,2020,
4,43944,9,0,9,4,4,2020,
5,43944,0,0,0,4,4,2020,
6,43944,17,48,65,4,4,2020,
7,43944,38,2,40,4,4,2020,
8,43944,12,16,28,4,4,2020,
9,43944,19,74,93,4,4,2020,
10,43944,13,14,27,4,4,2020,
11,43944,5,19,24,4,4,2020,
12,43944,5,24,29,4,4,2020,
13,43944,3,38,41,4,4,2020,
14,43944,5,0,5,4,4,2020,
15,43944,20,0,20,4,4,2020,
16,43944,3,0,3,4,4,2020,
17,43944,19,0,19,4,4,2020,
18,43944,6,12,18,4,4,2020,
19,43944,10,17,27,4,4,2020,
20,43944,25,1,26,4,4,2020,
21,43944,83,0,83,4,4,2020,
22,43944,50,0,50,4,4,2020,
23,43944,45,22,67,4,4,2020,
0,43945,7,27,34,5,4,2020,
1,43945,3,0,3,5,4,2020,
2,43945,0,0,0,5,4,2020,
3,43945,2,0,2,5,4,2020,
4,43945,0,0,0,5,4,2020,
5,43945,24,0,24,5,4,2020,
6,43945,18,33,51,5,4,2020,
7,43945,22,32,54,5,4,2020,
8,43945,25,0,25,5,4,2020,
9,43945,32,39,71,5,4,2020,
10,43945,25,69,94,5,4,2020,
11,43945,10,10,20,5,4,2020,
12,43945,3,26,29,5,4,2020,
13,43945,1,16,17,5,4,2020,
14,43945,3,51,54,5,4,2020,
15,43945,3,10,13,5,4,2020,
16,43945,8,1,9,5,4,2020,
17,43945,27,13,40,5,4,2020,
18,43945,10,86,96,5,4,2020,
19,43945,7,5,12,5,4,2020,
20,43945,23,27,50,5,4,2020,
21,43945,31,0,31,5,4,2020,
22,43945,51,0,51,5,4,2020,
23,43945,31,14,45,5,4,2020,
0,43946,13,28,41,6,4,2020,
1,43946,0,1,1,6,4,2020,
2,43946,0,0,0,6,4,2020,
3,43946,0,0,0,6,4,2020,
4,43946,0,0,0,6,4,2020,
5,43946,6,0,6,6,4,2020,
6,43946,20,0,20,6,4,2020,
7,43946,47,0,47,6,4,2020,
8,43946,7,23,30,6,4,2020,
9,43946,15,87,102,6,4,2020,
10,43946,6,19,25,6,4,2020,
11,43946,7,0,7,6,4,2020,
12,43946,0,23,23,6,4,2020,
13,43946,0,20,20,6,4,2020,
14,43946,4,0,4,6,4,2020,
15,43946,3,0,3,6,4,2020,
16,43946,2,0,2,6,4,2020,
17,43946,14,8,22,6,4,2020,
18,43946,2,42,44,6,4,2020,
19,43946,6,3,9,6,4,2020,
20,43946,8,0,8,6,4,2020,
21,43946,20,0,20,6,4,2020,
22,43946,27,4,31,6,4,2020,
23,43946,23,22,45,6,4,2020,
0,43947,4,0,4,7,4,2020,
1,43947,0,0,0,7,4,2020,
2,43947,3,0,3,7,4,2020,
3,43947,7,0,7,7,4,2020,
4,43947,5,0,5,7,4,2020,
5,43947,13,0,13,7,4,2020,
6,43947,33,0,33,7,4,2020,
7,43947,37,0,37,7,4,2020,
8,43947,26,58,84,7,4,2020,
9,43947,48,17,65,7,4,2020,
10,43947,32,11,43,7,4,2020,
11,43947,12,9,21,7,4,2020,
12,43947,5,71,76,7,4,2020,
13,43947,6,61,67,7,4,2020,
14,43947,7,50,57,7,4,2020,
15,43947,8,19,27,7,4,2020,
16,43947,20,0,20,7,4,2020,
17,43947,15,0,15,7,4,2020,
18,43947,11,50,61,7,4,2020,
19,43947,21,36,57,7,4,2020,
20,43947,33,0,33,7,4,2020,
21,43947,30,0,30,7,4,2020,
22,43947,44,7,51,7,4,2020,
23,43947,46,45,91,7,4,2020,
0,43948,8,39,47,1,4,2020,
1,43948,1,0,1,1,4,2020,
2,43948,0,0,0,1,4,2020,
3,43948,0,0,0,1,4,2020,
4,43948,2,0,2,1,4,2020,
5,43948,1,0,1,1,4,2020,
6,43948,12,0,12,1,4,2020,
7,43948,39,0,39,1,4,2020,
8,43948,21,88,109,1,4,2020,
9,43948,15,81,96,1,4,2020,
10,43948,2,6,8,1,4,2020,
11,43948,5,0,5,1,4,2020,
12,43948,4,23,27,1,4,2020,
13,43948,0,60,60,1,4,2020,
14,43948,4,0,4,1,4,2020,
15,43948,10,0,10,1,4,2020,
16,43948,16,0,16,1,4,2020,
17,43948,13,3,16,1,4,2020,
18,43948,12,73,85,1,4,2020,
19,43948,10,16,26,1,4,2020,
20,43948,10,0,10,1,4,2020,
21,43948,49,0,49,1,4,2020,
22,43948,26,3,29,1,4,2020,
23,43948,9,17,26,1,4,2020,
0,43949,0,18,18,2,4,2020,
1,43949,0,6,6,2,4,2020,
2,43949,1,0,1,2,4,2020,
3,43949,0,0,0,2,4,2020,
4,43949,1,0,1,2,4,2020,
5,43949,1,0,1,2,4,2020,
6,43949,17,0,17,2,4,2020,
7,43949,24,0,24,2,4,2020,
8,43949,8,51,59,2,4,2020,
9,43949,4,24,28,2,4,2020,
10,43949,11,6,17,2,4,2020,
11,43949,1,0,1,2,4,2020,
12,43949,3,16,19,2,4,2020,
13,43949,0,13,13,2,4,2020,
14,43949,6,0,6,2,4,2020,
15,43949,2,0,2,2,4,2020,
16,43949,11,0,11,2,4,2020,
17,43949,19,9,28,2,4,2020,
18,43949,4,36,40,2,4,2020,
19,43949,13,0,13,2,4,2020,
20,43949,13,0,13,2,4,2020,
21,43949,38,0,38,2,4,2020,
22,43949,33,6,39,2,4,2020,
23,43949,21,3,24,2,4,2020,
0,43950,1,0,1,3,4,2020,
1,43950,0,0,0,3,4,2020,
2,43950,0,0,0,3,4,2020,
3,43950,3,0,3,3,4,2020,
4,43950,0,0,0,3,4,2020,
5,43950,7,0,7,3,4,2020,
6,43950,20,0,20,3,4,2020,
7,43950,41,0,41,3,4,2020,
8,43950,15,0,15,3,4,2020,
9,43950,16,10,26,3,4,2020,
10,43950,12,137,149,3,4,2020,
11,43950,2,0,2,3,4,2020,
12,43950,0,91,91,3,4,2020,
13,43950,2,20,22,3,4,2020,
14,43950,1,2,3,3,4,2020,
15,43950,2,15,17,3,4,2020,
16,43950,6,0,6,3,4,2020,
17,43950,19,0,19,3,4,2020,
18,43950,4,49,53,3,4,2020,
19,43950,19,1,20,3,4,2020,
20,43950,38,10,48,3,4,2020,
21,43950,49,0,49,3,4,2020,
22,43950,44,11,55,3,4,2020,
23,43950,38,0,38,3,4,2020,
0,43951,18,0,18,4,4,2020,
1,43951,10,0,10,4,4,2020,
2,43951,5,0,5,4,4,2020,
3,43951,5,0,5,4,4,2020,
4,43951,10,0,10,4,4,2020,
5,43951,28,0,28,4,4,2020,
6,43951,48,0,48,4,4,2020,
7,43951,45,0,45,4,4,2020,
8,43951,20,6,26,4,4,2020,
9,43951,17,62,79,4,4,2020,
10,43951,21,171,192,4,4,2020,
11,43951,19,73,92,4,4,2020,
12,43951,15,36,51,4,4,2020,
13,43951,19,68,87,4,4,2020,
14,43951,17,0,17,4,4,2020,
15,43951,6,22,28,4,4,2020,
16,43951,43,2,45,4,4,2020,
17,43951,33,4,37,4,4,2020,
18,43951,5,79,84,4,4,2020,
19,43951,1,39,40,4,4,2020,
20,43951,9,7,16,4,4,2020,
21,43951,11,24,35,4,4,2020,
22,43951,7,3,10,4,4,2020,
23,43951,1,42,43,4,4,2020,
0,43952,0,6,6,5,5,2020,
1,43952,2,0,2,5,5,2020,
2,43952,5,0,5,5,5,2020,
3,43952,2,0,2,5,5,2020,
4,43952,2,0,2,5,5,2020,
5,43952,20,0,20,5,5,2020,
6,43952,60,0,60,5,5,2020,
7,43952,38,0,38,5,5,2020,
8,43952,10,0,10,5,5,2020,
9,43952,14,29,43,5,5,2020,
10,43952,43,25,68,5,5,2020,
11,43952,27,46,73,5,5,2020,
12,43952,38,0,38,5,5,2020,
13,43952,28,12,40,5,5,2020,
14,43952,32,19,51,5,5,2020,
15,43952,16,111,127,5,5,2020,
16,43952,16,0,16,5,5,2020,
17,43952,14,0,14,5,5,2020,
18,43952,8,8,16,5,5,2020,
19,43952,0,47,47,5,5,2020,
20,43952,6,39,45,5,5,2020,
21,43952,14,77,91,5,5,2020,
22,43952,19,3,22,5,5,2020,
23,43952,6,0,6,5,5,2020,
0,43953,7,0,7,6,5,2020,
1,43953,4,0,4,6,5,2020,
2,43953,1,0,1,6,5,2020,
3,43953,4,0,4,6,5,2020,
4,43953,9,0,9,6,5,2020,
5,43953,26,0,26,6,5,2020,
6,43953,60,0,60,6,5,2020,
7,43953,49,0,49,6,5,2020,
8,43953,21,0,21,6,5,2020,
9,43953,24,1,25,6,5,2020,
10,43953,27,18,45,6,5,2020,
11,43953,28,52,80,6,5,2020,
12,43953,71,0,71,6,5,2020,
13,43953,36,16,52,6,5,2020,
14,43953,11,70,81,6,5,2020,
15,43953,1,110,111,6,5,2020,
16,43953,0,44,44,6,5,2020,
17,43953,0,0,0,6,5,2020,
18,43953,1,0,1,6,5,2020,
19,43953,0,20,20,6,5,2020,
20,43953,3,10,13,6,5,2020,
21,43953,0,56,56,6,5,2020,
22,43953,0,0,0,6,5,2020,
23,43953,0,0,0,6,5,2020,
0,43954,0,0,0,7,5,2020,
1,43954,1,0,1,7,5,2020,
2,43954,5,0,5,7,5,2020,
3,43954,0,0,0,7,5,2020,
4,43954,1,0,1,7,5,2020,
5,43954,16,0,16,7,5,2020,
6,43954,71,0,71,7,5,2020,
7,43954,41,0,41,7,5,2020,
8,43954,24,20,44,7,5,2020,
9,43954,44,22,66,7,5,2020,
10,43954,32,31,63,7,5,2020,
11,43954,54,60,114,7,5,2020,
12,43954,57,0,57,7,5,2020,
13,43954,46,52,98,7,5,2020,
14,43954,17,41,58,7,5,2020,
15,43954,1,119,120,7,5,2020,
16,43954,2,18,20,7,5,2020,
17,43954,0,0,0,7,5,2020,
18,43954,5,67,72,7,5,2020,
19,43954,1,15,16,7,5,2020,
20,43954,1,55,56,7,5,2020,
21,43954,5,83,88,7,5,2020,
22,43954,15,0,15,7,5,2020,
23,43954,7,0,7,7,5,2020,
0,43955,1,0,1,1,5,2020,
1,43955,1,0,1,1,5,2020,
2,43955,6,0,6,1,5,2020,
3,43955,2,0,2,1,5,2020,
4,43955,8,0,8,1,5,2020,
5,43955,29,0,29,1,5,2020,
6,43955,47,0,47,1,5,2020,
7,43955,34,0,34,1,5,2020,
8,43955,21,1,22,1,5,2020,
9,43955,49,49,98,1,5,2020,
10,43955,32,32,64,1,5,2020,
11,43955,28,47,75,1,5,2020,
12,43955,47,0,47,1,5,2020,
13,43955,28,34,62,1,5,2020,
14,43955,27,29,56,1,5,2020,
15,43955,3,96,99,1,5,2020,
16,43955,0,32,32,1,5,2020,
17,43955,0,0,0,1,5,2020,
18,43955,0,27,27,1,5,2020,
19,43955,4,54,58,1,5,2020,
20,43955,4,16,20,1,5,2020,
21,43955,8,97,105,1,5,2020,
22,43955,5,6,11,1,5,2020,
23,43955,8,0,8,1,5,2020,
0,43956,2,0,2,2,5,2020,
1,43956,0,0,0,2,5,2020,
2,43956,5,0,5,2,5,2020,
3,43956,0,0,0,2,5,2020,
4,43956,17,0,17,2,5,2020,
5,43956,24,0,24,2,5,2020,
6,43956,48,0,48,2,5,2020,
7,43956,40,0,40,2,5,2020,
8,43956,10,10,20,2,5,2020,
9,43956,19,23,42,2,5,2020,
10,43956,36,18,54,2,5,2020,
11,43956,49,33,82,2,5,2020,
12,43956,79,0,79,2,5,2020,
13,43956,54,60,114,2,5,2020,
14,43956,16,13,29,2,5,2020,
15,43956,3,94,97,2,5,2020,
16,43956,1,5,6,2,5,2020,
17,43956,3,0,3,2,5,2020,
18,43956,2,12,14,2,5,2020,
19,43956,0,3,3,2,5,2020,
20,43956,0,12,12,2,5,2020,
21,43956,2,120,122,2,5,2020,
22,43956,0,0,0,2,5,2020,
23,43956,0,0,0,2,5,2020,
0,43957,2,0,2,3,5,2020,
1,43957,0,0,0,3,5,2020,
2,43957,0,0,0,3,5,2020,
3,43957,2,0,2,3,5,2020,
4,43957,0,0,0,3,5,2020,
5,43957,22,0,22,3,5,2020,
6,43957,50,0,50,3,5,2020,
7,43957,59,0,59,3,5,2020,
8,43957,7,1,8,3,5,2020,
9,43957,37,42,79,3,5,2020,
10,43957,50,12,62,3,5,2020,
11,43957,44,45,89,3,5,2020,
12,43957,61,0,61,3,5,2020,
13,43957,47,18,65,3,5,2020,
14,43957,17,36,53,3,5,2020,
15,43957,2,113,115,3,5,2020,
16,43957,0,0,0,3,5,2020,
17,43957,1,0,1,3,5,2020,
18,43957,0,0,0,3,5,2020,
19,43957,0,32,32,3,5,2020,
20,43957,0,30,30,3,5,2020,
21,43957,1,45,46,3,5,2020,
22,43957,3,0,3,3,5,2020,
23,43957,3,0,3,3,5,2020,
0,43958,3,0,3,4,5,2020,
1,43958,3,0,3,4,5,2020,
2,43958,0,0,0,4,5,2020,
3,43958,3,0,3,4,5,2020,
4,43958,9,0,9,4,5,2020,
5,43958,37,0,37,4,5,2020,
6,43958,63,0,63,4,5,2020,
7,43958,29,0,29,4,5,2020,
8,43958,23,0,23,4,5,2020,
9,43958,48,0,48,4,5,2020,
10,43958,79,61,140,4,5,2020,
11,43958,52,33,85,4,5,2020,
12,43958,94,1,95,4,5,2020,
13,43958,68,37,105,4,5,2020,
14,43958,30,32,62,4,5,2020,
15,43958,4,107,111,4,5,2020,
16,43958,0,20,20,4,5,2020,
17,43958,0,0,0,4,5,2020,
18,43958,0,46,46,4,5,2020,
19,43958,1,16,17,4,5,2020,
20,43958,7,31,38,4,5,2020,
21,43958,11,73,84,4,5,2020,
22,43958,5,0,5,4,5,2020,
23,43958,0,0,0,4,5,2020,
0,43959,0,0,0,5,5,2020,
1,43959,8,0,8,5,5,2020,
2,43959,7,0,7,5,5,2020,
3,43959,7,0,7,5,5,2020,
4,43959,16,0,16,5,5,2020,
5,43959,45,0,45,5,5,2020,
6,43959,94,0,94,5,5,2020,
7,43959,71,0,71,5,5,2020,
8,43959,34,0,34,5,5,2020,
9,43959,66,0,66,5,5,2020,
10,43959,69,69,138,5,5,2020,
11,43959,47,52,99,5,5,2020,
12,43959,58,0,58,5,5,2020,
13,43959,52,28,80,5,5,2020,
14,43959,32,26,58,5,5,2020,
15,43959,1,134,135,5,5,2020,
16,43959,1,0,1,5,5,2020,
17,43959,1,0,1,5,5,2020,
18,43959,2,43,45,5,5,2020,
19,43959,1,25,26,5,5,2020,
20,43959,9,47,56,5,5,2020,
21,43959,7,69,76,5,5,2020,
22,43959,12,0,12,5,5,2020,
23,43959,1,0,1,5,5,2020,
0,43960,7,0,7,6,5,2020,
1,43960,2,0,2,6,5,2020,
2,43960,2,0,2,6,5,2020,
3,43960,7,0,7,6,5,2020,
4,43960,10,0,10,6,5,2020,
5,43960,28,0,28,6,5,2020,
6,43960,84,0,84,6,5,2020,
7,43960,75,0,75,6,5,2020,
8,43960,21,0,21,6,5,2020,
9,43960,34,40,74,6,5,2020,
10,43960,52,45,97,6,5,2020,
11,43960,58,21,79,6,5,2020,
12,43960,77,26,103,6,5,2020,
13,43960,60,59,119,6,5,2020,
14,43960,14,35,49,6,5,2020,
15,43960,0,101,101,6,5,2020,
16,43960,0,28,28,6,5,2020,
17,43960,0,0,0,6,5,2020,
18,43960,0,0,0,6,5,2020,
19,43960,2,22,24,6,5,2020,
20,43960,0,51,51,6,5,2020,
21,43960,5,49,54,6,5,2020,
22,43960,1,0,1,6,5,2020,
23,43960,0,0,0,6,5,2020,
0,43961,1,0,1,7,5,2020,
1,43961,0,0,0,7,5,2020,
2,43961,1,0,1,7,5,2020,
3,43961,10,0,10,7,5,2020,
4,43961,5,0,5,7,5,2020,
5,43961,23,0,23,7,5,2020,
6,43961,85,0,85,7,5,2020,
7,43961,65,0,65,7,5,2020,
8,43961,32,0,32,7,5,2020,
9,43961,60,44,104,7,5,2020,
10,43961,68,23,91,7,5,2020,
11,43961,40,48,88,7,5,2020,
12,43961,83,9,92,7,5,2020,
13,43961,47,24,71,7,5,2020,
14,43961,12,43,55,7,5,2020,
15,43961,1,78,79,7,5,2020,
16,43961,1,6,7,7,5,2020,
17,43961,0,10,10,7,5,2020,
18,43961,0,57,57,7,5,2020,
19,43961,1,12,13,7,5,2020,
20,43961,0,78,78,7,5,2020,
21,43961,6,96,102,7,5,2020,
22,43961,6,1,7,7,5,2020,
23,43961,2,0,2,7,5,2020,
0,43962,0,0,0,1,5,2020,
1,43962,0,0,0,1,5,2020,
2,43962,0,0,0,1,5,2020,
3,43962,4,0,4,1,5,2020,
4,43962,5,0,5,1,5,2020,
5,43962,23,0,23,1,5,2020,
6,43962,84,0,84,1,5,2020,
7,43962,60,0,60,1,5,2020,
8,43962,25,0,25,1,5,2020,
9,43962,52,33,85,1,5,2020,
10,43962,44,22,66,1,5,2020,
11,43962,48,42,90,1,5,2020,
12,43962,41,0,41,1,5,2020,
13,43962,45,37,82,1,5,2020,
14,43962,22,35,57,1,5,2020,
15,43962,2,184,186,1,5,2020,
16,43962,0,3,3,1,5,2020,
17,43962,1,0,1,1,5,2020,
18,43962,0,49,49,1,5,2020,
19,43962,1,19,20,1,5,2020,
20,43962,2,24,26,1,5,2020,
21,43962,7,100,107,1,5,2020,
22,43962,4,0,4,1,5,2020,
23,43962,8,0,8,1,5,2020,
0,43963,0,0,0,2,5,2020,
1,43963,0,0,0,2,5,2020,
2,43963,0,0,0,2,5,2020,
3,43963,2,0,2,2,5,2020,
4,43963,3,0,3,2,5,2020,
5,43963,42,0,42,2,5,2020,
6,43963,69,0,69,2,5,2020,
7,43963,34,0,34,2,5,2020,
8,43963,18,0,18,2,5,2020,
9,43963,17,48,65,2,5,2020,
10,43963,26,30,56,2,5,2020,
11,43963,57,44,101,2,5,2020,
12,43963,47,0,47,2,5,2020,
13,43963,46,19,65,2,5,2020,
14,43963,24,78,102,2,5,2020,
15,43963,0,119,119,2,5,2020,
16,43963,0,0,0,2,5,2020,
17,43963,0,0,0,2,5,2020,
18,43963,0,68,68,2,5,2020,
19,43963,0,0,0,2,5,2020,
20,43963,0,37,37,2,5,2020,
21,43963,1,96,97,2,5,2020,
22,43963,4,0,4,2,5,2020,
23,43963,4,0,4,2,5,2020,
0,43964,3,0,3,3,5,2020,
1,43964,0,0,0,3,5,2020,
2,43964,1,0,1,3,5,2020,
3,43964,0,0,0,3,5,2020,
4,43964,7,0,7,3,5,2020,
5,43964,26,0,26,3,5,2020,
6,43964,48,0,48,3,5,2020,
7,43964,33,0,33,3,5,2020,
8,43964,20,0,20,3,5,2020,
9,43964,29,57,86,3,5,2020,
10,43964,38,8,46,3,5,2020,
11,43964,46,17,63,3,5,2020,
12,43964,47,1,48,3,5,2020,
13,43964,35,15,50,3,5,2020,
14,43964,22,27,49,3,5,2020,
15,43964,0,51,51,3,5,2020,
16,43964,0,33,33,3,5,2020,
17,43964,0,0,0,3,5,2020,
18,43964,0,37,37,3,5,2020,
19,43964,1,29,30,3,5,2020,
20,43964,0,80,80,3,5,2020,
21,43964,1,19,20,3,5,2020,
22,43964,1,0,1,3,5,2020,
23,43964,0,0,0,3,5,2020,
0,43965,4,0,4,4,5,2020,
1,43965,0,0,0,4,5,2020,
2,43965,0,0,0,4,5,2020,
3,43965,0,0,0,4,5,2020,
4,43965,3,0,3,4,5,2020,
5,43965,26,0,26,4,5,2020,
6,43965,83,0,83,4,5,2020,
7,43965,86,0,86,4,5,2020,
8,43965,34,0,34,4,5,2020,
9,43965,51,25,76,4,5,2020,
10,43965,54,57,111,4,5,2020,
11,43965,43,39,82,4,5,2020,
12,43965,65,0,65,4,5,2020,
13,43965,51,44,95,4,5,2020,
14,43965,18,24,42,4,5,2020,
15,43965,4,92,96,4,5,2020,
16,43965,0,55,55,4,5,2020,
17,43965,1,6,7,4,5,2020,
18,43965,1,25,26,4,5,2020,
19,43965,3,5,8,4,5,2020,
20,43965,3,82,85,4,5,2020,
21,43965,7,80,87,4,5,2020,
22,43965,10,1,11,4,5,2020,
23,43965,8,0,8,4,5,2020,
0,43966,6,0,6,5,5,2020,
1,43966,1,0,1,5,5,2020,
2,43966,15,0,15,5,5,2020,
3,43966,9,0,9,5,5,2020,
4,43966,4,0,4,5,5,2020,
5,43966,50,0,50,5,5,2020,
6,43966,131,0,131,5,5,2020,
7,43966,70,0,70,5,5,2020,
8,43966,59,0,59,5,5,2020,
9,43966,47,39,86,5,5,2020,
10,43966,70,5,75,5,5,2020,
11,43966,31,50,81,5,5,2020,
12,43966,22,22,44,5,5,2020,
13,43966,42,41,83,5,5,2020,
14,43966,26,18,44,5,5,2020,
15,43966,3,180,183,5,5,2020,
16,43966,3,10,13,5,5,2020,
17,43966,0,0,0,5,5,2020,
18,43966,1,15,16,5,5,2020,
19,43966,0,43,43,5,5,2020,
20,43966,1,40,41,5,5,2020,
21,43966,7,101,108,5,5,2020,
22,43966,3,0,3,5,5,2020,
23,43966,6,0,6,5,5,2020,
0,43967,0,0,0,6,5,2020,
1,43967,0,0,0,6,5,2020,
2,43967,1,0,1,6,5,2020,
3,43967,3,0,3,6,5,2020,
4,43967,9,0,9,6,5,2020,
5,43967,51,0,51,6,5,2020,
6,43967,89,0,89,6,5,2020,
7,43967,55,0,55,6,5,2020,
8,43967,57,0,57,6,5,2020,
9,43967,54,48,102,6,5,2020,
10,43967,63,25,88,6,5,2020,
11,43967,73,45,118,6,5,2020,
12,43967,65,0,65,6,5,2020,
13,43967,52,75,127,6,5,2020,
14,43967,15,75,90,6,5,2020,
15,43967,2,176,178,6,5,2020,
16,43967,5,1,6,6,5,2020,
17,43967,0,0,0,6,5,2020,
18,43967,0,0,0,6,5,2020,
19,43967,0,67,67,6,5,2020,
20,43967,3,99,102,6,5,2020,
21,43967,2,43,45,6,5,2020,
22,43967,0,0,0,6,5,2020,
23,43967,0,0,0,6,5,2020,
0,43968,0,0,0,7,5,2020,
1,43968,0,0,0,7,5,2020,
2,43968,1,0,1,7,5,2020,
3,43968,10,0,10,7,5,2020,
4,43968,4,0,4,7,5,2020,
5,43968,45,0,45,7,5,2020,
6,43968,93,0,93,7,5,2020,
7,43968,54,0,54,7,5,2020,
8,43968,36,18,54,7,5,2020,
9,43968,61,55,116,7,5,2020,
10,43968,68,27,95,7,5,2020,
11,43968,73,103,176,7,5,2020,
12,43968,79,1,80,7,5,2020,
13,43968,70,36,106,7,5,2020,
14,43968,39,74,113,7,5,2020,
15,43968,10,219,229,7,5,2020,
16,43968,4,16,20,7,5,2020,
17,43968,0,15,15,7,5,2020,
18,43968,0,31,31,7,5,2020,
19,43968,2,34,36,7,5,2020,
20,43968,7,114,121,7,5,2020,
21,43968,11,87,98,7,5,2020,
22,43968,7,0,7,7,5,2020,
23,43968,6,0,6,7,5,2020,
0,43969,0,0,0,1,5,2020,
1,43969,0,0,0,1,5,2020,
2,43969,0,0,0,1,5,2020,
3,43969,2,0,2,1,5,2020,
4,43969,9,0,9,1,5,2020,
5,43969,16,0,16,1,5,2020,
6,43969,74,0,74,1,5,2020,
7,43969,44,0,44,1,5,2020,
8,43969,55,0,55,1,5,2020,
9,43969,38,51,89,1,5,2020,
10,43969,70,24,94,1,5,2020,
11,43969,43,54,97,1,5,2020,
12,43969,38,0,38,1,5,2020,
13,43969,33,34,67,1,5,2020,
14,43969,19,33,52,1,5,2020,
15,43969,1,114,115,1,5,2020,
16,43969,1,0,1,1,5,2020,
17,43969,0,71,71,1,5,2020,
18,43969,3,66,69,1,5,2020,
19,43969,1,0,1,1,5,2020,
20,43969,5,83,88,1,5,2020,
21,43969,5,70,75,1,5,2020,
22,43969,5,0,5,1,5,2020,
23,43969,3,0,3,1,5,2020,
0,43970,2,0,2,2,5,2020,
1,43970,1,0,1,2,5,2020,
2,43970,4,0,4,2,5,2020,
3,43970,2,0,2,2,5,2020,
4,43970,8,0,8,2,5,2020,
5,43970,38,0,38,2,5,2020,
6,43970,46,0,46,2,5,2020,
7,43970,33,0,33,2,5,2020,
8,43970,52,0,52,2,5,2020,
9,43970,43,69,112,2,5,2020,
10,43970,37,13,50,2,5,2020,
11,43970,64,51,115,2,5,2020,
12,43970,40,0,40,2,5,2020,
13,43970,44,47,91,2,5,2020,
14,43970,20,52,72,2,5,2020,
15,43970,1,108,109,2,5,2020,
16,43970,0,0,0,2,5,2020,
17,43970,0,0,0,2,5,2020,
18,43970,0,30,30,2,5,2020,
19,43970,0,19,19,2,5,2020,
20,43970,21,27,48,2,5,2020,
21,43970,9,110,119,2,5,2020,
22,43970,10,0,10,2,5,2020,
23,43970,9,0,9,2,5,2020,
0,43971,2,0,2,3,5,2020,
1,43971,2,0,2,3,5,2020,
2,43971,0,0,0,3,5,2020,
3,43971,0,0,0,3,5,2020,
4,43971,8,0,8,3,5,2020,
5,43971,6,0,6,3,5,2020,
6,43971,39,0,39,3,5,2020,
7,43971,50,0,50,3,5,2020,
8,43971,54,0,54,3,5,2020,
9,43971,36,33,69,3,5,2020,
10,43971,59,33,92,3,5,2020,
11,43971,46,40,86,3,5,2020,
12,43971,58,0,58,3,5,2020,
13,43971,48,30,78,3,5,2020,
14,43971,37,31,68,3,5,2020,
15,43971,3,69,72,3,5,2020,
16,43971,0,25,25,3,5,2020,
17,43971,1,0,1,3,5,2020,
18,43971,0,22,22,3,5,2020,
19,43971,1,45,46,3,5,2020,
20,43971,5,7,12,3,5,2020,
21,43971,15,67,82,3,5,2020,
22,43971,15,0,15,3,5,2020,
23,43971,8,0,8,3,5,2020,
0,43972,0,0,0,4,5,2020,
1,43972,0,0,0,4,5,2020,
2,43972,1,0,1,4,5,2020,
3,43972,0,0,0,4,5,2020,
4,43972,10,0,10,4,5,2020,
5,43972,34,0,34,4,5,2020,
6,43972,86,0,86,4,5,2020,
7,43972,69,0,69,4,5,2020,
8,43972,59,0,59,4,5,2020,
9,43972,91,22,113,4,5,2020,
10,43972,57,52,109,4,5,2020,
11,43972,53,29,82,4,5,2020,
12,43972,94,0,94,4,5,2020,
13,43972,69,27,96,4,5,2020,
14,43972,32,42,74,4,5,2020,
15,43972,5,127,132,4,5,2020,
16,43972,0,37,37,4,5,2020,
17,43972,1,3,4,4,5,2020,
18,43972,7,36,43,4,5,2020,
19,43972,3,0,3,4,5,2020,
20,43972,17,61,78,4,5,2020,
21,43972,9,73,82,4,5,2020,
22,43972,14,0,14,4,5,2020,
23,43972,8,0,8,4,5,2020,
0,43973,16,0,16,5,5,2020,
1,43973,17,0,17,5,5,2020,
2,43973,17,0,17,5,5,2020,
3,43973,24,0,24,5,5,2020,
4,43973,16,0,16,5,5,2020,
5,43973,98,0,98,5,5,2020,
6,43973,122,0,122,5,5,2020,
7,43973,65,0,65,5,5,2020,
8,43973,53,0,53,5,5,2020,
9,43973,97,42,139,5,5,2020,
10,43973,90,10,100,5,5,2020,
11,43973,79,57,136,5,5,2020,
12,43973,61,21,82,5,5,2020,
13,43973,76,24,100,5,5,2020,
14,43973,65,32,97,5,5,2020,
15,43973,1,158,159,5,5,2020,
16,43973,0,31,31,5,5,2020,
17,43973,0,0,0,5,5,2020,
18,43973,0,38,38,5,5,2020,
19,43973,2,1,3,5,5,2020,
20,43973,1,30,31,5,5,2020,
21,43973,4,151,155,5,5,2020,
22,43973,23,0,23,5,5,2020,
23,43973,5,0,5,5,5,2020,
0,43974,3,0,3,6,5,2020,
1,43974,4,0,4,6,5,2020,
2,43974,10,0,10,6,5,2020,
3,43974,1,0,1,6,5,2020,
4,43974,7,0,7,6,5,2020,
5,43974,52,0,52,6,5,2020,
6,43974,84,0,84,6,5,2020,
7,43974,110,0,110,6,5,2020,
8,43974,71,0,71,6,5,2020,
9,43974,72,4,76,6,5,2020,
10,43974,51,88,139,6,5,2020,
11,43974,68,66,134,6,5,2020,
12,43974,88,2,90,6,5,2020,
13,43974,68,41,109,6,5,2020,
14,43974,58,53,111,6,5,2020,
15,43974,3,217,220,6,5,2020,
16,43974,2,2,4,6,5,2020,
17,43974,2,0,2,6,5,2020,
18,43974,0,69,69,6,5,2020,
19,43974,2,37,39,6,5,2020,
20,43974,12,38,50,6,5,2020,
21,43974,9,68,77,6,5,2020,
22,43974,11,0,11,6,5,2020,
23,43974,0,0,0,6,5,2020,
0,43975,1,0,1,7,5,2020,
1,43975,2,0,2,7,5,2020,
2,43975,1,0,1,7,5,2020,
3,43975,0,0,0,7,5,2020,
4,43975,14,0,14,7,5,2020,
5,43975,50,0,50,7,5,2020,
6,43975,104,0,104,7,5,2020,
7,43975,89,0,89,7,5,2020,
8,43975,71,0,71,7,5,2020,
9,43975,108,48,156,7,5,2020,
10,43975,94,17,111,7,5,2020,
11,43975,90,64,154,7,5,2020,
12,43975,102,35,137,7,5,2020,
13,43975,81,34,115,7,5,2020,
14,43975,58,100,158,7,5,2020,
15,43975,3,259,262,7,5,2020,
16,43975,0,42,42,7,5,2020,
17,43975,0,0,0,7,5,2020,
18,43975,12,66,78,7,5,2020,
19,43975,9,3,12,7,5,2020,
20,43975,3,41,44,7,5,2020,
21,43975,0,167,167,7,5,2020,
22,43975,6,0,6,7,5,2020,
23,43975,3,0,3,7,5,2020,
0,43976,0,0,0,1,5,2020,
1,43976,0,0,0,1,5,2020,
2,43976,4,0,4,1,5,2020,
3,43976,1,0,1,1,5,2020,
4,43976,11,0,11,1,5,2020,
5,43976,52,0,52,1,5,2020,
6,43976,87,0,87,1,5,2020,
7,43976,52,0,52,1,5,2020,
8,43976,52,0,52,1,5,2020,
9,43976,69,66,135,1,5,2020,
10,43976,78,26,104,1,5,2020,
11,43976,58,90,148,1,5,2020,
12,43976,39,30,69,1,5,2020,
13,43976,39,37,76,1,5,2020,
14,43976,20,56,76,1,5,2020,
15,43976,1,260,261,1,5,2020,
16,43976,1,26,27,1,5,2020,
17,43976,4,14,18,1,5,2020,
18,43976,2,67,69,1,5,2020,
19,43976,0,0,0,1,5,2020,
20,43976,3,93,96,1,5,2020,
21,43976,9,127,136,1,5,2020,
22,43976,19,0,19,1,5,2020,
23,43976,19,0,19,1,5,2020,
0,43977,1,0,1,2,5,2020,
1,43977,0,0,0,2,5,2020,
2,43977,1,0,1,2,5,2020,
3,43977,7,0,7,2,5,2020,
4,43977,18,0,18,2,5,2020,
5,43977,42,0,42,2,5,2020,
6,43977,67,0,67,2,5,2020,
7,43977,79,0,79,2,5,2020,
8,43977,55,0,55,2,5,2020,
9,43977,49,0,49,2,5,2020,
10,43977,61,93,154,2,5,2020,
11,43977,67,58,125,2,5,2020,
12,43977,55,67,122,2,5,2020,
13,43977,61,56,117,2,5,2020,
14,43977,18,47,65,2,5,2020,
15,43977,0,207,207,2,5,2020,
16,43977,0,0,0,2,5,2020,
17,43977,7,0,7,2,5,2020,
18,43977,0,33,33,2,5,2020,
19,43977,0,37,37,2,5,2020,
20,43977,6,54,60,2,5,2020,
21,43977,15,73,88,2,5,2020,
22,43977,5,0,5,2,5,2020,
23,43977,1,0,1,2,5,2020,
0,43978,0,0,0,3,5,2020,
1,43978,1,0,1,3,5,2020,
2,43978,1,0,1,3,5,2020,
3,43978,4,0,4,3,5,2020,
4,43978,21,0,21,3,5,2020,
5,43978,39,0,39,3,5,2020,
6,43978,64,0,64,3,5,2020,
7,43978,59,0,59,3,5,2020,
8,43978,51,0,51,3,5,2020,
9,43978,39,0,39,3,5,2020,
10,43978,51,64,115,3,5,2020,
11,43978,22,47,69,3,5,2020,
12,43978,39,3,42,3,5,2020,
13,43978,23,17,40,3,5,2020,
14,43978,37,6,43,3,5,2020,
15,43978,4,178,182,3,5,2020,
16,43978,2,10,12,3,5,2020,
17,43978,0,10,10,3,5,2020,
18,43978,1,33,34,3,5,2020,
19,43978,0,70,70,3,5,2020,
20,43978,4,40,44,3,5,2020,
21,43978,7,11,18,3,5,2020,
22,43978,10,0,10,3,5,2020,
23,43978,14,0,14,3,5,2020,
0,43979,1,0,1,4,5,2020,
1,43979,0,0,0,4,5,2020,
2,43979,1,0,1,4,5,2020,
3,43979,3,0,3,4,5,2020,
4,43979,9,0,9,4,5,2020,
5,43979,78,0,78,4,5,2020,
6,43979,121,0,121,4,5,2020,
7,43979,64,0,64,4,5,2020,
8,43979,100,0,100,4,5,2020,
9,43979,69,37,106,4,5,2020,
10,43979,73,29,102,4,5,2020,
11,43979,75,34,109,4,5,2020,
12,43979,75,58,133,4,5,2020,
13,43979,52,47,99,4,5,2020,
14,43979,46,33,79,4,5,2020,
15,43979,1,126,127,4,5,2020,
16,43979,1,63,64,4,5,2020,
17,43979,2,19,21,4,5,2020,
18,43979,0,24,24,4,5,2020,
19,43979,0,21,21,4,5,2020,
20,43979,8,11,19,4,5,2020,
21,43979,7,116,123,4,5,2020,
22,43979,28,0,28,4,5,2020,
23,43979,6,0,6,4,5,2020,
0,43980,13,0,13,5,5,2020,
1,43980,16,0,16,5,5,2020,
2,43980,17,0,17,5,5,2020,
3,43980,16,0,16,5,5,2020,
4,43980,12,0,12,5,5,2020,
5,43980,60,0,60,5,5,2020,
6,43980,122,0,122,5,5,2020,
7,43980,68,0,68,5,5,2020,
8,43980,59,0,59,5,5,2020,
9,43980,56,28,84,5,5,2020,
10,43980,101,9,110,5,5,2020,
11,43980,39,70,109,5,5,2020,
12,43980,64,45,109,5,5,2020,
13,43980,47,30,77,5,5,2020,
14,43980,26,81,107,5,5,2020,
15,43980,1,117,118,5,5,2020,
16,43980,0,25,25,5,5,2020,
17,43980,0,9,9,5,5,2020,
18,43980,0,0,0,5,5,2020,
19,43980,2,85,87,5,5,2020,
20,43980,6,93,99,5,5,2020,
21,43980,12,33,45,5,5,2020,
22,43980,17,3,20,5,5,2020,
23,43980,3,0,3,5,5,2020,
0,43981,0,0,0,6,5,2020,
1,43981,0,0,0,6,5,2020,
2,43981,0,0,0,6,5,2020,
3,43981,5,0,5,6,5,2020,
4,43981,15,0,15,6,5,2020,
5,43981,41,0,41,6,5,2020,
6,43981,139,0,139,6,5,2020,
7,43981,135,0,135,6,5,2020,
8,43981,103,0,103,6,5,2020,
9,43981,96,54,150,6,5,2020,
10,43981,91,14,105,6,5,2020,
11,43981,55,58,113,6,5,2020,
12,43981,82,65,147,6,5,2020,
13,43981,70,32,102,6,5,2020,
14,43981,35,95,130,6,5,2020,
15,43981,2,192,194,6,5,2020,
16,43981,0,74,74,6,5,2020,
17,43981,2,0,2,6,5,2020,
18,43981,0,29,29,6,5,2020,
19,43981,3,77,80,6,5,2020,
20,43981,3,26,29,6,5,2020,
21,43981,11,52,63,6,5,2020,
22,43981,4,0,4,6,5,2020,
23,43981,3,0,3,6,5,2020,
0,43982,0,0,0,7,5,2020,
1,43982,0,0,0,7,5,2020,
2,43982,0,0,0,7,5,2020,
3,43982,1,0,1,7,5,2020,
4,43982,10,0,10,7,5,2020,
5,43982,57,0,57,7,5,2020,
6,43982,115,0,115,7,5,2020,
7,43982,56,0,56,7,5,2020,
8,43982,64,0,64,7,5,2020,
9,43982,87,59,146,7,5,2020,
10,43982,100,10,110,7,5,2020,
11,43982,73,67,140,7,5,2020,
12,43982,64,74,138,7,5,2020,
13,43982,66,57,123,7,5,2020,
14,43982,44,102,146,7,5,2020,
15,43982,1,200,201,7,5,2020,
16,43982,0,15,15,7,5,2020,
17,43982,7,0,7,7,5,2020,
18,43982,1,55,56,7,5,2020,
19,43982,11,114,125,7,5,2020,
20,43982,21,111,132,7,5,2020,
21,43982,13,74,87,7,5,2020,
22,43982,30,50,80,7,5,2020,
23,43982,22,4,26,7,5,2020,
0,43983,18,0,18,1,6,2020,
1,43983,17,0,17,1,6,2020,
2,43983,17,0,17,1,6,2020,
3,43983,18,0,18,1,6,2020,
4,43983,40,0,40,1,6,2020,
5,43983,110,0,110,1,6,2020,
6,43983,123,0,123,1,6,2020,
7,43983,88,0,88,1,6,2020,
8,43983,73,100,173,1,6,2020,
9,43983,115,40,155,1,6,2020,
10,43983,97,3,100,1,6,2020,
11,43983,83,98,181,1,6,2020,
12,43983,79,122,201,1,6,2020,
13,43983,65,48,113,1,6,2020,
14,43983,80,84,164,1,6,2020,
15,43983,26,213,239,1,6,2020,
16,43983,6,85,91,1,6,2020,
17,43983,1,0,1,1,6,2020,
18,43983,4,36,40,1,6,2020,
19,43983,12,59,71,1,6,2020,
20,43983,30,112,142,1,6,2020,
21,43983,23,128,151,1,6,2020,
22,43983,24,35,59,1,6,2020,
23,43983,6,1,7,1,6,2020,
0,43984,4,0,4,2,6,2020,
1,43984,5,0,5,2,6,2020,
2,43984,51,0,51,2,6,2020,
3,43984,24,0,24,2,6,2020,
4,43984,41,0,41,2,6,2020,
5,43984,123,0,123,2,6,2020,
6,43984,113,0,113,2,6,2020,
7,43984,80,0,80,2,6,2020,
8,43984,60,32,92,2,6,2020,
9,43984,64,47,111,2,6,2020,
10,43984,102,0,102,2,6,2020,
11,43984,77,90,167,2,6,2020,
12,43984,97,75,172,2,6,2020,
13,43984,87,40,127,2,6,2020,
14,43984,19,106,125,2,6,2020,
15,43984,8,138,146,2,6,2020,
16,43984,13,73,86,2,6,2020,
17,43984,6,0,6,2,6,2020,
18,43984,8,30,38,2,6,2020,
19,43984,14,84,98,2,6,2020,
20,43984,26,65,91,2,6,2020,
21,43984,40,95,135,2,6,2020,
22,43984,14,28,42,2,6,2020,
23,43984,3,30,33,2,6,2020,
0,43985,7,0,7,3,6,2020,
1,43985,8,0,8,3,6,2020,
2,43985,2,0,2,3,6,2020,
3,43985,3,0,3,3,6,2020,
4,43985,30,0,30,3,6,2020,
5,43985,79,0,79,3,6,2020,
6,43985,126,0,126,3,6,2020,
7,43985,122,0,122,3,6,2020,
8,43985,98,26,124,3,6,2020,
9,43985,84,43,127,3,6,2020,
10,43985,83,2,85,3,6,2020,
11,43985,58,90,148,3,6,2020,
12,43985,50,5,55,3,6,2020,
13,43985,74,22,96,3,6,2020,
14,43985,47,42,89,3,6,2020,
15,43985,15,213,228,3,6,2020,
16,43985,12,76,88,3,6,2020,
17,43985,18,0,18,3,6,2020,
18,43985,8,35,43,3,6,2020,
19,43985,5,82,87,3,6,2020,
20,43985,48,19,67,3,6,2020,
21,43985,54,55,109,3,6,2020,
22,43985,52,40,92,3,6,2020,
23,43985,6,15,21,3,6,2020,
0,43986,1,0,1,4,6,2020,
1,43986,9,0,9,4,6,2020,
2,43986,9,0,9,4,6,2020,
3,43986,38,0,38,4,6,2020,
4,43986,65,0,65,4,6,2020,
5,43986,125,0,125,4,6,2020,
6,43986,139,0,139,4,6,2020,
7,43986,97,0,97,4,6,2020,
8,43986,156,8,164,4,6,2020,
9,43986,83,32,115,4,6,2020,
10,43986,117,2,119,4,6,2020,
11,43986,69,87,156,4,6,2020,
12,43986,100,28,128,4,6,2020,
13,43986,85,14,99,4,6,2020,
14,43986,38,97,135,4,6,2020,
15,43986,13,68,81,4,6,2020,
16,43986,12,179,191,4,6,2020,
17,43986,20,2,22,4,6,2020,
18,43986,9,47,56,4,6,2020,
19,43986,23,53,76,4,6,2020,
20,43986,32,50,82,4,6,2020,
21,43986,58,46,104,4,6,2020,
22,43986,42,17,59,4,6,2020,
23,43986,28,17,45,4,6,2020,
0,43987,11,0,11,5,6,2020,
1,43987,5,0,5,5,6,2020,
2,43987,22,0,22,5,6,2020,
3,43987,33,0,33,5,6,2020,
4,43987,96,0,96,5,6,2020,
5,43987,154,0,154,5,6,2020,
6,43987,134,0,134,5,6,2020,
7,43987,167,0,167,5,6,2020,
8,43987,75,76,151,5,6,2020,
9,43987,87,16,103,5,6,2020,
10,43987,104,17,121,5,6,2020,
11,43987,76,71,147,5,6,2020,
12,43987,97,32,129,5,6,2020,
13,43987,124,43,167,5,6,2020,
14,43987,73,128,201,5,6,2020,
15,43987,9,129,138,5,6,2020,
16,43987,14,27,41,5,6,2020,
17,43987,18,0,18,5,6,2020,
18,43987,6,29,35,5,6,2020,
19,43987,11,57,68,5,6,2020,
20,43987,39,19,58,5,6,2020,
21,43987,66,63,129,5,6,2020,
22,43987,25,62,87,5,6,2020,
23,43987,10,18,28,5,6,2020,
0,43988,11,0,11,6,6,2020,
1,43988,5,0,5,6,6,2020,
2,43988,12,0,12,6,6,2020,
3,43988,13,0,13,6,6,2020,
4,43988,57,0,57,6,6,2020,
5,43988,160,0,160,6,6,2020,
6,43988,152,0,152,6,6,2020,
7,43988,153,0,153,6,6,2020,
8,43988,139,20,159,6,6,2020,
9,43988,132,33,165,6,6,2020,
10,43988,158,0,158,6,6,2020,
11,43988,83,143,226,6,6,2020,
12,43988,109,47,156,6,6,2020,
13,43988,108,74,182,6,6,2020,
14,43988,79,116,195,6,6,2020,
15,43988,26,187,213,6,6,2020,
16,43988,23,168,191,6,6,2020,
17,43988,8,52,60,6,6,2020,
18,43988,13,45,58,6,6,2020,
19,43988,8,59,67,6,6,2020,
20,43988,26,110,136,6,6,2020,
21,43988,40,70,110,6,6,2020,
22,43988,20,47,67,6,6,2020,
23,43988,3,20,23,6,6,2020,
0,43989,1,0,1,7,6,2020,
1,43989,10,0,10,7,6,2020,
2,43989,14,0,14,7,6,2020,
3,43989,29,0,29,7,6,2020,
4,43989,40,0,40,7,6,2020,
5,43989,134,0,134,7,6,2020,
6,43989,150,0,150,7,6,2020,
7,43989,124,0,124,7,6,2020,
8,43989,110,68,178,7,6,2020,
9,43989,139,60,199,7,6,2020,
10,43989,113,25,138,7,6,2020,
11,43989,78,121,199,7,6,2020,
12,43989,76,35,111,7,6,2020,
13,43989,115,80,195,7,6,2020,
14,43989,73,205,278,7,6,2020,
15,43989,27,221,248,7,6,2020,
16,43989,25,152,177,7,6,2020,
17,43989,12,11,23,7,6,2020,
18,43989,18,139,157,7,6,2020,
19,43989,9,51,60,7,6,2020,
20,43989,23,54,77,7,6,2020,
21,43989,52,93,145,7,6,2020,
22,43989,26,39,65,7,6,2020,
23,43989,52,82,134,7,6,2020,
0,43990,20,0,20,1,6,2020,
1,43990,14,0,14,1,6,2020,
2,43990,10,0,10,1,6,2020,
3,43990,26,0,26,1,6,2020,
4,43990,88,0,88,1,6,2020,
5,43990,85,0,85,1,6,2020,
6,43990,123,0,123,1,6,2020,
7,43990,84,0,84,1,6,2020,
8,43990,46,80,126,1,6,2020,
9,43990,57,54,111,1,6,2020,
10,43990,49,6,55,1,6,2020,
11,43990,54,131,185,1,6,2020,
12,43990,71,53,124,1,6,2020,
13,43990,71,86,157,1,6,2020,
14,43990,20,140,160,1,6,2020,
15,43990,11,158,169,1,6,2020,
16,43990,13,90,103,1,6,2020,
17,43990,7,0,7,1,6,2020,
18,43990,10,53,63,1,6,2020,
19,43990,1,92,93,1,6,2020,
20,43990,35,85,120,1,6,2020,
21,43990,38,53,91,1,6,2020,
22,43990,29,46,75,1,6,2020,
23,43990,2,41,43,1,6,2020,
0,43991,5,0,5,2,6,2020,
1,43991,10,0,10,2,6,2020,
2,43991,16,0,16,2,6,2020,
3,43991,16,0,16,2,6,2020,
4,43991,54,0,54,2,6,2020,
5,43991,123,0,123,2,6,2020,
6,43991,104,0,104,2,6,2020,
7,43991,99,0,99,2,6,2020,
8,43991,58,28,86,2,6,2020,
9,43991,106,35,141,2,6,2020,
10,43991,71,3,74,2,6,2020,
11,43991,70,84,154,2,6,2020,
12,43991,66,86,152,2,6,2020,
13,43991,76,76,152,2,6,2020,
14,43991,35,91,126,2,6,2020,
15,43991,12,113,125,2,6,2020,
16,43991,6,22,28,2,6,2020,
17,43991,1,1,2,2,6,2020,
18,43991,3,50,53,2,6,2020,
19,43991,18,31,49,2,6,2020,
20,43991,28,69,97,2,6,2020,
21,43991,54,45,99,2,6,2020,
22,43991,42,25,67,2,6,2020,
23,43991,10,31,41,2,6,2020,
