Time,Date,SB,NB,Total,Day,Month,Year
0,1/1/2019,32,85,117,2,1,2019
1,1/1/2019,30,47,77,2,1,2019
2,1/1/2019,45,0,45,2,1,2019
3,1/1/2019,65,0,65,2,1,2019
4,1/1/2019,99,1,100,2,1,2019
5,1/1/2019,153,0,153,2,1,2019
6,1/1/2019,272,37,309,2,1,2019
7,1/1/2019,328,134,462,2,1,2019
8,1/1/2019,178,468,646,2,1,2019
9,1/1/2019,225,354,579,2,1,2019
10,1/1/2019,295,226,521,2,1,2019
11,1/1/2019,306,279,585,2,1,2019
12,1/1/2019,280,399,679,2,1,2019
13,1/1/2019,287,523,810,2,1,2019
14,1/1/2019,247,163,410,2,1,2019
15,1/1/2019,286,270,556,2,1,2019
16,1/1/2019,190,539,729,2,1,2019
17,1/1/2019,144,490,634,2,1,2019
18,1/1/2019,67,365,432,2,1,2019
19,1/1/2019,73,225,298,2,1,2019
20,1/1/2019,217,278,495,2,1,2019
21,1/1/2019,294,312,606,2,1,2019
22,1/1/2019,361,521,882,2,1,2019
23,1/1/2019,317,377,694,2,1,2019
0,1/2/2019,183,411,594,3,1,2019
1,1/2/2019,15,273,288,3,1,2019
2,1/2/2019,49,5,54,3,1,2019
3,1/2/2019,94,0,94,3,1,2019
4,1/2/2019,86,0,86,3,1,2019
5,1/2/2019,210,0,210,3,1,2019
6,1/2/2019,340,29,369,3,1,2019
7,1/2/2019,215,203,418,3,1,2019
8,1/2/2019,166,588,754,3,1,2019
9,1/2/2019,200,121,321,3,1,2019
10,1/2/2019,317,191,508,3,1,2019
11,1/2/2019,341,290,631,3,1,2019
12,1/2/2019,319,453,772,3,1,2019
13,1/2/2019,307,173,480,3,1,2019
14,1/2/2019,298,359,657,3,1,2019
15,1/2/2019,313,624,937,3,1,2019
16,1/2/2019,299,265,564,3,1,2019
17,1/2/2019,316,285,601,3,1,2019
18,1/2/2019,175,493,668,3,1,2019
19,1/2/2019,78,374,452,3,1,2019
20,1/2/2019,196,181,377,3,1,2019
21,1/2/2019,343,223,566,3,1,2019
22,1/2/2019,382,348,730,3,1,2019
23,1/2/2019,435,556,991,3,1,2019
0,1/3/2019,209,228,437,4,1,2019
1,1/3/2019,58,314,372,4,1,2019
2,1/3/2019,65,112,177,4,1,2019
3,1/3/2019,105,166,271,4,1,2019
4,1/3/2019,78,25,103,4,1,2019
5,1/3/2019,195,10,205,4,1,2019
6,1/3/2019,372,35,407,4,1,2019
7,1/3/2019,438,222,660,4,1,2019
8,1/3/2019,186,719,905,4,1,2019
9,1/3/2019,222,255,477,4,1,2019
10,1/3/2019,246,486,732,4,1,2019
11,1/3/2019,314,360,674,4,1,2019
12,1/3/2019,248,131,379,4,1,2019
13,1/3/2019,274,337,611,4,1,2019
14,1/3/2019,394,143,537,4,1,2019
15,1/3/2019,306,354,660,4,1,2019
16,1/3/2019,294,247,541,4,1,2019
17,1/3/2019,270,530,800,4,1,2019
18,1/3/2019,109,306,415,4,1,2019
19,1/3/2019,129,529,658,4,1,2019
20,1/3/2019,263,174,437,4,1,2019
21,1/3/2019,408,303,711,4,1,2019
22,1/3/2019,433,320,753,4,1,2019
23,1/3/2019,346,186,532,4,1,2019
0,1/4/2019,213,322,535,5,1,2019
1,1/4/2019,85,574,659,5,1,2019
2,1/4/2019,53,146,199,5,1,2019
3,1/4/2019,76,327,403,5,1,2019
4,1/4/2019,143,4,147,5,1,2019
5,1/4/2019,235,68,303,5,1,2019
6,1/4/2019,404,37,441,5,1,2019
7,1/4/2019,301,316,617,5,1,2019
8,1/4/2019,236,695,931,5,1,2019
9,1/4/2019,246,420,666,5,1,2019
10,1/4/2019,348,298,646,5,1,2019
11,1/4/2019,389,518,907,5,1,2019
12,1/4/2019,324,310,634,5,1,2019
13,1/4/2019,296,398,694,5,1,2019
14,1/4/2019,273,375,648,5,1,2019
15,1/4/2019,374,427,801,5,1,2019
16,1/4/2019,353,454,807,5,1,2019
17,1/4/2019,218,278,496,5,1,2019
18,1/4/2019,102,362,464,5,1,2019
19,1/4/2019,105,360,465,5,1,2019
20,1/4/2019,236,326,562,5,1,2019
21,1/4/2019,391,477,868,5,1,2019
22,1/4/2019,374,178,552,5,1,2019
23,1/4/2019,349,693,1042,5,1,2019
0,1/5/2019,228,316,544,6,1,2019
1,1/5/2019,35,353,388,6,1,2019
2,1/5/2019,71,197,268,6,1,2019
3,1/5/2019,131,4,135,6,1,2019
4,1/5/2019,139,0,139,6,1,2019
5,1/5/2019,211,0,211,6,1,2019
6,1/5/2019,446,161,607,6,1,2019
7,1/5/2019,410,225,635,6,1,2019
8,1/5/2019,304,707,1011,6,1,2019
9,1/5/2019,216,551,767,6,1,2019
10,1/5/2019,269,246,515,6,1,2019
11,1/5/2019,301,392,693,6,1,2019
12,1/5/2019,227,452,679,6,1,2019
13,1/5/2019,262,729,991,6,1,2019
14,1/5/2019,337,195,532,6,1,2019
15,1/5/2019,316,407,723,6,1,2019
16,1/5/2019,337,367,704,6,1,2019
17,1/5/2019,361,619,980,6,1,2019
18,1/5/2019,117,405,522,6,1,2019
19,1/5/2019,93,697,790,6,1,2019
20,1/5/2019,254,371,625,6,1,2019
21,1/5/2019,483,310,793,6,1,2019
22,1/5/2019,327,401,728,6,1,2019
23,1/5/2019,322,559,881,6,1,2019
0,1/6/2019,98,591,689,7,1,2019
1,1/6/2019,28,404,432,7,1,2019
2,1/6/2019,54,67,121,7,1,2019
3,1/6/2019,86,35,121,7,1,2019
4,1/6/2019,104,29,133,7,1,2019
5,1/6/2019,144,0,144,7,1,2019
6,1/6/2019,314,27,341,7,1,2019
7,1/6/2019,289,375,664,7,1,2019
8,1/6/2019,221,547,768,7,1,2019
9,1/6/2019,124,487,611,7,1,2019
10,1/6/2019,211,329,540,7,1,2019
11,1/6/2019,292,418,710,7,1,2019
12,1/6/2019,261,285,546,7,1,2019
13,1/6/2019,370,781,1151,7,1,2019
14,1/6/2019,288,266,554,7,1,2019
15,1/6/2019,292,509,801,7,1,2019
16,1/6/2019,340,425,765,7,1,2019
17,1/6/2019,206,357,563,7,1,2019
18,1/6/2019,88,379,467,7,1,2019
19,1/6/2019,111,508,619,7,1,2019
20,1/6/2019,215,373,588,7,1,2019
21,1/6/2019,309,544,853,7,1,2019
22,1/6/2019,366,316,682,7,1,2019
23,1/6/2019,152,662,814,7,1,2019
0,1/7/2019,55,630,685,1,1,2019
1,1/7/2019,30,259,289,1,1,2019
2,1/7/2019,19,67,86,1,1,2019
3,1/7/2019,67,0,67,1,1,2019
4,1/7/2019,86,0,86,1,1,2019
5,1/7/2019,141,0,141,1,1,2019
6,1/7/2019,215,136,351,1,1,2019
7,1/7/2019,267,318,585,1,1,2019
8,1/7/2019,194,608,802,1,1,2019
9,1/7/2019,211,562,773,1,1,2019
10,1/7/2019,207,307,514,1,1,2019
11,1/7/2019,214,481,695,1,1,2019
12,1/7/2019,175,242,417,1,1,2019
13,1/7/2019,249,405,654,1,1,2019
14,1/7/2019,186,197,383,1,1,2019
15,1/7/2019,233,421,654,1,1,2019
16,1/7/2019,227,186,413,1,1,2019
17,1/7/2019,152,617,769,1,1,2019
18,1/7/2019,54,582,636,1,1,2019
19,1/7/2019,96,652,748,1,1,2019
20,1/7/2019,165,303,468,1,1,2019
21,1/7/2019,222,283,505,1,1,2019
22,1/7/2019,273,275,548,1,1,2019
23,1/7/2019,167,465,632,1,1,2019
0,1/8/2019,71,412,483,2,1,2019
1,1/8/2019,20,263,283,2,1,2019
2,1/8/2019,57,9,66,2,1,2019
3,1/8/2019,91,0,91,2,1,2019
4,1/8/2019,72,0,72,2,1,2019
5,1/8/2019,115,0,115,2,1,2019
6,1/8/2019,235,51,286,2,1,2019
7,1/8/2019,180,307,487,2,1,2019
8,1/8/2019,163,398,561,2,1,2019
9,1/8/2019,136,625,761,2,1,2019
10,1/8/2019,178,250,428,2,1,2019
11,1/8/2019,186,332,518,2,1,2019
12,1/8/2019,109,424,533,2,1,2019
13,1/8/2019,183,448,631,2,1,2019
14,1/8/2019,165,105,270,2,1,2019
15,1/8/2019,133,432,565,2,1,2019
16,1/8/2019,88,299,387,2,1,2019
17,1/8/2019,123,362,485,2,1,2019
18,1/8/2019,32,301,333,2,1,2019
19,1/8/2019,61,332,393,2,1,2019
20,1/8/2019,109,232,341,2,1,2019
21,1/8/2019,227,412,639,2,1,2019
22,1/8/2019,233,330,563,2,1,2019
23,1/8/2019,143,348,491,2,1,2019
0,1/9/2019,35,225,260,3,1,2019
1,1/9/2019,7,77,84,3,1,2019
2,1/9/2019,26,0,26,3,1,2019
3,1/9/2019,46,1,47,3,1,2019
4,1/9/2019,50,0,50,3,1,2019
5,1/9/2019,159,0,159,3,1,2019
6,1/9/2019,175,97,272,3,1,2019
7,1/9/2019,158,217,375,3,1,2019
8,1/9/2019,82,569,651,3,1,2019
9,1/9/2019,111,403,514,3,1,2019
10,1/9/2019,125,131,256,3,1,2019
11,1/9/2019,96,363,459,3,1,2019
12,1/9/2019,126,326,452,3,1,2019
13,1/9/2019,98,283,381,3,1,2019
14,1/9/2019,180,119,299,3,1,2019
15,1/9/2019,119,141,260,3,1,2019
16,1/9/2019,67,193,260,3,1,2019
17,1/9/2019,87,305,392,3,1,2019
18,1/9/2019,16,429,445,3,1,2019
19,1/9/2019,59,348,407,3,1,2019
20,1/9/2019,114,188,302,3,1,2019
21,1/9/2019,257,227,484,3,1,2019
22,1/9/2019,265,278,543,3,1,2019
23,1/9/2019,178,402,580,3,1,2019
0,1/10/2019,103,249,352,4,1,2019
1,1/10/2019,27,19,46,4,1,2019
2,1/10/2019,13,0,13,4,1,2019
3,1/10/2019,74,1,75,4,1,2019
4,1/10/2019,70,0,70,4,1,2019
5,1/10/2019,167,0,167,4,1,2019
6,1/10/2019,239,67,306,4,1,2019
7,1/10/2019,287,269,556,4,1,2019
8,1/10/2019,131,432,563,4,1,2019
9,1/10/2019,123,423,546,4,1,2019
10,1/10/2019,185,170,355,4,1,2019
11,1/10/2019,167,254,421,4,1,2019
12,1/10/2019,81,307,388,4,1,2019
13,1/10/2019,121,335,456,4,1,2019
14,1/10/2019,117,209,326,4,1,2019
15,1/10/2019,75,238,313,4,1,2019
16,1/10/2019,105,212,317,4,1,2019
17,1/10/2019,105,197,302,4,1,2019
18,1/10/2019,26,251,277,4,1,2019
19,1/10/2019,35,213,248,4,1,2019
20,1/10/2019,153,292,445,4,1,2019
21,1/10/2019,302,292,594,4,1,2019
22,1/10/2019,277,146,423,4,1,2019
23,1/10/2019,194,207,401,4,1,2019
0,1/11/2019,129,257,386,5,1,2019
1,1/11/2019,52,0,52,5,1,2019
2,1/11/2019,25,0,25,5,1,2019
3,1/11/2019,58,0,58,5,1,2019
4,1/11/2019,82,0,82,5,1,2019
5,1/11/2019,197,0,197,5,1,2019
6,1/11/2019,279,17,296,5,1,2019
7,1/11/2019,255,362,617,5,1,2019
8,1/11/2019,95,518,613,5,1,2019
9,1/11/2019,127,465,592,5,1,2019
10,1/11/2019,168,253,421,5,1,2019
11,1/11/2019,160,223,383,5,1,2019
12,1/11/2019,111,179,290,5,1,2019
13,1/11/2019,86,309,395,5,1,2019
14,1/11/2019,96,175,271,5,1,2019
15,1/11/2019,72,272,344,5,1,2019
16,1/11/2019,82,217,299,5,1,2019
17,1/11/2019,99,147,246,5,1,2019
18,1/11/2019,45,285,330,5,1,2019
19,1/11/2019,39,248,287,5,1,2019
20,1/11/2019,124,217,341,5,1,2019
21,1/11/2019,311,271,582,5,1,2019
22,1/11/2019,249,272,521,5,1,2019
23,1/11/2019,247,343,590,5,1,2019
0,1/12/2019,192,260,452,6,1,2019
1,1/12/2019,46,75,121,6,1,2019
2,1/12/2019,28,40,68,6,1,2019
3,1/12/2019,56,0,56,6,1,2019
4,1/12/2019,53,0,53,6,1,2019
5,1/12/2019,102,1,103,6,1,2019
6,1/12/2019,258,38,296,6,1,2019
7,1/12/2019,281,253,534,6,1,2019
8,1/12/2019,167,492,659,6,1,2019
9,1/12/2019,175,508,683,6,1,2019
10,1/12/2019,158,293,451,6,1,2019
11,1/12/2019,109,296,405,6,1,2019
12,1/12/2019,84,337,421,6,1,2019
13,1/12/2019,125,271,396,6,1,2019
14,1/12/2019,130,141,271,6,1,2019
15,1/12/2019,98,188,286,6,1,2019
16,1/12/2019,140,502,642,6,1,2019
17,1/12/2019,59,288,347,6,1,2019
18,1/12/2019,26,372,398,6,1,2019
19,1/12/2019,55,497,552,6,1,2019
20,1/12/2019,122,62,184,6,1,2019
21,1/12/2019,167,333,500,6,1,2019
22,1/12/2019,204,174,378,6,1,2019
23,1/12/2019,92,345,437,6,1,2019
0,1/13/2019,39,191,230,7,1,2019
1,1/13/2019,14,0,14,7,1,2019
2,1/13/2019,21,0,21,7,1,2019
3,1/13/2019,83,0,83,7,1,2019
4,1/13/2019,86,0,86,7,1,2019
5,1/13/2019,121,0,121,7,1,2019
6,1/13/2019,224,112,336,7,1,2019
7,1/13/2019,194,366,560,7,1,2019
8,1/13/2019,87,536,623,7,1,2019
9,1/13/2019,76,375,451,7,1,2019
10,1/13/2019,156,104,260,7,1,2019
11,1/13/2019,219,203,422,7,1,2019
12,1/13/2019,177,291,468,7,1,2019
13,1/13/2019,204,567,771,7,1,2019
14,1/13/2019,143,104,247,7,1,2019
15,1/13/2019,109,455,564,7,1,2019
16,1/13/2019,176,269,445,7,1,2019
17,1/13/2019,145,208,353,7,1,2019
18,1/13/2019,70,339,409,7,1,2019
19,1/13/2019,64,324,388,7,1,2019
20,1/13/2019,136,300,436,7,1,2019
21,1/13/2019,142,226,368,7,1,2019
22,1/13/2019,174,294,468,7,1,2019
23,1/13/2019,114,465,579,7,1,2019
0,1/14/2019,43,218,261,1,1,2019
1,1/14/2019,14,3,17,1,1,2019
2,1/14/2019,18,0,18,1,1,2019
3,1/14/2019,26,0,26,1,1,2019
4,1/14/2019,24,0,24,1,1,2019
5,1/14/2019,70,0,70,1,1,2019
6,1/14/2019,138,49,187,1,1,2019
7,1/14/2019,144,254,398,1,1,2019
8,1/14/2019,82,527,609,1,1,2019
9,1/14/2019,64,347,411,1,1,2019
10,1/14/2019,95,115,210,1,1,2019
11,1/14/2019,184,199,383,1,1,2019
12,1/14/2019,117,171,288,1,1,2019
13,1/14/2019,75,221,296,1,1,2019
14,1/14/2019,62,94,156,1,1,2019
15,1/14/2019,75,106,181,1,1,2019
16,1/14/2019,122,132,254,1,1,2019
17,1/14/2019,106,363,469,1,1,2019
18,1/14/2019,27,337,364,1,1,2019
19,1/14/2019,48,359,407,1,1,2019
20,1/14/2019,98,207,305,1,1,2019
21,1/14/2019,111,249,360,1,1,2019
22,1/14/2019,124,197,321,1,1,2019
23,1/14/2019,64,265,329,1,1,2019
0,1/15/2019,19,162,181,2,1,2019
1,1/15/2019,8,87,95,2,1,2019
2,1/15/2019,26,0,26,2,1,2019
3,1/15/2019,43,0,43,2,1,2019
4,1/15/2019,58,0,58,2,1,2019
5,1/15/2019,73,0,73,2,1,2019
6,1/15/2019,138,74,212,2,1,2019
7,1/15/2019,162,132,294,2,1,2019
8,1/15/2019,75,471,546,2,1,2019
9,1/15/2019,89,348,437,2,1,2019
10,1/15/2019,112,133,245,2,1,2019
11,1/15/2019,130,222,352,2,1,2019
12,1/15/2019,59,227,286,2,1,2019
13,1/15/2019,94,365,459,2,1,2019
14,1/15/2019,70,107,177,2,1,2019
15,1/15/2019,77,252,329,2,1,2019
16,1/15/2019,73,205,278,2,1,2019
17,1/15/2019,36,231,267,2,1,2019
18,1/15/2019,26,291,317,2,1,2019
19,1/15/2019,35,217,252,2,1,2019
20,1/15/2019,65,62,127,2,1,2019
21,1/15/2019,180,237,417,2,1,2019
22,1/15/2019,270,240,510,2,1,2019
23,1/15/2019,138,145,283,2,1,2019
0,1/16/2019,45,186,231,3,1,2019
1,1/16/2019,16,17,33,3,1,2019
2,1/16/2019,4,0,4,3,1,2019
3,1/16/2019,37,0,37,3,1,2019
4,1/16/2019,28,0,28,3,1,2019
5,1/16/2019,104,0,104,3,1,2019
6,1/16/2019,187,66,253,3,1,2019
7,1/16/2019,140,174,314,3,1,2019
8,1/16/2019,74,422,496,3,1,2019
9,1/16/2019,77,396,473,3,1,2019
10,1/16/2019,96,75,171,3,1,2019
11,1/16/2019,98,325,423,3,1,2019
12,1/16/2019,121,105,226,3,1,2019
13,1/16/2019,70,171,241,3,1,2019
14,1/16/2019,60,74,134,3,1,2019
15,1/16/2019,57,136,193,3,1,2019
16,1/16/2019,72,230,302,3,1,2019
17,1/16/2019,40,185,225,3,1,2019
18,1/16/2019,27,283,310,3,1,2019
19,1/16/2019,42,166,208,3,1,2019
20,1/16/2019,84,94,178,3,1,2019
21,1/16/2019,220,72,292,3,1,2019
22,1/16/2019,296,226,522,3,1,2019
23,1/16/2019,184,155,339,3,1,2019
0,1/17/2019,68,106,174,4,1,2019
1,1/17/2019,17,1,18,4,1,2019
2,1/17/2019,17,0,17,4,1,2019
3,1/17/2019,71,0,71,4,1,2019
4,1/17/2019,88,0,88,4,1,2019
5,1/17/2019,107,0,107,4,1,2019
6,1/17/2019,237,73,310,4,1,2019
7,1/17/2019,244,126,370,4,1,2019
8,1/17/2019,169,364,533,4,1,2019
9,1/17/2019,129,436,565,4,1,2019
10,1/17/2019,181,103,284,4,1,2019
11,1/17/2019,206,219,425,4,1,2019
12,1/17/2019,110,231,341,4,1,2019
13,1/17/2019,108,235,343,4,1,2019
14,1/17/2019,120,60,180,4,1,2019
15,1/17/2019,69,169,238,4,1,2019
16,1/17/2019,83,175,258,4,1,2019
17,1/17/2019,79,208,287,4,1,2019
18,1/17/2019,42,160,202,4,1,2019
19,1/17/2019,57,377,434,4,1,2019
20,1/17/2019,166,120,286,4,1,2019
21,1/17/2019,330,146,476,4,1,2019
22,1/17/2019,316,188,504,4,1,2019
23,1/17/2019,307,139,446,4,1,2019
0,1/18/2019,145,164,309,5,1,2019
1,1/18/2019,41,0,41,5,1,2019
2,1/18/2019,39,0,39,5,1,2019
3,1/18/2019,65,0,65,5,1,2019
4,1/18/2019,88,0,88,5,1,2019
5,1/18/2019,172,0,172,5,1,2019
6,1/18/2019,374,67,441,5,1,2019
7,1/18/2019,384,209,593,5,1,2019
8,1/18/2019,187,262,449,5,1,2019
9,1/18/2019,129,449,578,5,1,2019
10,1/18/2019,196,159,355,5,1,2019
11,1/18/2019,191,266,457,5,1,2019
12,1/18/2019,144,192,336,5,1,2019
13,1/18/2019,128,128,256,5,1,2019
14,1/18/2019,131,62,193,5,1,2019
15,1/18/2019,135,233,368,5,1,2019
16,1/18/2019,137,236,373,5,1,2019
17,1/18/2019,123,197,320,5,1,2019
18,1/18/2019,33,187,220,5,1,2019
19,1/18/2019,54,213,267,5,1,2019
20,1/18/2019,158,110,268,5,1,2019
21,1/18/2019,300,175,475,5,1,2019
22,1/18/2019,246,155,401,5,1,2019
23,1/18/2019,258,153,411,5,1,2019
0,1/19/2019,190,220,410,6,1,2019
1,1/19/2019,27,32,59,6,1,2019
2,1/19/2019,34,13,47,6,1,2019
3,1/19/2019,54,0,54,6,1,2019
4,1/19/2019,68,0,68,6,1,2019
5,1/19/2019,166,0,166,6,1,2019
6,1/19/2019,314,72,386,6,1,2019
7,1/19/2019,287,186,473,6,1,2019
8,1/19/2019,176,402,578,6,1,2019
9,1/19/2019,170,444,614,6,1,2019
10,1/19/2019,148,171,319,6,1,2019
11,1/19/2019,163,256,419,6,1,2019
12,1/19/2019,121,295,416,6,1,2019
13,1/19/2019,93,118,211,6,1,2019
14,1/19/2019,120,136,256,6,1,2019
15,1/19/2019,85,248,333,6,1,2019
16,1/19/2019,81,260,341,6,1,2019
17,1/19/2019,64,306,370,6,1,2019
18,1/19/2019,26,279,305,6,1,2019
19,1/19/2019,32,217,249,6,1,2019
20,1/19/2019,85,77,162,6,1,2019
21,1/19/2019,174,234,408,6,1,2019
22,1/19/2019,180,171,351,6,1,2019
23,1/19/2019,114,156,270,6,1,2019
0,1/20/2019,52,115,167,7,1,2019
1,1/20/2019,41,0,41,7,1,2019
2,1/20/2019,16,0,16,7,1,2019
3,1/20/2019,58,0,58,7,1,2019
4,1/20/2019,57,0,57,7,1,2019
5,1/20/2019,96,0,96,7,1,2019
6,1/20/2019,219,87,306,7,1,2019
7,1/20/2019,182,236,418,7,1,2019
8,1/20/2019,50,577,627,7,1,2019
9,1/20/2019,70,270,340,7,1,2019
10,1/20/2019,118,124,242,7,1,2019
11,1/20/2019,149,77,226,7,1,2019
12,1/20/2019,104,376,480,7,1,2019
13,1/20/2019,148,370,518,7,1,2019
14,1/20/2019,120,213,333,7,1,2019
15,1/20/2019,104,330,434,7,1,2019
16,1/20/2019,93,217,310,7,1,2019
17,1/20/2019,148,127,275,7,1,2019
18,1/20/2019,58,402,460,7,1,2019
19,1/20/2019,57,263,320,7,1,2019
20,1/20/2019,78,103,181,7,1,2019
21,1/20/2019,161,152,313,7,1,2019
22,1/20/2019,181,345,526,7,1,2019
23,1/20/2019,79,208,287,7,1,2019
0,1/21/2019,31,181,212,1,1,2019
1,1/21/2019,23,0,23,1,1,2019
2,1/21/2019,13,0,13,1,1,2019
3,1/21/2019,17,0,17,1,1,2019
4,1/21/2019,31,0,31,1,1,2019
5,1/21/2019,63,0,63,1,1,2019
6,1/21/2019,134,92,226,1,1,2019
7,1/21/2019,146,269,415,1,1,2019
8,1/21/2019,72,375,447,1,1,2019
9,1/21/2019,57,292,349,1,1,2019
10,1/21/2019,52,169,221,1,1,2019
11,1/21/2019,92,232,324,1,1,2019
12,1/21/2019,84,144,228,1,1,2019
13,1/21/2019,58,327,385,1,1,2019
14,1/21/2019,112,81,193,1,1,2019
15,1/21/2019,97,280,377,1,1,2019
16,1/21/2019,112,212,324,1,1,2019
17,1/21/2019,91,414,505,1,1,2019
18,1/21/2019,17,399,416,1,1,2019
19,1/21/2019,20,422,442,1,1,2019
20,1/21/2019,84,292,376,1,1,2019
21,1/21/2019,127,216,343,1,1,2019
22,1/21/2019,163,183,346,1,1,2019
23,1/21/2019,55,228,283,1,1,2019
0,1/22/2019,37,254,291,2,1,2019
1,1/22/2019,15,19,34,2,1,2019
2,1/22/2019,33,0,33,2,1,2019
3,1/22/2019,44,0,44,2,1,2019
4,1/22/2019,43,0,43,2,1,2019
5,1/22/2019,60,0,60,2,1,2019
6,1/22/2019,141,68,209,2,1,2019
7,1/22/2019,124,105,229,2,1,2019
8,1/22/2019,75,398,473,2,1,2019
9,1/22/2019,100,337,437,2,1,2019
10,1/22/2019,71,134,205,2,1,2019
11,1/22/2019,70,160,230,2,1,2019
12,1/22/2019,73,175,248,2,1,2019
13,1/22/2019,77,279,356,2,1,2019
14,1/22/2019,57,148,205,2,1,2019
15,1/22/2019,88,244,332,2,1,2019
16,1/22/2019,69,213,282,2,1,2019
17,1/22/2019,78,309,387,2,1,2019
18,1/22/2019,31,273,304,2,1,2019
19,1/22/2019,16,199,215,2,1,2019
20,1/22/2019,68,75,143,2,1,2019
21,1/22/2019,186,165,351,2,1,2019
22,1/22/2019,178,233,411,2,1,2019
23,1/22/2019,110,195,305,2,1,2019
0,1/23/2019,33,80,113,3,1,2019
1,1/23/2019,2,3,5,3,1,2019
2,1/23/2019,17,0,17,3,1,2019
3,1/23/2019,28,0,28,3,1,2019
4,1/23/2019,29,0,29,3,1,2019
5,1/23/2019,101,0,101,3,1,2019
6,1/23/2019,172,53,225,3,1,2019
7,1/23/2019,117,170,287,3,1,2019
8,1/23/2019,69,246,315,3,1,2019
9,1/23/2019,87,232,319,3,1,2019
10,1/23/2019,97,81,178,3,1,2019
11,1/23/2019,88,232,320,3,1,2019
12,1/23/2019,52,222,274,3,1,2019
13,1/23/2019,71,246,317,3,1,2019
14,1/23/2019,82,96,178,3,1,2019
15,1/23/2019,78,176,254,3,1,2019
16,1/23/2019,60,140,200,3,1,2019
17,1/23/2019,75,273,348,3,1,2019
18,1/23/2019,20,205,225,3,1,2019
19,1/23/2019,31,153,184,3,1,2019
20,1/23/2019,94,161,255,3,1,2019
21,1/23/2019,246,146,392,3,1,2019
22,1/23/2019,273,250,523,3,1,2019
23,1/23/2019,152,84,236,3,1,2019
0,1/24/2019,71,78,149,4,1,2019
1,1/24/2019,6,8,14,4,1,2019
2,1/24/2019,42,0,42,4,1,2019
3,1/24/2019,49,0,49,4,1,2019
4,1/24/2019,66,0,66,4,1,2019
5,1/24/2019,117,0,117,4,1,2019
6,1/24/2019,232,68,300,4,1,2019
7,1/24/2019,212,91,303,4,1,2019
8,1/24/2019,102,316,418,4,1,2019
9,1/24/2019,106,480,586,4,1,2019
10,1/24/2019,142,37,179,4,1,2019
11,1/24/2019,144,299,443,4,1,2019
12,1/24/2019,105,162,267,4,1,2019
13,1/24/2019,91,198,289,4,1,2019
14,1/24/2019,138,68,206,4,1,2019
15,1/24/2019,82,225,307,4,1,2019
16,1/24/2019,108,93,201,4,1,2019
17,1/24/2019,91,246,337,4,1,2019
18,1/24/2019,56,202,258,4,1,2019
19,1/24/2019,27,225,252,4,1,2019
20,1/24/2019,132,165,297,4,1,2019
21,1/24/2019,291,126,417,4,1,2019
22,1/24/2019,268,162,430,4,1,2019
23,1/24/2019,240,144,384,4,1,2019
0,1/25/2019,167,97,264,5,1,2019
1,1/25/2019,35,0,35,5,1,2019
2,1/25/2019,30,0,30,5,1,2019
3,1/25/2019,47,0,47,5,1,2019
4,1/25/2019,64,0,64,5,1,2019
5,1/25/2019,204,0,204,5,1,2019
6,1/25/2019,343,40,383,5,1,2019
7,1/25/2019,217,104,321,5,1,2019
8,1/25/2019,114,361,475,5,1,2019
9,1/25/2019,120,409,529,5,1,2019
10,1/25/2019,150,99,249,5,1,2019
11,1/25/2019,141,252,393,5,1,2019
12,1/25/2019,112,198,310,5,1,2019
13,1/25/2019,112,150,262,5,1,2019
14,1/25/2019,117,79,196,5,1,2019
15,1/25/2019,86,195,281,5,1,2019
16,1/25/2019,166,173,339,5,1,2019
17,1/25/2019,117,128,245,5,1,2019
18,1/25/2019,48,222,270,5,1,2019
19,1/25/2019,35,150,185,5,1,2019
20,1/25/2019,104,126,230,5,1,2019
21,1/25/2019,290,121,411,5,1,2019
22,1/25/2019,265,168,433,5,1,2019
23,1/25/2019,200,141,341,5,1,2019
0,1/26/2019,116,182,298,6,1,2019
1,1/26/2019,46,46,92,6,1,2019
2,1/26/2019,14,1,15,6,1,2019
3,1/26/2019,53,12,65,6,1,2019
4,1/26/2019,59,0,59,6,1,2019
5,1/26/2019,94,2,96,6,1,2019
6,1/26/2019,293,8,301,6,1,2019
7,1/26/2019,244,159,403,6,1,2019
8,1/26/2019,98,338,436,6,1,2019
9,1/26/2019,142,335,477,6,1,2019
10,1/26/2019,111,266,377,6,1,2019
11,1/26/2019,77,275,352,6,1,2019
12,1/26/2019,67,39,106,6,1,2019
13,1/26/2019,116,183,299,6,1,2019
14,1/26/2019,139,107,246,6,1,2019
15,1/26/2019,108,212,320,6,1,2019
16,1/26/2019,84,282,366,6,1,2019
17,1/26/2019,58,263,321,6,1,2019
18,1/26/2019,16,381,397,6,1,2019
19,1/26/2019,23,193,216,6,1,2019
20,1/26/2019,91,182,273,6,1,2019
21,1/26/2019,167,56,223,6,1,2019
22,1/26/2019,174,155,329,6,1,2019
23,1/26/2019,82,211,293,6,1,2019
0,1/27/2019,34,124,158,7,1,2019
1,1/27/2019,4,26,30,7,1,2019
2,1/27/2019,9,0,9,7,1,2019
3,1/27/2019,59,0,59,7,1,2019
4,1/27/2019,55,0,55,7,1,2019
5,1/27/2019,113,0,113,7,1,2019
6,1/27/2019,155,33,188,7,1,2019
7,1/27/2019,180,289,469,7,1,2019
8,1/27/2019,88,370,458,7,1,2019
9,1/27/2019,59,361,420,7,1,2019
10,1/27/2019,92,145,237,7,1,2019
11,1/27/2019,176,137,313,7,1,2019
12,1/27/2019,136,171,307,7,1,2019
13,1/27/2019,155,479,634,7,1,2019
14,1/27/2019,118,105,223,7,1,2019
15,1/27/2019,112,399,511,7,1,2019
16,1/27/2019,145,137,282,7,1,2019
17,1/27/2019,112,251,363,7,1,2019
18,1/27/2019,39,232,271,7,1,2019
19,1/27/2019,40,275,315,7,1,2019
20,1/27/2019,82,166,248,7,1,2019
21,1/27/2019,175,63,238,7,1,2019
22,1/27/2019,204,210,414,7,1,2019
23,1/27/2019,111,266,377,7,1,2019
0,1/28/2019,38,135,173,1,1,2019
1,1/28/2019,8,99,107,1,1,2019
2,1/28/2019,12,227,239,1,1,2019
3,1/28/2019,30,0,30,1,1,2019
4,1/28/2019,41,0,41,1,1,2019
5,1/28/2019,45,0,45,1,1,2019
6,1/28/2019,112,49,161,1,1,2019
7,1/28/2019,145,270,415,1,1,2019
8,1/28/2019,105,241,346,1,1,2019
9,1/28/2019,64,270,334,1,1,2019
10,1/28/2019,90,121,211,1,1,2019
11,1/28/2019,91,210,301,1,1,2019
12,1/28/2019,107,163,270,1,1,2019
13,1/28/2019,90,192,282,1,1,2019
14,1/28/2019,102,167,269,1,1,2019
15,1/28/2019,112,170,282,1,1,2019
16,1/28/2019,94,130,224,1,1,2019
17,1/28/2019,85,356,441,1,1,2019
18,1/28/2019,20,303,323,1,1,2019
19,1/28/2019,15,314,329,1,1,2019
20,1/28/2019,38,75,113,1,1,2019
21,1/28/2019,132,160,292,1,1,2019
22,1/28/2019,170,143,313,1,1,2019
23,1/28/2019,55,157,212,1,1,2019
0,1/29/2019,25,120,145,2,1,2019
1,1/29/2019,15,57,72,2,1,2019
2,1/29/2019,12,11,23,2,1,2019
3,1/29/2019,54,0,54,2,1,2019
4,1/29/2019,41,0,41,2,1,2019
5,1/29/2019,60,1,61,2,1,2019
6,1/29/2019,142,0,142,2,1,2019
7,1/29/2019,115,199,314,2,1,2019
8,1/29/2019,98,299,397,2,1,2019
9,1/29/2019,36,267,303,2,1,2019
10,1/29/2019,52,123,175,2,1,2019
11,1/29/2019,97,198,295,2,1,2019
12,1/29/2019,102,135,237,2,1,2019
13,1/29/2019,59,136,195,2,1,2019
14,1/29/2019,106,130,236,2,1,2019
15,1/29/2019,61,163,224,2,1,2019
16,1/29/2019,66,214,280,2,1,2019
17,1/29/2019,96,204,300,2,1,2019
18,1/29/2019,15,225,240,2,1,2019
19,1/29/2019,15,199,214,2,1,2019
20,1/29/2019,66,44,110,2,1,2019
21,1/29/2019,127,217,344,2,1,2019
22,1/29/2019,192,99,291,2,1,2019
23,1/29/2019,109,71,180,2,1,2019
0,1/30/2019,58,106,164,3,1,2019
1,1/30/2019,8,5,13,3,1,2019
2,1/30/2019,19,10,29,3,1,2019
3,1/30/2019,34,0,34,3,1,2019
4,1/30/2019,38,0,38,3,1,2019
5,1/30/2019,98,0,98,3,1,2019
6,1/30/2019,189,23,212,3,1,2019
7,1/30/2019,129,187,316,3,1,2019
8,1/30/2019,64,352,416,3,1,2019
9,1/30/2019,91,318,409,3,1,2019
10,1/30/2019,91,92,183,3,1,2019
11,1/30/2019,79,293,372,3,1,2019
12,1/30/2019,77,91,168,3,1,2019
13,1/30/2019,96,139,235,3,1,2019
14,1/30/2019,137,61,198,3,1,2019
15,1/30/2019,58,144,202,3,1,2019
16,1/30/2019,83,145,228,3,1,2019
17,1/30/2019,93,147,240,3,1,2019
18,1/30/2019,29,187,216,3,1,2019
19,1/30/2019,30,192,222,3,1,2019
20,1/30/2019,122,119,241,3,1,2019
21,1/30/2019,228,221,449,3,1,2019
22,1/30/2019,262,96,358,3,1,2019
23,1/30/2019,162,129,291,3,1,2019
0,1/31/2019,120,74,194,4,1,2019
1,1/31/2019,23,17,40,4,1,2019
2,1/31/2019,41,32,73,4,1,2019
3,1/31/2019,94,0,94,4,1,2019
4,1/31/2019,111,0,111,4,1,2019
5,1/31/2019,139,0,139,4,1,2019
6,1/31/2019,197,8,205,4,1,2019
7,1/31/2019,239,257,496,4,1,2019
8,1/31/2019,174,381,555,4,1,2019
9,1/31/2019,119,332,451,4,1,2019
10,1/31/2019,137,73,210,4,1,2019
11,1/31/2019,165,246,411,4,1,2019
12,1/31/2019,91,364,455,4,1,2019
13,1/31/2019,98,340,438,4,1,2019
14,1/31/2019,137,103,240,4,1,2019
15,1/31/2019,45,194,239,4,1,2019
16,1/31/2019,78,176,254,4,1,2019
17,1/31/2019,76,158,234,4,1,2019
18,1/31/2019,45,313,358,4,1,2019
19,1/31/2019,28,220,248,4,1,2019
20,1/31/2019,128,160,288,4,1,2019
21,1/31/2019,278,167,445,4,1,2019
22,1/31/2019,300,170,470,4,1,2019
23,1/31/2019,210,236,446,4,1,2019
0,2/1/2019,123,198,321,5,2,2019
1,2/1/2019,18,59,77,5,2,2019
2,2/1/2019,29,4,33,5,2,2019
3,2/1/2019,49,120,169,5,2,2019
4,2/1/2019,80,0,80,5,2,2019
5,2/1/2019,150,0,150,5,2,2019
6,2/1/2019,245,15,260,5,2,2019
7,2/1/2019,199,246,445,5,2,2019
8,2/1/2019,94,343,437,5,2,2019
9,2/1/2019,107,521,628,5,2,2019
10,2/1/2019,167,25,192,5,2,2019
11,2/1/2019,113,337,450,5,2,2019
12,2/1/2019,87,186,273,5,2,2019
13,2/1/2019,96,190,286,5,2,2019
14,2/1/2019,86,102,188,5,2,2019
15,2/1/2019,57,209,266,5,2,2019
16,2/1/2019,130,322,452,5,2,2019
17,2/1/2019,94,193,287,5,2,2019
18,2/1/2019,28,293,321,5,2,2019
19,2/1/2019,36,384,420,5,2,2019
20,2/1/2019,108,105,213,5,2,2019
21,2/1/2019,198,232,430,5,2,2019
22,2/1/2019,195,203,398,5,2,2019
23,2/1/2019,168,212,380,5,2,2019
0,2/2/2019,77,175,252,6,2,2019
1,2/2/2019,22,85,107,6,2,2019
2,2/2/2019,24,25,49,6,2,2019
3,2/2/2019,47,0,47,6,2,2019
4,2/2/2019,55,0,55,6,2,2019
5,2/2/2019,114,1,115,6,2,2019
6,2/2/2019,254,61,315,6,2,2019
7,2/2/2019,176,149,325,6,2,2019
8,2/2/2019,140,474,614,6,2,2019
9,2/2/2019,128,457,585,6,2,2019
10,2/2/2019,126,26,152,6,2,2019
11,2/2/2019,83,231,314,6,2,2019
12,2/2/2019,89,176,265,6,2,2019
13,2/2/2019,138,219,357,6,2,2019
14,2/2/2019,113,132,245,6,2,2019
15,2/2/2019,114,185,299,6,2,2019
16,2/2/2019,69,197,266,6,2,2019
17,2/2/2019,37,280,317,6,2,2019
18,2/2/2019,16,319,335,6,2,2019
19,2/2/2019,47,183,230,6,2,2019
20,2/2/2019,73,83,156,6,2,2019
21,2/2/2019,109,172,281,6,2,2019
22,2/2/2019,132,181,313,6,2,2019
23,2/2/2019,90,62,152,6,2,2019
0,2/3/2019,34,166,200,7,2,2019
1,2/3/2019,10,12,22,7,2,2019
2,2/3/2019,10,0,10,7,2,2019
3,2/3/2019,47,0,47,7,2,2019
4,2/3/2019,60,0,60,7,2,2019
5,2/3/2019,76,0,76,7,2,2019
6,2/3/2019,183,103,286,7,2,2019
7,2/3/2019,166,196,362,7,2,2019
8,2/3/2019,48,267,315,7,2,2019
9,2/3/2019,102,386,488,7,2,2019
10,2/3/2019,177,112,289,7,2,2019
11,2/3/2019,124,115,239,7,2,2019
12,2/3/2019,111,173,284,7,2,2019
13,2/3/2019,81,449,530,7,2,2019
14,2/3/2019,94,175,269,7,2,2019
15,2/3/2019,125,330,455,7,2,2019
16,2/3/2019,63,74,137,7,2,2019
17,2/3/2019,72,319,391,7,2,2019
18,2/3/2019,18,190,208,7,2,2019
19,2/3/2019,40,178,218,7,2,2019
20,2/3/2019,74,194,268,7,2,2019
21,2/3/2019,148,246,394,7,2,2019
22,2/3/2019,183,199,382,7,2,2019
23,2/3/2019,115,265,380,7,2,2019
0,2/4/2019,41,246,287,1,2,2019
1,2/4/2019,14,3,17,1,2,2019
2,2/4/2019,19,75,94,1,2,2019
3,2/4/2019,35,0,35,1,2,2019
4,2/4/2019,29,0,29,1,2,2019
5,2/4/2019,65,0,65,1,2,2019
6,2/4/2019,170,26,196,1,2,2019
7,2/4/2019,257,162,419,1,2,2019
8,2/4/2019,104,293,397,1,2,2019
9,2/4/2019,199,326,525,1,2,2019
10,2/4/2019,169,40,209,1,2,2019
11,2/4/2019,127,290,417,1,2,2019
12,2/4/2019,221,105,326,1,2,2019
13,2/4/2019,202,170,372,1,2,2019
14,2/4/2019,261,132,393,1,2,2019
15,2/4/2019,263,160,423,1,2,2019
16,2/4/2019,292,125,417,1,2,2019
17,2/4/2019,300,197,497,1,2,2019
18,2/4/2019,125,199,324,1,2,2019
19,2/4/2019,31,186,217,1,2,2019
20,2/4/2019,74,147,221,1,2,2019
21,2/4/2019,208,117,325,1,2,2019
22,2/4/2019,293,86,379,1,2,2019
23,2/4/2019,151,67,218,1,2,2019
0,2/5/2019,61,178,239,2,2,2019
1,2/5/2019,26,15,41,2,2,2019
2,2/5/2019,7,6,13,2,2,2019
3,2/5/2019,70,0,70,2,2,2019
4,2/5/2019,75,0,75,2,2,2019
5,2/5/2019,85,1,86,2,2,2019
6,2/5/2019,153,28,181,2,2,2019
7,2/5/2019,204,177,381,2,2,2019
8,2/5/2019,126,264,390,2,2,2019
9,2/5/2019,132,211,343,2,2,2019
10,2/5/2019,137,39,176,2,2,2019
11,2/5/2019,110,175,285,2,2,2019
12,2/5/2019,200,117,317,2,2,2019
13,2/5/2019,159,221,380,2,2,2019
14,2/5/2019,174,107,281,2,2,2019
15,2/5/2019,230,138,368,2,2,2019
16,2/5/2019,188,128,316,2,2,2019
17,2/5/2019,185,159,344,2,2,2019
18,2/5/2019,12,176,188,2,2,2019
19,2/5/2019,18,104,122,2,2,2019
20,2/5/2019,64,26,90,2,2,2019
21,2/5/2019,191,263,454,2,2,2019
22,2/5/2019,207,143,350,2,2,2019
23,2/5/2019,138,78,216,2,2,2019
0,2/6/2019,49,96,145,3,2,2019
1,2/6/2019,6,0,6,3,2,2019
2,2/6/2019,21,0,21,3,2,2019
3,2/6/2019,37,0,37,3,2,2019
4,2/6/2019,22,0,22,3,2,2019
5,2/6/2019,97,1,98,3,2,2019
6,2/6/2019,167,50,217,3,2,2019
7,2/6/2019,142,202,344,3,2,2019
8,2/6/2019,90,317,407,3,2,2019
9,2/6/2019,115,262,377,3,2,2019
10,2/6/2019,137,28,165,3,2,2019
11,2/6/2019,104,240,344,3,2,2019
12,2/6/2019,69,159,228,3,2,2019
13,2/6/2019,116,124,240,3,2,2019
14,2/6/2019,105,33,138,3,2,2019
15,2/6/2019,144,106,250,3,2,2019
16,2/6/2019,146,216,362,3,2,2019
17,2/6/2019,66,149,215,3,2,2019
18,2/6/2019,36,181,217,3,2,2019
19,2/6/2019,15,186,201,3,2,2019
20,2/6/2019,63,43,106,3,2,2019
21,2/6/2019,192,173,365,3,2,2019
22,2/6/2019,214,79,293,3,2,2019
23,2/6/2019,136,122,258,3,2,2019
0,2/7/2019,62,79,141,4,2,2019
1,2/7/2019,1,0,1,4,2,2019
2,2/7/2019,32,0,32,4,2,2019
3,2/7/2019,34,0,34,4,2,2019
4,2/7/2019,74,0,74,4,2,2019
5,2/7/2019,92,0,92,4,2,2019
6,2/7/2019,233,25,258,4,2,2019
7,2/7/2019,223,208,431,4,2,2019
8,2/7/2019,158,272,430,4,2,2019
9,2/7/2019,112,257,369,4,2,2019
10,2/7/2019,180,111,291,4,2,2019
11,2/7/2019,168,201,369,4,2,2019
12,2/7/2019,87,113,200,4,2,2019
13,2/7/2019,107,183,290,4,2,2019
14,2/7/2019,83,60,143,4,2,2019
15,2/7/2019,52,137,189,4,2,2019
16,2/7/2019,70,119,189,4,2,2019
17,2/7/2019,51,70,121,4,2,2019
18,2/7/2019,25,198,223,4,2,2019
19,2/7/2019,9,39,48,4,2,2019
20,2/7/2019,106,78,184,4,2,2019
21,2/7/2019,251,166,417,4,2,2019
22,2/7/2019,300,95,395,4,2,2019
23,2/7/2019,270,85,355,4,2,2019
0,2/8/2019,91,76,167,5,2,2019
1,2/8/2019,28,43,71,5,2,2019
2,2/8/2019,37,5,42,5,2,2019
3,2/8/2019,56,0,56,5,2,2019
4,2/8/2019,63,0,63,5,2,2019
5,2/8/2019,167,0,167,5,2,2019
6,2/8/2019,291,22,313,5,2,2019
7,2/8/2019,241,165,406,5,2,2019
8,2/8/2019,13,300,313,5,2,2019
9,2/8/2019,46,317,363,5,2,2019
10,2/8/2019,140,112,252,5,2,2019
11,2/8/2019,173,167,340,5,2,2019
12,2/8/2019,116,175,291,5,2,2019
13,2/8/2019,67,189,256,5,2,2019
14,2/8/2019,126,57,183,5,2,2019
15,2/8/2019,129,216,345,5,2,2019
16,2/8/2019,119,144,263,5,2,2019
17,2/8/2019,139,162,301,5,2,2019
18,2/8/2019,22,143,165,5,2,2019
19,2/8/2019,26,226,252,5,2,2019
20,2/8/2019,139,33,172,5,2,2019
21,2/8/2019,268,227,495,5,2,2019
22,2/8/2019,244,87,331,5,2,2019
23,2/8/2019,242,115,357,5,2,2019
0,2/9/2019,154,104,258,6,2,2019
1,2/9/2019,29,22,51,6,2,2019
2,2/9/2019,25,13,38,6,2,2019
3,2/9/2019,86,0,86,6,2,2019
4,2/9/2019,58,0,58,6,2,2019
5,2/9/2019,132,1,133,6,2,2019
6,2/9/2019,285,20,305,6,2,2019
7,2/9/2019,260,200,460,6,2,2019
8,2/9/2019,163,317,480,6,2,2019
9,2/9/2019,122,446,568,6,2,2019
10,2/9/2019,53,100,153,6,2,2019
11,2/9/2019,92,182,274,6,2,2019
12,2/9/2019,78,146,224,6,2,2019
13,2/9/2019,102,209,311,6,2,2019
14,2/9/2019,151,90,241,6,2,2019
15,2/9/2019,154,201,355,6,2,2019
16,2/9/2019,129,218,347,6,2,2019
17,2/9/2019,41,204,245,6,2,2019
18,2/9/2019,6,218,224,6,2,2019
19,2/9/2019,45,152,197,6,2,2019
20,2/9/2019,62,58,120,6,2,2019
21,2/9/2019,120,152,272,6,2,2019
22,2/9/2019,153,76,229,6,2,2019
23,2/9/2019,88,159,247,6,2,2019
0,2/10/2019,44,45,89,7,2,2019
1,2/10/2019,26,0,26,7,2,2019
2,2/10/2019,23,0,23,7,2,2019
3,2/10/2019,62,0,62,7,2,2019
4,2/10/2019,50,0,50,7,2,2019
5,2/10/2019,159,0,159,7,2,2019
6,2/10/2019,173,24,197,7,2,2019
7,2/10/2019,207,257,464,7,2,2019
8,2/10/2019,88,382,470,7,2,2019
9,2/10/2019,55,296,351,7,2,2019
10,2/10/2019,133,1,134,7,2,2019
11,2/10/2019,169,162,331,7,2,2019
12,2/10/2019,142,173,315,7,2,2019
13,2/10/2019,160,297,457,7,2,2019
14,2/10/2019,125,65,190,7,2,2019
15,2/10/2019,140,304,444,7,2,2019
16,2/10/2019,149,179,328,7,2,2019
17,2/10/2019,144,220,364,7,2,2019
18,2/10/2019,41,168,209,7,2,2019
19,2/10/2019,25,196,221,7,2,2019
20,2/10/2019,72,196,268,7,2,2019
21,2/10/2019,171,145,316,7,2,2019
22,2/10/2019,154,190,344,7,2,2019
23,2/10/2019,76,185,261,7,2,2019
0,2/11/2019,67,190,257,1,2,2019
1,2/11/2019,27,11,38,1,2,2019
2,2/11/2019,8,0,8,1,2,2019
3,2/11/2019,18,0,18,1,2,2019
4,2/11/2019,50,0,50,1,2,2019
5,2/11/2019,81,0,81,1,2,2019
6,2/11/2019,98,6,104,1,2,2019
7,2/11/2019,124,148,272,1,2,2019
8,2/11/2019,69,309,378,1,2,2019
9,2/11/2019,71,244,315,1,2,2019
10,2/11/2019,122,78,200,1,2,2019
11,2/11/2019,94,220,314,1,2,2019
12,2/11/2019,85,133,218,1,2,2019
13,2/11/2019,81,288,369,1,2,2019
14,2/11/2019,99,101,200,1,2,2019
15,2/11/2019,75,220,295,1,2,2019
16,2/11/2019,108,181,289,1,2,2019
17,2/11/2019,88,161,249,1,2,2019
18,2/11/2019,24,235,259,1,2,2019
19,2/11/2019,15,365,380,1,2,2019
20,2/11/2019,57,172,229,1,2,2019
21,2/11/2019,107,165,272,1,2,2019
22,2/11/2019,119,170,289,1,2,2019
23,2/11/2019,65,56,121,1,2,2019
0,2/12/2019,34,159,193,2,2,2019
1,2/12/2019,14,19,33,2,2,2019
2,2/12/2019,22,0,22,2,2,2019
3,2/12/2019,57,0,57,2,2,2019
4,2/12/2019,52,0,52,2,2,2019
5,2/12/2019,59,1,60,2,2,2019
6,2/12/2019,166,44,210,2,2,2019
7,2/12/2019,131,52,183,2,2,2019
8,2/12/2019,91,226,317,2,2,2019
9,2/12/2019,73,211,284,2,2,2019
10,2/12/2019,92,91,183,2,2,2019
11,2/12/2019,73,207,280,2,2,2019
12,2/12/2019,94,63,157,2,2,2019
13,2/12/2019,96,241,337,2,2,2019
14,2/12/2019,80,4,84,2,2,2019
15,2/12/2019,61,290,351,2,2,2019
16,2/12/2019,81,125,206,2,2,2019
17,2/12/2019,87,192,279,2,2,2019
18,2/12/2019,21,237,258,2,2,2019
19,2/12/2019,13,171,184,2,2,2019
20,2/12/2019,50,35,85,2,2,2019
21,2/12/2019,202,177,379,2,2,2019
22,2/12/2019,201,92,293,2,2,2019
23,2/12/2019,152,97,249,2,2,2019
0,2/13/2019,7,35,42,3,2,2019
1,2/13/2019,0,0,0,3,2,2019
2,2/13/2019,9,0,9,3,2,2019
3,2/13/2019,37,31,68,3,2,2019
4,2/13/2019,28,2,30,3,2,2019
5,2/13/2019,137,0,137,3,2,2019
6,2/13/2019,280,34,314,3,2,2019
7,2/13/2019,192,158,350,3,2,2019
8,2/13/2019,85,228,313,3,2,2019
9,2/13/2019,105,241,346,3,2,2019
10,2/13/2019,126,31,157,3,2,2019
11,2/13/2019,123,227,350,3,2,2019
12,2/13/2019,72,83,155,3,2,2019
13,2/13/2019,123,69,192,3,2,2019
14,2/13/2019,84,84,168,3,2,2019
15,2/13/2019,76,125,201,3,2,2019
16,2/13/2019,106,144,250,3,2,2019
17,2/13/2019,115,72,187,3,2,2019
18,2/13/2019,39,157,196,3,2,2019
19,2/13/2019,19,128,147,3,2,2019
20,2/13/2019,64,60,124,3,2,2019
21,2/13/2019,255,128,383,3,2,2019
22,2/13/2019,341,135,476,3,2,2019
23,2/13/2019,231,103,334,3,2,2019
0,2/14/2019,132,84,216,4,2,2019
1,2/14/2019,21,2,23,4,2,2019
2,2/14/2019,27,3,30,4,2,2019
3,2/14/2019,96,0,96,4,2,2019
4,2/14/2019,106,0,106,4,2,2019
5,2/14/2019,158,0,158,4,2,2019
6,2/14/2019,313,9,322,4,2,2019
7,2/14/2019,369,75,444,4,2,2019
8,2/14/2019,176,261,437,4,2,2019
9,2/14/2019,117,234,351,4,2,2019
10,2/14/2019,225,87,312,4,2,2019
11,2/14/2019,289,102,391,4,2,2019
12,2/14/2019,169,168,337,4,2,2019
13,2/14/2019,138,28,166,4,2,2019
14,2/14/2019,155,250,405,4,2,2019
15,2/14/2019,161,108,269,4,2,2019
16,2/14/2019,134,94,228,4,2,2019
17,2/14/2019,218,212,430,4,2,2019
18,2/14/2019,65,139,204,4,2,2019
19,2/14/2019,53,132,185,4,2,2019
20,2/14/2019,151,131,282,4,2,2019
21,2/14/2019,343,97,440,4,2,2019
22,2/14/2019,369,125,494,4,2,2019
23,2/14/2019,284,88,372,4,2,2019
0,2/15/2019,200,104,304,5,2,2019
1,2/15/2019,66,63,129,5,2,2019
2,2/15/2019,59,3,62,5,2,2019
3,2/15/2019,82,0,82,5,2,2019
4,2/15/2019,109,0,109,5,2,2019
5,2/15/2019,244,1,245,5,2,2019
6,2/15/2019,468,39,507,5,2,2019
7,2/15/2019,494,106,600,5,2,2019
8,2/15/2019,195,315,510,5,2,2019
9,2/15/2019,192,313,505,5,2,2019
10,2/15/2019,218,137,355,5,2,2019
11,2/15/2019,277,189,466,5,2,2019
12,2/15/2019,131,83,214,5,2,2019
13,2/15/2019,142,197,339,5,2,2019
14,2/15/2019,157,72,229,5,2,2019
15,2/15/2019,168,169,337,5,2,2019
16,2/15/2019,181,216,397,5,2,2019
17,2/15/2019,224,153,377,5,2,2019
18,2/15/2019,50,115,165,5,2,2019
19,2/15/2019,28,161,189,5,2,2019
20,2/15/2019,94,101,195,5,2,2019
21,2/15/2019,327,234,561,5,2,2019
22,2/15/2019,234,87,321,5,2,2019
23,2/15/2019,143,162,305,5,2,2019
0,2/16/2019,81,105,186,6,2,2019
1,2/16/2019,17,11,28,6,2,2019
2,2/16/2019,10,13,23,6,2,2019
3,2/16/2019,83,0,83,6,2,2019
4,2/16/2019,83,0,83,6,2,2019
5,2/16/2019,78,1,79,6,2,2019
6,2/16/2019,200,26,226,6,2,2019
7,2/16/2019,422,157,579,6,2,2019
8,2/16/2019,267,337,604,6,2,2019
9,2/16/2019,258,388,646,6,2,2019
10,2/16/2019,245,23,268,6,2,2019
11,2/16/2019,165,224,389,6,2,2019
12,2/16/2019,112,210,322,6,2,2019
13,2/16/2019,107,149,256,6,2,2019
14,2/16/2019,107,107,214,6,2,2019
15,2/16/2019,155,248,403,6,2,2019
16,2/16/2019,88,204,292,6,2,2019
17,2/16/2019,104,202,306,6,2,2019
18,2/16/2019,16,246,262,6,2,2019
19,2/16/2019,22,130,152,6,2,2019
20,2/16/2019,105,204,309,6,2,2019
21,2/16/2019,217,175,392,6,2,2019
22,2/16/2019,221,46,267,6,2,2019
23,2/16/2019,89,191,280,6,2,2019
0,2/17/2019,53,59,112,7,2,2019
1,2/17/2019,16,1,17,7,2,2019
2,2/17/2019,20,0,20,7,2,2019
3,2/17/2019,54,0,54,7,2,2019
4,2/17/2019,72,0,72,7,2,2019
5,2/17/2019,131,0,131,7,2,2019
6,2/17/2019,279,68,347,7,2,2019
7,2/17/2019,261,163,424,7,2,2019
8,2/17/2019,117,404,521,7,2,2019
9,2/17/2019,83,333,416,7,2,2019
10,2/17/2019,199,0,199,7,2,2019
11,2/17/2019,191,86,277,7,2,2019
12,2/17/2019,127,280,407,7,2,2019
13,2/17/2019,125,353,478,7,2,2019
14,2/17/2019,162,137,299,7,2,2019
15,2/17/2019,115,301,416,7,2,2019
16,2/17/2019,133,99,232,7,2,2019
17,2/17/2019,130,292,422,7,2,2019
18,2/17/2019,62,297,359,7,2,2019
19,2/17/2019,46,309,355,7,2,2019
20,2/17/2019,86,148,234,7,2,2019
21,2/17/2019,202,92,294,7,2,2019
22,2/17/2019,166,218,384,7,2,2019
23,2/17/2019,95,266,361,7,2,2019
0,2/18/2019,58,224,282,1,2,2019
1,2/18/2019,15,57,72,1,2,2019
2,2/18/2019,27,141,168,1,2,2019
3,2/18/2019,24,0,24,1,2,2019
4,2/18/2019,27,0,27,1,2,2019
5,2/18/2019,51,0,51,1,2,2019
6,2/18/2019,143,74,217,1,2,2019
7,2/18/2019,137,186,323,1,2,2019
8,2/18/2019,81,364,445,1,2,2019
9,2/18/2019,153,412,565,1,2,2019
10,2/18/2019,69,215,284,1,2,2019
11,2/18/2019,103,265,368,1,2,2019
12,2/18/2019,95,305,400,1,2,2019
13,2/18/2019,97,238,335,1,2,2019
14,2/18/2019,132,223,355,1,2,2019
15,2/18/2019,122,255,377,1,2,2019
16,2/18/2019,124,284,408,1,2,2019
17,2/18/2019,102,348,450,1,2,2019
18,2/18/2019,17,521,538,1,2,2019
19,2/18/2019,28,499,527,1,2,2019
20,2/18/2019,65,419,484,1,2,2019
21,2/18/2019,135,299,434,1,2,2019
22,2/18/2019,103,294,397,1,2,2019
23,2/18/2019,88,358,446,1,2,2019
0,2/19/2019,46,330,376,2,2,2019
1,2/19/2019,10,13,23,2,2,2019
2,2/19/2019,18,0,18,2,2,2019
3,2/19/2019,57,0,57,2,2,2019
4,2/19/2019,32,0,32,2,2,2019
5,2/19/2019,58,1,59,2,2,2019
6,2/19/2019,150,55,205,2,2,2019
7,2/19/2019,139,217,356,2,2,2019
8,2/19/2019,87,285,372,2,2,2019
9,2/19/2019,86,367,453,2,2,2019
10,2/19/2019,111,46,157,2,2,2019
11,2/19/2019,76,292,368,2,2,2019
12,2/19/2019,85,140,225,2,2,2019
13,2/19/2019,90,234,324,2,2,2019
14,2/19/2019,67,200,267,2,2,2019
15,2/19/2019,74,394,468,2,2,2019
16,2/19/2019,77,145,222,2,2,2019
17,2/19/2019,105,234,339,2,2,2019
18,2/19/2019,36,283,319,2,2,2019
19,2/19/2019,16,281,297,2,2,2019
20,2/19/2019,39,130,169,2,2,2019
21,2/19/2019,214,327,541,2,2,2019
22,2/19/2019,154,121,275,2,2,2019
23,2/19/2019,107,135,242,2,2,2019
0,2/20/2019,98,135,233,3,2,2019
1,2/20/2019,21,0,21,3,2,2019
2,2/20/2019,8,0,8,3,2,2019
3,2/20/2019,49,0,49,3,2,2019
4,2/20/2019,27,0,27,3,2,2019
5,2/20/2019,87,0,87,3,2,2019
6,2/20/2019,172,47,219,3,2,2019
7,2/20/2019,175,140,315,3,2,2019
8,2/20/2019,78,329,407,3,2,2019
9,2/20/2019,86,234,320,3,2,2019
10,2/20/2019,125,35,160,3,2,2019
11,2/20/2019,61,254,315,3,2,2019
12,2/20/2019,84,73,157,3,2,2019
13,2/20/2019,60,226,286,3,2,2019
14,2/20/2019,87,94,181,3,2,2019
15,2/20/2019,103,199,302,3,2,2019
16,2/20/2019,100,167,267,3,2,2019
17,2/20/2019,66,114,180,3,2,2019
18,2/20/2019,22,207,229,3,2,2019
19,2/20/2019,14,212,226,3,2,2019
20,2/20/2019,66,151,217,3,2,2019
21,2/20/2019,151,147,298,3,2,2019
22,2/20/2019,247,135,382,3,2,2019
23,2/20/2019,181,146,327,3,2,2019
0,2/21/2019,89,100,189,4,2,2019
1,2/21/2019,16,0,16,4,2,2019
2,2/21/2019,36,0,36,4,2,2019
3,2/21/2019,67,0,67,4,2,2019
4,2/21/2019,81,0,81,4,2,2019
5,2/21/2019,213,0,213,4,2,2019
6,2/21/2019,245,18,263,4,2,2019
7,2/21/2019,279,219,498,4,2,2019
8,2/21/2019,169,269,438,4,2,2019
9,2/21/2019,128,330,458,4,2,2019
10,2/21/2019,212,7,219,4,2,2019
11,2/21/2019,172,191,363,4,2,2019
12,2/21/2019,121,279,400,4,2,2019
13,2/21/2019,126,227,353,4,2,2019
14,2/21/2019,119,92,211,4,2,2019
15,2/21/2019,63,227,290,4,2,2019
16,2/21/2019,74,84,158,4,2,2019
17,2/21/2019,96,166,262,4,2,2019
18,2/21/2019,40,190,230,4,2,2019
19,2/21/2019,15,141,156,4,2,2019
20,2/21/2019,107,150,257,4,2,2019
21,2/21/2019,270,166,436,4,2,2019
22,2/21/2019,354,203,557,4,2,2019
23,2/21/2019,230,54,284,4,2,2019
0,2/22/2019,134,88,222,5,2,2019
1,2/22/2019,61,45,106,5,2,2019
2,2/22/2019,28,1,29,5,2,2019
3,2/22/2019,54,0,54,5,2,2019
4,2/22/2019,58,0,58,5,2,2019
5,2/22/2019,203,0,203,5,2,2019
6,2/22/2019,345,2,347,5,2,2019
7,2/22/2019,279,116,395,5,2,2019
8,2/22/2019,139,376,515,5,2,2019
9,2/22/2019,145,395,540,5,2,2019
10,2/22/2019,179,62,241,5,2,2019
11,2/22/2019,163,246,409,5,2,2019
12,2/22/2019,103,167,270,5,2,2019
13,2/22/2019,105,154,259,5,2,2019
14,2/22/2019,118,76,194,5,2,2019
15,2/22/2019,104,260,364,5,2,2019
16,2/22/2019,78,155,233,5,2,2019
17,2/22/2019,117,170,287,5,2,2019
18,2/22/2019,58,120,178,5,2,2019
19,2/22/2019,33,298,331,5,2,2019
20,2/22/2019,148,170,318,5,2,2019
21,2/22/2019,255,169,424,5,2,2019
22,2/22/2019,291,96,387,5,2,2019
23,2/22/2019,191,185,376,5,2,2019
0,2/23/2019,88,88,176,6,2,2019
1,2/23/2019,27,21,48,6,2,2019
2,2/23/2019,19,13,32,6,2,2019
3,2/23/2019,62,0,62,6,2,2019
4,2/23/2019,43,0,43,6,2,2019
5,2/23/2019,123,2,125,6,2,2019
6,2/23/2019,313,74,387,6,2,2019
7,2/23/2019,255,159,414,6,2,2019
8,2/23/2019,155,411,566,6,2,2019
9,2/23/2019,130,271,401,6,2,2019
10,2/23/2019,119,139,258,6,2,2019
11,2/23/2019,104,195,299,6,2,2019
12,2/23/2019,61,196,257,6,2,2019
13,2/23/2019,127,272,399,6,2,2019
14,2/23/2019,127,73,200,6,2,2019
15,2/23/2019,112,369,481,6,2,2019
16,2/23/2019,110,251,361,6,2,2019
17,2/23/2019,59,341,400,6,2,2019
18,2/23/2019,14,295,309,6,2,2019
19,2/23/2019,19,141,160,6,2,2019
20,2/23/2019,64,174,238,6,2,2019
21,2/23/2019,144,172,316,6,2,2019
22,2/23/2019,151,131,282,6,2,2019
23,2/23/2019,96,185,281,6,2,2019
0,2/24/2019,63,59,122,7,2,2019
1,2/24/2019,26,0,26,7,2,2019
2,2/24/2019,37,0,37,7,2,2019
3,2/24/2019,51,0,51,7,2,2019
4,2/24/2019,60,0,60,7,2,2019
5,2/24/2019,108,0,108,7,2,2019
6,2/24/2019,186,81,267,7,2,2019
7,2/24/2019,196,253,449,7,2,2019
8,2/24/2019,99,479,578,7,2,2019
9,2/24/2019,65,163,228,7,2,2019
10,2/24/2019,136,1,137,7,2,2019
11,2/24/2019,141,232,373,7,2,2019
12,2/24/2019,146,248,394,7,2,2019
13,2/24/2019,146,361,507,7,2,2019
14,2/24/2019,141,183,324,7,2,2019
15,2/24/2019,136,375,511,7,2,2019
16,2/24/2019,153,256,409,7,2,2019
17,2/24/2019,207,284,491,7,2,2019
18,2/24/2019,81,349,430,7,2,2019
19,2/24/2019,45,174,219,7,2,2019
20,2/24/2019,88,114,202,7,2,2019
21,2/24/2019,157,216,373,7,2,2019
22,2/24/2019,160,458,618,7,2,2019
23,2/24/2019,113,330,443,7,2,2019
0,2/25/2019,75,149,224,1,2,2019
1,2/25/2019,8,0,8,1,2,2019
2,2/25/2019,11,1,12,1,2,2019
3,2/25/2019,59,0,59,1,2,2019
4,2/25/2019,51,0,51,1,2,2019
5,2/25/2019,68,0,68,1,2,2019
6,2/25/2019,158,76,234,1,2,2019
7,2/25/2019,157,232,389,1,2,2019
8,2/25/2019,119,272,391,1,2,2019
9,2/25/2019,80,238,318,1,2,2019
10,2/25/2019,95,124,219,1,2,2019
11,2/25/2019,82,230,312,1,2,2019
12,2/25/2019,97,124,221,1,2,2019
13,2/25/2019,96,217,313,1,2,2019
14,2/25/2019,116,67,183,1,2,2019
15,2/25/2019,161,272,433,1,2,2019
16,2/25/2019,183,266,449,1,2,2019
17,2/25/2019,124,215,339,1,2,2019
18,2/25/2019,43,188,231,1,2,2019
19,2/25/2019,13,394,407,1,2,2019
20,2/25/2019,50,45,95,1,2,2019
21,2/25/2019,142,185,327,1,2,2019
22,2/25/2019,96,141,237,1,2,2019
23,2/25/2019,104,132,236,1,2,2019
0,2/26/2019,29,111,140,2,2,2019
1,2/26/2019,21,13,34,2,2,2019
2,2/26/2019,21,0,21,2,2,2019
3,2/26/2019,81,0,81,2,2,2019
4,2/26/2019,43,0,43,2,2,2019
5,2/26/2019,114,1,115,2,2,2019
6,2/26/2019,242,22,264,2,2,2019
7,2/26/2019,162,116,278,2,2,2019
8,2/26/2019,93,272,365,2,2,2019
9,2/26/2019,92,337,429,2,2,2019
10,2/26/2019,111,35,146,2,2,2019
11,2/26/2019,111,194,305,2,2,2019
12,2/26/2019,97,122,219,2,2,2019
13,2/26/2019,95,186,281,2,2,2019
14,2/26/2019,109,101,210,2,2,2019
15,2/26/2019,70,237,307,2,2,2019
16,2/26/2019,101,112,213,2,2,2019
17,2/26/2019,91,219,310,2,2,2019
18,2/26/2019,23,212,235,2,2,2019
19,2/26/2019,27,251,278,2,2,2019
20,2/26/2019,64,0,64,2,2,2019
21,2/26/2019,201,206,407,2,2,2019
22,2/26/2019,170,168,338,2,2,2019
23,2/26/2019,99,101,200,2,2,2019
0,2/27/2019,61,66,127,3,2,2019
1,2/27/2019,9,0,9,3,2,2019
2,2/27/2019,10,0,10,3,2,2019
3,2/27/2019,27,0,27,3,2,2019
4,2/27/2019,32,0,32,3,2,2019
5,2/27/2019,151,0,151,3,2,2019
6,2/27/2019,231,23,254,3,2,2019
7,2/27/2019,199,113,312,3,2,2019
8,2/27/2019,100,272,372,3,2,2019
9,2/27/2019,144,250,394,3,2,2019
10,2/27/2019,116,56,172,3,2,2019
11,2/27/2019,76,295,371,3,2,2019
12,2/27/2019,67,118,185,3,2,2019
13,2/27/2019,82,145,227,3,2,2019
14,2/27/2019,124,43,167,3,2,2019
15,2/27/2019,103,164,267,3,2,2019
16,2/27/2019,97,157,254,3,2,2019
17,2/27/2019,142,197,339,3,2,2019
18,2/27/2019,37,187,224,3,2,2019
19,2/27/2019,18,224,242,3,2,2019
20,2/27/2019,64,48,112,3,2,2019
21,2/27/2019,250,89,339,3,2,2019
22,2/27/2019,223,154,377,3,2,2019
23,2/27/2019,197,86,283,3,2,2019
0,2/28/2019,118,34,152,4,2,2019
1,2/28/2019,36,0,36,4,2,2019
2,2/28/2019,36,0,36,4,2,2019
3,2/28/2019,94,0,94,4,2,2019
4,2/28/2019,109,0,109,4,2,2019
5,2/28/2019,160,0,160,4,2,2019
6,2/28/2019,269,58,327,4,2,2019
7,2/28/2019,278,107,385,4,2,2019
8,2/28/2019,246,310,556,4,2,2019
9,2/28/2019,155,312,467,4,2,2019
10,2/28/2019,218,55,273,4,2,2019
11,2/28/2019,263,194,457,4,2,2019
12,2/28/2019,83,219,302,4,2,2019
13,2/28/2019,136,256,392,4,2,2019
14,2/28/2019,137,153,290,4,2,2019
15,2/28/2019,107,215,322,4,2,2019
16,2/28/2019,115,122,237,4,2,2019
17,2/28/2019,127,145,272,4,2,2019
18,2/28/2019,48,216,264,4,2,2019
19,2/28/2019,25,212,237,4,2,2019
20,2/28/2019,132,79,211,4,2,2019
21,2/28/2019,308,181,489,4,2,2019
22,2/28/2019,329,146,475,4,2,2019
23,2/28/2019,258,53,311,4,2,2019
0,3/1/2019,140,105,245,5,3,2019
1,3/1/2019,37,1,38,5,3,2019
2,3/1/2019,24,0,24,5,3,2019
3,3/1/2019,58,0,58,5,3,2019
4,3/1/2019,91,0,91,5,3,2019
5,3/1/2019,199,0,199,5,3,2019
6,3/1/2019,365,27,392,5,3,2019
7,3/1/2019,321,80,401,5,3,2019
8,3/1/2019,188,223,411,5,3,2019
9,3/1/2019,211,271,482,5,3,2019
10,3/1/2019,197,160,357,5,3,2019
11,3/1/2019,148,181,329,5,3,2019
12,3/1/2019,137,136,273,5,3,2019
13,3/1/2019,104,175,279,5,3,2019
14,3/1/2019,177,116,293,5,3,2019
15,3/1/2019,168,226,394,5,3,2019
16,3/1/2019,137,166,303,5,3,2019
17,3/1/2019,169,184,353,5,3,2019
18,3/1/2019,56,214,270,5,3,2019
19,3/1/2019,38,92,130,5,3,2019
20,3/1/2019,110,105,215,5,3,2019
21,3/1/2019,290,208,498,5,3,2019
22,3/1/2019,212,163,375,5,3,2019
23,3/1/2019,269,194,463,5,3,2019
0,3/2/2019,139,124,263,6,3,2019
1,3/2/2019,29,8,37,6,3,2019
2,3/2/2019,29,13,42,6,3,2019
3,3/2/2019,96,0,96,6,3,2019
4,3/2/2019,34,0,34,6,3,2019
5,3/2/2019,169,1,170,6,3,2019
6,3/2/2019,340,47,387,6,3,2019
7,3/2/2019,359,193,552,6,3,2019
8,3/2/2019,212,350,562,6,3,2019
9,3/2/2019,151,377,528,6,3,2019
10,3/2/2019,254,70,324,6,3,2019
11,3/2/2019,83,240,323,6,3,2019
12,3/2/2019,126,170,296,6,3,2019
13,3/2/2019,113,168,281,6,3,2019
14,3/2/2019,132,155,287,6,3,2019
15,3/2/2019,143,159,302,6,3,2019
16,3/2/2019,96,192,288,6,3,2019
17,3/2/2019,65,334,399,6,3,2019
18,3/2/2019,38,228,266,6,3,2019
19,3/2/2019,52,157,209,6,3,2019
20,3/2/2019,96,85,181,6,3,2019
21,3/2/2019,157,166,323,6,3,2019
22,3/2/2019,178,71,249,6,3,2019
23,3/2/2019,103,72,175,6,3,2019
0,3/3/2019,57,57,114,7,3,2019
1,3/3/2019,15,2,17,7,3,2019
2,3/3/2019,30,0,30,7,3,2019
3,3/3/2019,57,0,57,7,3,2019
4,3/3/2019,78,0,78,7,3,2019
5,3/3/2019,158,0,158,7,3,2019
6,3/3/2019,202,39,241,7,3,2019
7,3/3/2019,236,166,402,7,3,2019
8,3/3/2019,91,411,502,7,3,2019
9,3/3/2019,97,273,370,7,3,2019
10,3/3/2019,168,72,240,7,3,2019
11,3/3/2019,171,153,324,7,3,2019
12,3/3/2019,170,169,339,7,3,2019
13,3/3/2019,163,361,524,7,3,2019
14,3/3/2019,147,117,264,7,3,2019
15,3/3/2019,160,393,553,7,3,2019
16,3/3/2019,143,183,326,7,3,2019
17,3/3/2019,148,226,374,7,3,2019
18,3/3/2019,44,299,343,7,3,2019
19,3/3/2019,40,249,289,7,3,2019
20,3/3/2019,88,46,134,7,3,2019
21,3/3/2019,177,237,414,7,3,2019
22,3/3/2019,185,242,427,7,3,2019
23,3/3/2019,111,245,356,7,3,2019
0,3/4/2019,62,182,244,1,3,2019
1,3/4/2019,27,2,29,1,3,2019
2,3/4/2019,6,2,8,1,3,2019
3,3/4/2019,12,0,12,1,3,2019
4,3/4/2019,29,0,29,1,3,2019
5,3/4/2019,95,0,95,1,3,2019
6,3/4/2019,125,47,172,1,3,2019
7,3/4/2019,181,137,318,1,3,2019
8,3/4/2019,122,306,428,1,3,2019
9,3/4/2019,68,239,307,1,3,2019
10,3/4/2019,108,55,163,1,3,2019
11,3/4/2019,106,225,331,1,3,2019
12,3/4/2019,133,83,216,1,3,2019
13,3/4/2019,92,293,385,1,3,2019
14,3/4/2019,145,176,321,1,3,2019
15,3/4/2019,151,212,363,1,3,2019
16,3/4/2019,113,208,321,1,3,2019
17,3/4/2019,80,252,332,1,3,2019
18,3/4/2019,24,282,306,1,3,2019
19,3/4/2019,17,292,309,1,3,2019
20,3/4/2019,59,95,154,1,3,2019
21,3/4/2019,118,111,229,1,3,2019
22,3/4/2019,116,161,277,1,3,2019
23,3/4/2019,62,143,205,1,3,2019
0,3/5/2019,44,157,201,2,3,2019
1,3/5/2019,4,23,27,2,3,2019
2,3/5/2019,25,0,25,2,3,2019
3,3/5/2019,56,0,56,2,3,2019
4,3/5/2019,38,1,39,2,3,2019
5,3/5/2019,77,0,77,2,3,2019
6,3/5/2019,213,44,257,2,3,2019
7,3/5/2019,168,201,369,2,3,2019
8,3/5/2019,100,291,391,2,3,2019
9,3/5/2019,105,278,383,2,3,2019
10,3/5/2019,127,10,137,2,3,2019
11,3/5/2019,119,277,396,2,3,2019
12,3/5/2019,73,176,249,2,3,2019
13,3/5/2019,89,211,300,2,3,2019
14,3/5/2019,67,222,289,2,3,2019
15,3/5/2019,83,139,222,2,3,2019
16,3/5/2019,95,221,316,2,3,2019
17,3/5/2019,100,140,240,2,3,2019
18,3/5/2019,9,286,295,2,3,2019
19,3/5/2019,18,132,150,2,3,2019
20,3/5/2019,87,63,150,2,3,2019
21,3/5/2019,152,186,338,2,3,2019
22,3/5/2019,214,193,407,2,3,2019
23,3/5/2019,104,123,227,2,3,2019
0,3/6/2019,48,72,120,3,3,2019
1,3/6/2019,16,48,64,3,3,2019
2,3/6/2019,8,0,8,3,3,2019
3,3/6/2019,56,0,56,3,3,2019
4,3/6/2019,60,0,60,3,3,2019
5,3/6/2019,97,0,97,3,3,2019
6,3/6/2019,220,53,273,3,3,2019
7,3/6/2019,148,142,290,3,3,2019
8,3/6/2019,98,361,459,3,3,2019
9,3/6/2019,130,234,364,3,3,2019
10,3/6/2019,127,2,129,3,3,2019
11,3/6/2019,98,284,382,3,3,2019
12,3/6/2019,72,186,258,3,3,2019
13,3/6/2019,105,115,220,3,3,2019
14,3/6/2019,92,102,194,3,3,2019
15,3/6/2019,98,125,223,3,3,2019
16,3/6/2019,95,174,269,3,3,2019
17,3/6/2019,58,126,184,3,3,2019
18,3/6/2019,37,318,355,3,3,2019
19,3/6/2019,13,150,163,3,3,2019
20,3/6/2019,71,100,171,3,3,2019
21,3/6/2019,142,120,262,3,3,2019
22,3/6/2019,237,111,348,3,3,2019
23,3/6/2019,157,241,398,3,3,2019
0,3/7/2019,79,96,175,4,3,2019
1,3/7/2019,11,0,11,4,3,2019
2,3/7/2019,18,0,18,4,3,2019
3,3/7/2019,90,0,90,4,3,2019
4,3/7/2019,74,0,74,4,3,2019
5,3/7/2019,116,0,116,4,3,2019
6,3/7/2019,244,1,245,4,3,2019
7,3/7/2019,260,175,435,4,3,2019
8,3/7/2019,123,366,489,4,3,2019
9,3/7/2019,123,371,494,4,3,2019
10,3/7/2019,149,9,158,4,3,2019
11,3/7/2019,199,296,495,4,3,2019
12,3/7/2019,89,247,336,4,3,2019
13,3/7/2019,77,182,259,4,3,2019
14,3/7/2019,120,48,168,4,3,2019
15,3/7/2019,100,193,293,4,3,2019
16,3/7/2019,125,161,286,4,3,2019
17,3/7/2019,126,250,376,4,3,2019
18,3/7/2019,21,145,166,4,3,2019
19,3/7/2019,25,243,268,4,3,2019
20,3/7/2019,110,126,236,4,3,2019
21,3/7/2019,238,225,463,4,3,2019
22,3/7/2019,357,124,481,4,3,2019
23,3/7/2019,218,84,302,4,3,2019
0,3/8/2019,161,90,251,5,3,2019
1,3/8/2019,50,5,55,5,3,2019
2,3/8/2019,32,14,46,5,3,2019
3,3/8/2019,82,0,82,5,3,2019
4,3/8/2019,70,0,70,5,3,2019
5,3/8/2019,161,0,161,5,3,2019
6,3/8/2019,359,53,412,5,3,2019
7,3/8/2019,330,84,414,5,3,2019
8,3/8/2019,185,442,627,5,3,2019
9,3/8/2019,174,355,529,5,3,2019
10,3/8/2019,164,144,308,5,3,2019
11,3/8/2019,131,80,211,5,3,2019
12,3/8/2019,76,218,294,5,3,2019
13,3/8/2019,88,214,302,5,3,2019
14,3/8/2019,131,73,204,5,3,2019
15,3/8/2019,139,226,365,5,3,2019
16,3/8/2019,134,127,261,5,3,2019
17,3/8/2019,130,186,316,5,3,2019
18,3/8/2019,42,122,164,5,3,2019
19,3/8/2019,23,344,367,5,3,2019
20,3/8/2019,65,97,162,5,3,2019
21,3/8/2019,300,156,456,5,3,2019
22,3/8/2019,239,188,427,5,3,2019
23,3/8/2019,187,193,380,5,3,2019
0,3/9/2019,113,127,240,6,3,2019
1,3/9/2019,27,27,54,6,3,2019
2,3/9/2019,28,13,41,6,3,2019
3,3/9/2019,66,0,66,6,3,2019
4,3/9/2019,57,0,57,6,3,2019
5,3/9/2019,127,1,128,6,3,2019
6,3/9/2019,344,72,416,6,3,2019
7,3/9/2019,289,155,444,6,3,2019
8,3/9/2019,207,357,564,6,3,2019
9,3/9/2019,160,438,598,6,3,2019
10,3/9/2019,132,49,181,6,3,2019
11,3/9/2019,77,284,361,6,3,2019
12,3/9/2019,84,219,303,6,3,2019
13,3/9/2019,88,176,264,6,3,2019
14,3/9/2019,124,151,275,6,3,2019
15,3/9/2019,105,290,395,6,3,2019
16,3/9/2019,91,257,348,6,3,2019
17,3/9/2019,56,319,375,6,3,2019
18,3/9/2019,49,250,299,6,3,2019
19,3/9/2019,14,126,140,6,3,2019
20,3/9/2019,90,213,303,6,3,2019
21,3/9/2019,148,230,378,6,3,2019
22,3/9/2019,180,132,312,6,3,2019
23,3/9/2019,84,78,162,6,3,2019
0,3/10/2019,35,85,120,7,3,2019
1,3/10/2019,10,0,10,7,3,2019
2,3/10/2019,0,0,0,7,3,2019
3,3/10/2019,21,0,21,7,3,2019
4,3/10/2019,46,0,46,7,3,2019
5,3/10/2019,108,0,108,7,3,2019
6,3/10/2019,139,0,139,7,3,2019
7,3/10/2019,263,78,341,7,3,2019
8,3/10/2019,200,275,475,7,3,2019
9,3/10/2019,84,418,502,7,3,2019
10,3/10/2019,98,262,360,7,3,2019
11,3/10/2019,136,42,178,7,3,2019
12,3/10/2019,167,155,322,7,3,2019
13,3/10/2019,131,254,385,7,3,2019
14,3/10/2019,143,309,452,7,3,2019
15,3/10/2019,153,119,272,7,3,2019
16,3/10/2019,113,455,568,7,3,2019
17,3/10/2019,155,186,341,7,3,2019
18,3/10/2019,192,167,359,7,3,2019
19,3/10/2019,38,298,336,7,3,2019
20,3/10/2019,52,297,349,7,3,2019
21,3/10/2019,85,162,247,7,3,2019
22,3/10/2019,160,173,333,7,3,2019
23,3/10/2019,173,286,459,7,3,2019
0,3/11/2019,99,245,344,1,3,2019
1,3/11/2019,33,157,190,1,3,2019
2,3/11/2019,26,6,32,1,3,2019
3,3/11/2019,5,0,5,1,3,2019
4,3/11/2019,33,0,33,1,3,2019
5,3/11/2019,42,0,42,1,3,2019
6,3/11/2019,92,0,92,1,3,2019
7,3/11/2019,160,54,214,1,3,2019
8,3/11/2019,161,281,442,1,3,2019
9,3/11/2019,83,281,364,1,3,2019
10,3/11/2019,117,308,425,1,3,2019
11,3/11/2019,148,77,225,1,3,2019
12,3/11/2019,118,254,372,1,3,2019
13,3/11/2019,111,181,292,1,3,2019
14,3/11/2019,122,183,305,1,3,2019
15,3/11/2019,119,71,190,1,3,2019
16,3/11/2019,170,234,404,1,3,2019
17,3/11/2019,114,316,430,1,3,2019
18,3/11/2019,168,391,559,1,3,2019
19,3/11/2019,59,270,329,1,3,2019
20,3/11/2019,31,339,370,1,3,2019
21,3/11/2019,79,77,156,1,3,2019
22,3/11/2019,148,155,303,1,3,2019
23,3/11/2019,106,213,319,1,3,2019
0,3/12/2019,67,140,207,2,3,2019
1,3/12/2019,27,90,117,2,3,2019
2,3/12/2019,11,13,24,2,3,2019
3,3/12/2019,21,0,21,2,3,2019
4,3/12/2019,70,0,70,2,3,2019
5,3/12/2019,55,0,55,2,3,2019
6,3/12/2019,97,1,98,2,3,2019
7,3/12/2019,191,27,218,2,3,2019
8,3/12/2019,189,126,315,2,3,2019
9,3/12/2019,118,406,524,2,3,2019
10,3/12/2019,84,274,358,2,3,2019
11,3/12/2019,159,13,172,2,3,2019
12,3/12/2019,100,252,352,2,3,2019
13,3/12/2019,81,255,336,2,3,2019
14,3/12/2019,104,203,307,2,3,2019
15,3/12/2019,73,223,296,2,3,2019
16,3/12/2019,128,154,282,2,3,2019
17,3/12/2019,87,169,256,2,3,2019
18,3/12/2019,61,243,304,2,3,2019
19,3/12/2019,67,157,224,2,3,2019
20,3/12/2019,27,155,182,2,3,2019
21,3/12/2019,111,71,182,2,3,2019
22,3/12/2019,184,219,403,2,3,2019
23,3/12/2019,168,149,317,2,3,2019
0,3/13/2019,155,46,201,3,3,2019
1,3/13/2019,59,110,169,3,3,2019
2,3/13/2019,8,1,9,3,3,2019
3,3/13/2019,13,0,13,3,3,2019
4,3/13/2019,47,0,47,3,3,2019
5,3/13/2019,80,0,80,3,3,2019
6,3/13/2019,125,1,126,3,3,2019
7,3/13/2019,226,33,259,3,3,2019
8,3/13/2019,165,143,308,3,3,2019
9,3/13/2019,104,293,397,3,3,2019
10,3/13/2019,95,267,362,3,3,2019
11,3/13/2019,159,8,167,3,3,2019
12,3/13/2019,153,261,414,3,3,2019
13,3/13/2019,82,164,246,3,3,2019
14,3/13/2019,92,96,188,3,3,2019
15,3/13/2019,103,161,264,3,3,2019
16,3/13/2019,73,180,253,3,3,2019
17,3/13/2019,114,92,206,3,3,2019
18,3/13/2019,76,170,246,3,3,2019
19,3/13/2019,70,226,296,3,3,2019
20,3/13/2019,55,122,177,3,3,2019
21,3/13/2019,141,149,290,3,3,2019
22,3/13/2019,208,128,336,3,3,2019
23,3/13/2019,272,177,449,3,3,2019
0,3/14/2019,220,170,390,4,3,2019
1,3/14/2019,106,37,143,4,3,2019
2,3/14/2019,12,2,14,4,3,2019
3,3/14/2019,42,0,42,4,3,2019
4,3/14/2019,87,0,87,4,3,2019
5,3/14/2019,114,0,114,4,3,2019
6,3/14/2019,201,0,201,4,3,2019
7,3/14/2019,245,7,252,4,3,2019
8,3/14/2019,332,244,576,4,3,2019
9,3/14/2019,169,379,548,4,3,2019
10,3/14/2019,160,406,566,4,3,2019
11,3/14/2019,173,13,186,4,3,2019
12,3/14/2019,202,231,433,4,3,2019
13,3/14/2019,119,212,331,4,3,2019
14,3/14/2019,95,260,355,4,3,2019
15,3/14/2019,84,35,119,4,3,2019
16,3/14/2019,129,124,253,4,3,2019
17,3/14/2019,123,327,450,4,3,2019
18,3/14/2019,96,220,316,4,3,2019
19,3/14/2019,72,347,419,4,3,2019
20,3/14/2019,34,211,245,4,3,2019
21,3/14/2019,135,115,250,4,3,2019
22,3/14/2019,267,214,481,4,3,2019
23,3/14/2019,306,241,547,4,3,2019
0,3/15/2019,216,109,325,5,3,2019
1,3/15/2019,135,183,318,5,3,2019
2,3/15/2019,60,10,70,5,3,2019
3,3/15/2019,27,2,29,5,3,2019
4,3/15/2019,86,0,86,5,3,2019
5,3/15/2019,110,0,110,5,3,2019
6,3/15/2019,241,0,241,5,3,2019
7,3/15/2019,354,83,437,5,3,2019
8,3/15/2019,294,184,478,5,3,2019
9,3/15/2019,148,402,550,5,3,2019
10,3/15/2019,202,296,498,5,3,2019
11,3/15/2019,167,108,275,5,3,2019
12,3/15/2019,140,234,374,5,3,2019
13,3/15/2019,123,217,340,5,3,2019
14,3/15/2019,103,139,242,5,3,2019
15,3/15/2019,94,114,208,5,3,2019
16,3/15/2019,120,279,399,5,3,2019
17,3/15/2019,148,224,372,5,3,2019
18,3/15/2019,115,188,303,5,3,2019
19,3/15/2019,79,292,371,5,3,2019
20,3/15/2019,58,457,515,5,3,2019
21,3/15/2019,155,85,240,5,3,2019
22,3/15/2019,295,354,649,5,3,2019
23,3/15/2019,331,112,443,5,3,2019
0,3/16/2019,228,152,380,6,3,2019
1,3/16/2019,84,251,335,6,3,2019
2,3/16/2019,34,56,90,6,3,2019
3,3/16/2019,24,28,52,6,3,2019
4,3/16/2019,81,15,96,6,3,2019
5,3/16/2019,75,0,75,6,3,2019
6,3/16/2019,156,1,157,6,3,2019
7,3/16/2019,409,58,467,6,3,2019
8,3/16/2019,419,201,620,6,3,2019
9,3/16/2019,189,566,755,6,3,2019
10,3/16/2019,196,394,590,6,3,2019
11,3/16/2019,218,206,424,6,3,2019
12,3/16/2019,201,322,523,6,3,2019
13,3/16/2019,119,264,383,6,3,2019
14,3/16/2019,224,219,443,6,3,2019
15,3/16/2019,133,118,251,6,3,2019
16,3/16/2019,179,324,503,6,3,2019
17,3/16/2019,135,201,336,6,3,2019
18,3/16/2019,88,287,375,6,3,2019
19,3/16/2019,52,358,410,6,3,2019
20,3/16/2019,47,143,190,6,3,2019
21,3/16/2019,114,162,276,6,3,2019
22,3/16/2019,241,209,450,6,3,2019
23,3/16/2019,247,80,327,6,3,2019
0,3/17/2019,140,203,343,7,3,2019
1,3/17/2019,78,40,118,7,3,2019
2,3/17/2019,21,55,76,7,3,2019
3,3/17/2019,50,0,50,7,3,2019
4,3/17/2019,114,0,114,7,3,2019
5,3/17/2019,130,0,130,7,3,2019
6,3/17/2019,227,0,227,7,3,2019
7,3/17/2019,353,92,445,7,3,2019
8,3/17/2019,199,256,455,7,3,2019
9,3/17/2019,140,499,639,7,3,2019
10,3/17/2019,103,236,339,7,3,2019
11,3/17/2019,222,35,257,7,3,2019
12,3/17/2019,159,263,422,7,3,2019
13,3/17/2019,134,275,409,7,3,2019
14,3/17/2019,122,352,474,7,3,2019
15,3/17/2019,149,143,292,7,3,2019
16,3/17/2019,111,422,533,7,3,2019
17,3/17/2019,146,286,432,7,3,2019
18,3/17/2019,88,174,262,7,3,2019
19,3/17/2019,53,281,334,7,3,2019
20,3/17/2019,71,359,430,7,3,2019
21,3/17/2019,82,147,229,7,3,2019
22,3/17/2019,207,144,351,7,3,2019
23,3/17/2019,211,241,452,7,3,2019
0,3/18/2019,126,279,405,1,3,2019
1,3/18/2019,63,165,228,1,3,2019
2,3/18/2019,21,7,28,1,3,2019
3,3/18/2019,52,1,53,1,3,2019
4,3/18/2019,70,0,70,1,3,2019
5,3/18/2019,45,0,45,1,3,2019
6,3/18/2019,145,0,145,1,3,2019
7,3/18/2019,270,49,319,1,3,2019
8,3/18/2019,204,139,343,1,3,2019
9,3/18/2019,134,301,435,1,3,2019
10,3/18/2019,182,256,438,1,3,2019
11,3/18/2019,291,76,367,1,3,2019
12,3/18/2019,231,259,490,1,3,2019
13,3/18/2019,126,279,405,1,3,2019
14,3/18/2019,213,121,334,1,3,2019
15,3/18/2019,245,64,309,1,3,2019
16,3/18/2019,323,250,573,1,3,2019
17,3/18/2019,322,141,463,1,3,2019
18,3/18/2019,348,198,546,1,3,2019
19,3/18/2019,126,211,337,1,3,2019
20,3/18/2019,69,212,281,1,3,2019
21,3/18/2019,109,61,170,1,3,2019
22,3/18/2019,275,90,365,1,3,2019
23,3/18/2019,214,132,346,1,3,2019
0,3/19/2019,136,80,216,2,3,2019
1,3/19/2019,62,87,149,2,3,2019
2,3/19/2019,10,14,24,2,3,2019
3,3/19/2019,41,0,41,2,3,2019
4,3/19/2019,86,0,86,2,3,2019
5,3/19/2019,72,0,72,2,3,2019
6,3/19/2019,117,1,118,2,3,2019
7,3/19/2019,282,40,322,2,3,2019
8,3/19/2019,247,142,389,2,3,2019
9,3/19/2019,127,299,426,2,3,2019
10,3/19/2019,153,227,380,2,3,2019
11,3/19/2019,229,39,268,2,3,2019
12,3/19/2019,205,130,335,2,3,2019
13,3/19/2019,132,312,444,2,3,2019
14,3/19/2019,161,164,325,2,3,2019
15,3/19/2019,176,140,316,2,3,2019
16,3/19/2019,132,242,374,2,3,2019
17,3/19/2019,156,171,327,2,3,2019
18,3/19/2019,162,219,381,2,3,2019
19,3/19/2019,42,124,166,2,3,2019
20,3/19/2019,41,127,168,2,3,2019
21,3/19/2019,140,60,200,2,3,2019
22,3/19/2019,199,188,387,2,3,2019
23,3/19/2019,168,119,287,2,3,2019
0,3/20/2019,132,131,263,3,3,2019
1,3/20/2019,59,68,127,3,3,2019
2,3/20/2019,6,0,6,3,3,2019
3,3/20/2019,16,0,16,3,3,2019
4,3/20/2019,34,0,34,3,3,2019
5,3/20/2019,109,0,109,3,3,2019
6,3/20/2019,175,0,175,3,3,2019
7,3/20/2019,251,3,254,3,3,2019
8,3/20/2019,211,195,406,3,3,2019
9,3/20/2019,110,374,484,3,3,2019
10,3/20/2019,111,165,276,3,3,2019
11,3/20/2019,206,45,251,3,3,2019
12,3/20/2019,153,222,375,3,3,2019
13,3/20/2019,97,261,358,3,3,2019
14,3/20/2019,111,88,199,3,3,2019
15,3/20/2019,135,102,237,3,3,2019
16,3/20/2019,99,149,248,3,3,2019
17,3/20/2019,133,96,229,3,3,2019
18,3/20/2019,85,226,311,3,3,2019
19,3/20/2019,88,202,290,3,3,2019
20,3/20/2019,44,170,214,3,3,2019
21,3/20/2019,105,155,260,3,3,2019
22,3/20/2019,220,168,388,3,3,2019
23,3/20/2019,255,115,370,3,3,2019
0,3/21/2019,134,150,284,4,3,2019
1,3/21/2019,112,53,165,4,3,2019
2,3/21/2019,22,38,60,4,3,2019
3,3/21/2019,36,0,36,4,3,2019
4,3/21/2019,98,0,98,4,3,2019
5,3/21/2019,79,0,79,4,3,2019
6,3/21/2019,201,0,201,4,3,2019
7,3/21/2019,267,42,309,4,3,2019
8,3/21/2019,331,238,569,4,3,2019
9,3/21/2019,148,370,518,4,3,2019
10,3/21/2019,155,377,532,4,3,2019
11,3/21/2019,243,2,245,4,3,2019
12,3/21/2019,279,238,517,4,3,2019
13,3/21/2019,94,193,287,4,3,2019
14,3/21/2019,123,183,306,4,3,2019
15,3/21/2019,109,96,205,4,3,2019
16,3/21/2019,137,113,250,4,3,2019
17,3/21/2019,141,200,341,4,3,2019
18,3/21/2019,156,218,374,4,3,2019
19,3/21/2019,100,247,347,4,3,2019
20,3/21/2019,61,188,249,4,3,2019
21,3/21/2019,177,104,281,4,3,2019
22,3/21/2019,318,156,474,4,3,2019
23,3/21/2019,284,165,449,4,3,2019
0,3/22/2019,239,135,374,5,3,2019
1,3/22/2019,139,60,199,5,3,2019
2,3/22/2019,54,2,56,5,3,2019
3,3/22/2019,14,0,14,5,3,2019
4,3/22/2019,70,0,70,5,3,2019
5,3/22/2019,106,1,107,5,3,2019
6,3/22/2019,266,0,266,5,3,2019
7,3/22/2019,445,56,501,5,3,2019
8,3/22/2019,412,214,626,5,3,2019
9,3/22/2019,190,408,598,5,3,2019
10,3/22/2019,247,352,599,5,3,2019
11,3/22/2019,299,44,343,5,3,2019
12,3/22/2019,160,323,483,5,3,2019
13,3/22/2019,145,194,339,5,3,2019
14,3/22/2019,151,115,266,5,3,2019
15,3/22/2019,148,112,260,5,3,2019
16,3/22/2019,165,241,406,5,3,2019
17,3/22/2019,165,192,357,5,3,2019
18,3/22/2019,171,127,298,5,3,2019
19,3/22/2019,101,248,349,5,3,2019
20,3/22/2019,98,241,339,5,3,2019
21,3/22/2019,184,142,326,5,3,2019
22,3/22/2019,276,183,459,5,3,2019
23,3/22/2019,404,216,620,5,3,2019
0,3/23/2019,298,170,468,6,3,2019
1,3/23/2019,69,93,162,6,3,2019
2,3/23/2019,29,54,83,6,3,2019
3,3/23/2019,61,15,76,6,3,2019
4,3/23/2019,126,0,126,6,3,2019
5,3/23/2019,125,0,125,6,3,2019
6,3/23/2019,276,1,277,6,3,2019
7,3/23/2019,437,21,458,6,3,2019
8,3/23/2019,510,142,652,6,3,2019
9,3/23/2019,304,589,893,6,3,2019
10,3/23/2019,284,472,756,6,3,2019
11,3/23/2019,317,25,342,6,3,2019
12,3/23/2019,216,214,430,6,3,2019
13,3/23/2019,148,280,428,6,3,2019
14,3/23/2019,179,166,345,6,3,2019
15,3/23/2019,205,218,423,6,3,2019
16,3/23/2019,189,263,452,6,3,2019
17,3/23/2019,156,247,403,6,3,2019
18,3/23/2019,76,359,435,6,3,2019
19,3/23/2019,58,250,308,6,3,2019
20,3/23/2019,45,249,294,6,3,2019
21,3/23/2019,141,165,306,6,3,2019
22,3/23/2019,244,229,473,6,3,2019
23,3/23/2019,209,186,395,6,3,2019
0,3/24/2019,154,126,280,7,3,2019
1,3/24/2019,95,88,183,7,3,2019
2,3/24/2019,19,0,19,7,3,2019
3,3/24/2019,18,0,18,7,3,2019
4,3/24/2019,88,0,88,7,3,2019
5,3/24/2019,139,0,139,7,3,2019
6,3/24/2019,234,0,234,7,3,2019
7,3/24/2019,335,82,417,7,3,2019
8,3/24/2019,265,218,483,7,3,2019
9,3/24/2019,158,649,807,7,3,2019
10,3/24/2019,141,340,481,7,3,2019
11,3/24/2019,232,1,233,7,3,2019
12,3/24/2019,282,225,507,7,3,2019
13,3/24/2019,158,403,561,7,3,2019
14,3/24/2019,173,347,520,7,3,2019
15,3/24/2019,142,108,250,7,3,2019
16,3/24/2019,122,565,687,7,3,2019
17,3/24/2019,112,257,369,7,3,2019
18,3/24/2019,110,154,264,7,3,2019
19,3/24/2019,122,210,332,7,3,2019
20,3/24/2019,99,329,428,7,3,2019
21,3/24/2019,123,354,477,7,3,2019
22,3/24/2019,224,156,380,7,3,2019
23,3/24/2019,192,213,405,7,3,2019
0,3/25/2019,115,364,479,1,3,2019
1,3/25/2019,82,112,194,1,3,2019
2,3/25/2019,46,2,48,1,3,2019
3,3/25/2019,17,0,17,1,3,2019
4,3/25/2019,61,0,61,1,3,2019
5,3/25/2019,56,0,56,1,3,2019
6,3/25/2019,150,0,150,1,3,2019
7,3/25/2019,257,69,326,1,3,2019
8,3/25/2019,248,143,391,1,3,2019
9,3/25/2019,169,329,498,1,3,2019
10,3/25/2019,157,230,387,1,3,2019
11,3/25/2019,206,166,372,1,3,2019
12,3/25/2019,173,295,468,1,3,2019
13,3/25/2019,131,228,359,1,3,2019
14,3/25/2019,96,252,348,1,3,2019
15,3/25/2019,103,128,231,1,3,2019
16,3/25/2019,119,143,262,1,3,2019
17,3/25/2019,121,251,372,1,3,2019
18,3/25/2019,73,341,414,1,3,2019
19,3/25/2019,30,288,318,1,3,2019
20,3/25/2019,33,226,259,1,3,2019
21,3/25/2019,79,220,299,1,3,2019
22,3/25/2019,159,151,310,1,3,2019
23,3/25/2019,128,87,215,1,3,2019
0,3/26/2019,76,227,303,2,3,2019
1,3/26/2019,47,149,196,2,3,2019
2,3/26/2019,4,4,8,2,3,2019
3,3/26/2019,19,13,32,2,3,2019
4,3/26/2019,68,0,68,2,3,2019
5,3/26/2019,63,0,63,2,3,2019
6,3/26/2019,158,1,159,2,3,2019
7,3/26/2019,274,0,274,2,3,2019
8,3/26/2019,267,0,267,2,3,2019
9,3/26/2019,132,173,305,2,3,2019
10,3/26/2019,133,391,524,2,3,2019
11,3/26/2019,175,193,368,2,3,2019
12,3/26/2019,142,457,599,2,3,2019
13,3/26/2019,83,203,286,2,3,2019
14,3/26/2019,70,247,317,2,3,2019
15,3/26/2019,78,145,223,2,3,2019
16,3/26/2019,94,191,285,2,3,2019
17,3/26/2019,63,194,257,2,3,2019
18,3/26/2019,67,238,305,2,3,2019
19,3/26/2019,18,190,208,2,3,2019
20,3/26/2019,31,236,267,2,3,2019
21,3/26/2019,87,78,165,2,3,2019
22,3/26/2019,184,299,483,2,3,2019
23,3/26/2019,143,168,311,2,3,2019
0,3/27/2019,116,88,204,3,3,2019
1,3/27/2019,94,124,218,3,3,2019
2,3/27/2019,32,0,32,3,3,2019
3,3/27/2019,24,0,24,3,3,2019
4,3/27/2019,28,0,28,3,3,2019
5,3/27/2019,90,0,90,3,3,2019
6,3/27/2019,123,0,123,3,3,2019
7,3/27/2019,240,76,316,3,3,2019
8,3/27/2019,238,180,418,3,3,2019
9,3/27/2019,135,363,498,3,3,2019
10,3/27/2019,108,301,409,3,3,2019
11,3/27/2019,166,5,171,3,3,2019
12,3/27/2019,121,313,434,3,3,2019
13,3/27/2019,55,160,215,3,3,2019
14,3/27/2019,120,154,274,3,3,2019
15,3/27/2019,113,73,186,3,3,2019
16,3/27/2019,93,295,388,3,3,2019
17,3/27/2019,106,238,344,3,3,2019
18,3/27/2019,96,162,258,3,3,2019
19,3/27/2019,62,256,318,3,3,2019
20,3/27/2019,47,126,173,3,3,2019
21,3/27/2019,126,238,364,3,3,2019
22,3/27/2019,196,89,285,3,3,2019
23,3/27/2019,242,217,459,3,3,2019
0,3/28/2019,162,169,331,4,3,2019
1,3/28/2019,110,113,223,4,3,2019
2,3/28/2019,22,0,22,4,3,2019
3,3/28/2019,34,0,34,4,3,2019
4,3/28/2019,85,0,85,4,3,2019
5,3/28/2019,124,0,124,4,3,2019
6,3/28/2019,222,0,222,4,3,2019
7,3/28/2019,296,70,366,4,3,2019
8,3/28/2019,331,219,550,4,3,2019
9,3/28/2019,165,272,437,4,3,2019
10,3/28/2019,118,407,525,4,3,2019
11,3/28/2019,251,43,294,4,3,2019
12,3/28/2019,212,156,368,4,3,2019
13,3/28/2019,144,223,367,4,3,2019
14,3/28/2019,130,268,398,4,3,2019
15,3/28/2019,139,200,339,4,3,2019
16,3/28/2019,87,208,295,4,3,2019
17,3/28/2019,146,256,402,4,3,2019
18,3/28/2019,144,244,388,4,3,2019
19,3/28/2019,46,261,307,4,3,2019
20,3/28/2019,37,206,243,4,3,2019
21,3/28/2019,168,185,353,4,3,2019
22,3/28/2019,281,209,490,4,3,2019
23,3/28/2019,298,164,462,4,3,2019
0,3/29/2019,199,251,450,5,3,2019
1,3/29/2019,127,91,218,5,3,2019
2,3/29/2019,100,0,100,5,3,2019
3,3/29/2019,39,0,39,5,3,2019
4,3/29/2019,88,0,88,5,3,2019
5,3/29/2019,151,2,153,5,3,2019
6,3/29/2019,318,0,318,5,3,2019
7,3/29/2019,337,47,384,5,3,2019
8,3/29/2019,417,191,608,5,3,2019
9,3/29/2019,211,357,568,5,3,2019
10,3/29/2019,258,360,618,5,3,2019
11,3/29/2019,221,112,333,5,3,2019
12,3/29/2019,179,227,406,5,3,2019
13,3/29/2019,92,235,327,5,3,2019
14,3/29/2019,124,185,309,5,3,2019
15,3/29/2019,127,174,301,5,3,2019
16,3/29/2019,146,375,521,5,3,2019
17,3/29/2019,109,239,348,5,3,2019
18,3/29/2019,101,248,349,5,3,2019
19,3/29/2019,78,316,394,5,3,2019
20,3/29/2019,34,165,199,5,3,2019
21,3/29/2019,171,124,295,5,3,2019
22,3/29/2019,416,265,681,5,3,2019
23,3/29/2019,293,214,507,5,3,2019
0,3/30/2019,252,284,536,6,3,2019
1,3/30/2019,152,210,362,6,3,2019
2,3/30/2019,46,2,48,6,3,2019
3,3/30/2019,48,13,61,6,3,2019
4,3/30/2019,112,0,112,6,3,2019
5,3/30/2019,100,0,100,6,3,2019
6,3/30/2019,222,1,223,6,3,2019
7,3/30/2019,348,2,350,6,3,2019
8,3/30/2019,390,292,682,6,3,2019
9,3/30/2019,244,422,666,6,3,2019
10,3/30/2019,277,393,670,6,3,2019
11,3/30/2019,291,183,474,6,3,2019
12,3/30/2019,195,337,532,6,3,2019
13,3/30/2019,79,214,293,6,3,2019
14,3/30/2019,162,326,488,6,3,2019
15,3/30/2019,129,232,361,6,3,2019
16,3/30/2019,199,460,659,6,3,2019
17,3/30/2019,89,401,490,6,3,2019
18,3/30/2019,98,534,632,6,3,2019
19,3/30/2019,51,303,354,6,3,2019
20,3/30/2019,33,147,180,6,3,2019
21,3/30/2019,136,215,351,6,3,2019
22,3/30/2019,257,334,591,6,3,2019
23,3/30/2019,202,331,533,6,3,2019
0,3/31/2019,132,331,463,7,3,2019
1,3/31/2019,91,86,177,7,3,2019
2,3/31/2019,14,0,14,7,3,2019
3,3/31/2019,32,0,32,7,3,2019
4,3/31/2019,110,0,110,7,3,2019
5,3/31/2019,110,0,110,7,3,2019
6,3/31/2019,228,2,230,7,3,2019
7,3/31/2019,292,78,370,7,3,2019
8,3/31/2019,300,255,555,7,3,2019
9,3/31/2019,182,548,730,7,3,2019
10,3/31/2019,150,346,496,7,3,2019
11,3/31/2019,252,0,252,7,3,2019
12,3/31/2019,202,315,517,7,3,2019
13,3/31/2019,218,263,481,7,3,2019
14,3/31/2019,176,361,537,7,3,2019
15,3/31/2019,148,200,348,7,3,2019
16,3/31/2019,141,489,630,7,3,2019
17,3/31/2019,133,383,516,7,3,2019
18,3/31/2019,122,57,179,7,3,2019
19,3/31/2019,61,487,548,7,3,2019
20,3/31/2019,46,383,429,7,3,2019
21,3/31/2019,110,168,278,7,3,2019
22,3/31/2019,193,163,356,7,3,2019
23,3/31/2019,136,402,538,7,3,2019
0,4/1/2019,65,436,501,1,4,2019
1,4/1/2019,65,122,187,1,4,2019
2,4/1/2019,18,29,47,1,4,2019
3,4/1/2019,29,39,68,1,4,2019
4,4/1/2019,34,33,67,1,4,2019
5,4/1/2019,83,0,83,1,4,2019
6,4/1/2019,149,1,150,1,4,2019
7,4/1/2019,249,145,394,1,4,2019
8,4/1/2019,324,171,495,1,4,2019
9,4/1/2019,189,433,622,1,4,2019
10,4/1/2019,78,272,350,1,4,2019
11,4/1/2019,149,173,322,1,4,2019
12,4/1/2019,92,258,350,1,4,2019
13,4/1/2019,96,181,277,1,4,2019
14,4/1/2019,121,246,367,1,4,2019
15,4/1/2019,159,436,595,1,4,2019
16,4/1/2019,139,163,302,1,4,2019
17,4/1/2019,145,143,288,1,4,2019
18,4/1/2019,77,295,372,1,4,2019
19,4/1/2019,28,191,219,1,4,2019
20,4/1/2019,33,377,410,1,4,2019
21,4/1/2019,89,296,385,1,4,2019
22,4/1/2019,148,231,379,1,4,2019
23,4/1/2019,114,249,363,1,4,2019
0,4/2/2019,37,228,265,2,4,2019
1,4/2/2019,31,251,282,2,4,2019
2,4/2/2019,23,0,23,2,4,2019
3,4/2/2019,59,1,60,2,4,2019
4,4/2/2019,17,0,17,2,4,2019
5,4/2/2019,42,0,42,2,4,2019
6,4/2/2019,154,0,154,2,4,2019
7,4/2/2019,225,81,306,2,4,2019
8,4/2/2019,290,238,528,2,4,2019
9,4/2/2019,144,326,470,2,4,2019
10,4/2/2019,99,379,478,2,4,2019
11,4/2/2019,97,103,200,2,4,2019
12,4/2/2019,123,132,255,2,4,2019
13,4/2/2019,82,235,317,2,4,2019
14,4/2/2019,104,198,302,2,4,2019
15,4/2/2019,101,432,533,2,4,2019
16,4/2/2019,84,31,115,2,4,2019
17,4/2/2019,65,164,229,2,4,2019
18,4/2/2019,42,223,265,2,4,2019
19,4/2/2019,22,290,312,2,4,2019
20,4/2/2019,38,149,187,2,4,2019
21,4/2/2019,102,178,280,2,4,2019
22,4/2/2019,155,186,341,2,4,2019
23,4/2/2019,194,208,402,2,4,2019
0,4/3/2019,76,162,238,3,4,2019
1,4/3/2019,18,183,201,3,4,2019
2,4/3/2019,27,3,30,3,4,2019
3,4/3/2019,30,21,51,3,4,2019
4,4/3/2019,25,0,25,3,4,2019
5,4/3/2019,64,0,64,3,4,2019
6,4/3/2019,134,0,134,3,4,2019
7,4/3/2019,249,5,254,3,4,2019
8,4/3/2019,248,234,482,3,4,2019
9,4/3/2019,180,320,500,3,4,2019
10,4/3/2019,118,265,383,3,4,2019
11,4/3/2019,129,110,239,3,4,2019
12,4/3/2019,98,149,247,3,4,2019
13,4/3/2019,48,197,245,3,4,2019
14,4/3/2019,82,202,284,3,4,2019
15,4/3/2019,94,310,404,3,4,2019
16,4/3/2019,105,141,246,3,4,2019
17,4/3/2019,78,102,180,3,4,2019
18,4/3/2019,76,282,358,3,4,2019
19,4/3/2019,22,186,208,3,4,2019
20,4/3/2019,46,205,251,3,4,2019
21,4/3/2019,130,189,319,3,4,2019
22,4/3/2019,220,72,292,3,4,2019
23,4/3/2019,180,155,335,3,4,2019
0,4/4/2019,69,307,376,4,4,2019
1,4/4/2019,50,118,168,4,4,2019
2,4/4/2019,54,0,54,4,4,2019
3,4/4/2019,64,0,64,4,4,2019
4,4/4/2019,49,0,49,4,4,2019
5,4/4/2019,57,1,58,4,4,2019
6,4/4/2019,169,0,169,4,4,2019
7,4/4/2019,280,55,335,4,4,2019
8,4/4/2019,343,220,563,4,4,2019
9,4/4/2019,130,411,541,4,4,2019
10,4/4/2019,97,298,395,4,4,2019
11,4/4/2019,243,124,367,4,4,2019
12,4/4/2019,236,186,422,4,4,2019
13,4/4/2019,115,242,357,4,4,2019
14,4/4/2019,115,94,209,4,4,2019
15,4/4/2019,124,231,355,4,4,2019
16,4/4/2019,124,177,301,4,4,2019
17,4/4/2019,154,85,239,4,4,2019
18,4/4/2019,149,324,473,4,4,2019
19,4/4/2019,24,251,275,4,4,2019
20,4/4/2019,49,141,190,4,4,2019
21,4/4/2019,191,205,396,4,4,2019
22,4/4/2019,233,79,312,4,4,2019
23,4/4/2019,302,211,513,4,4,2019
0,4/5/2019,223,161,384,5,4,2019
1,4/5/2019,77,271,348,5,4,2019
2,4/5/2019,33,27,60,5,4,2019
3,4/5/2019,63,0,63,5,4,2019
4,4/5/2019,60,0,60,5,4,2019
5,4/5/2019,97,0,97,5,4,2019
6,4/5/2019,238,0,238,5,4,2019
7,4/5/2019,361,123,484,5,4,2019
8,4/5/2019,330,205,535,5,4,2019
9,4/5/2019,187,323,510,5,4,2019
10,4/5/2019,127,341,468,5,4,2019
11,4/5/2019,117,172,289,5,4,2019
12,4/5/2019,181,68,249,5,4,2019
13,4/5/2019,105,198,303,5,4,2019
14,4/5/2019,99,115,214,5,4,2019
15,4/5/2019,112,213,325,5,4,2019
16,4/5/2019,81,327,408,5,4,2019
17,4/5/2019,118,159,277,5,4,2019
18,4/5/2019,130,181,311,5,4,2019
19,4/5/2019,48,256,304,5,4,2019
20,4/5/2019,93,123,216,5,4,2019
21,4/5/2019,201,211,412,5,4,2019
22,4/5/2019,191,149,340,5,4,2019
23,4/5/2019,236,222,458,5,4,2019
0,4/6/2019,132,118,250,6,4,2019
1,4/6/2019,65,126,191,6,4,2019
2,4/6/2019,64,150,214,6,4,2019
3,4/6/2019,71,8,79,6,4,2019
4,4/6/2019,18,0,18,6,4,2019
5,4/6/2019,66,0,66,6,4,2019
6,4/6/2019,192,0,192,6,4,2019
7,4/6/2019,305,0,305,6,4,2019
8,4/6/2019,445,185,630,6,4,2019
9,4/6/2019,213,449,662,6,4,2019
10,4/6/2019,130,540,670,6,4,2019
11,4/6/2019,123,88,211,6,4,2019
12,4/6/2019,167,182,349,6,4,2019
13,4/6/2019,71,220,291,6,4,2019
14,4/6/2019,88,269,357,6,4,2019
15,4/6/2019,86,270,356,6,4,2019
16,4/6/2019,133,284,417,6,4,2019
17,4/6/2019,89,136,225,6,4,2019
18,4/6/2019,65,311,376,6,4,2019
19,4/6/2019,27,405,432,6,4,2019
20,4/6/2019,56,133,189,6,4,2019
21,4/6/2019,130,300,430,6,4,2019
22,4/6/2019,218,203,421,6,4,2019
23,4/6/2019,116,301,417,6,4,2019
0,4/7/2019,77,223,300,7,4,2019
1,4/7/2019,33,134,167,7,4,2019
2,4/7/2019,42,62,104,7,4,2019
3,4/7/2019,73,1,74,7,4,2019
4,4/7/2019,59,0,59,7,4,2019
5,4/7/2019,142,0,142,7,4,2019
6,4/7/2019,253,51,304,7,4,2019
7,4/7/2019,192,217,409,7,4,2019
8,4/7/2019,183,535,718,7,4,2019
9,4/7/2019,151,417,568,7,4,2019
10,4/7/2019,120,79,199,7,4,2019
11,4/7/2019,128,203,331,7,4,2019
12,4/7/2019,187,272,459,7,4,2019
13,4/7/2019,151,339,490,7,4,2019
14,4/7/2019,128,343,471,7,4,2019
15,4/7/2019,132,451,583,7,4,2019
16,4/7/2019,123,177,300,7,4,2019
17,4/7/2019,133,167,300,7,4,2019
18,4/7/2019,36,375,411,7,4,2019
19,4/7/2019,37,378,415,7,4,2019
20,4/7/2019,96,142,238,7,4,2019
21,4/7/2019,150,127,277,7,4,2019
22,4/7/2019,159,269,428,7,4,2019
23,4/7/2019,102,325,427,7,4,2019
0,4/8/2019,63,314,377,1,4,2019
1,4/8/2019,29,282,311,1,4,2019
2,4/8/2019,9,118,127,1,4,2019
3,4/8/2019,33,6,39,1,4,2019
4,4/8/2019,20,0,20,1,4,2019
5,4/8/2019,88,0,88,1,4,2019
6,4/8/2019,195,94,289,1,4,2019
7,4/8/2019,163,76,239,1,4,2019
8,4/8/2019,166,480,646,1,4,2019
9,4/8/2019,104,345,449,1,4,2019
10,4/8/2019,107,195,302,1,4,2019
11,4/8/2019,66,206,272,1,4,2019
12,4/8/2019,68,151,219,1,4,2019
13,4/8/2019,131,68,199,1,4,2019
14,4/8/2019,137,245,382,1,4,2019
15,4/8/2019,143,245,388,1,4,2019
16,4/8/2019,152,258,410,1,4,2019
17,4/8/2019,85,381,466,1,4,2019
18,4/8/2019,20,214,234,1,4,2019
19,4/8/2019,26,239,265,1,4,2019
20,4/8/2019,63,218,281,1,4,2019
21,4/8/2019,91,144,235,1,4,2019
22,4/8/2019,121,96,217,1,4,2019
23,4/8/2019,48,136,184,1,4,2019
0,4/9/2019,26,345,371,2,4,2019
1,4/9/2019,30,77,107,2,4,2019
2,4/9/2019,40,0,40,2,4,2019
3,4/9/2019,37,0,37,2,4,2019
4,4/9/2019,44,1,45,2,4,2019
5,4/9/2019,85,0,85,2,4,2019
6,4/9/2019,168,55,223,2,4,2019
7,4/9/2019,175,187,362,2,4,2019
8,4/9/2019,173,259,432,2,4,2019
9,4/9/2019,84,399,483,2,4,2019
10,4/9/2019,103,113,216,2,4,2019
11,4/9/2019,95,151,246,2,4,2019
12,4/9/2019,72,166,238,2,4,2019
13,4/9/2019,124,189,313,2,4,2019
14,4/9/2019,103,103,206,2,4,2019
15,4/9/2019,105,336,441,2,4,2019
16,4/9/2019,68,108,176,2,4,2019
17,4/9/2019,57,392,449,2,4,2019
18,4/9/2019,22,65,87,2,4,2019
19,4/9/2019,29,205,234,2,4,2019
20,4/9/2019,80,28,108,2,4,2019
21,4/9/2019,163,227,390,2,4,2019
22,4/9/2019,129,214,343,2,4,2019
23,4/9/2019,70,244,314,2,4,2019
0,4/10/2019,52,131,183,3,4,2019
1,4/10/2019,11,103,114,3,4,2019
2,4/10/2019,19,1,20,3,4,2019
3,4/10/2019,52,1,53,3,4,2019
4,4/10/2019,29,0,29,3,4,2019
5,4/10/2019,146,0,146,3,4,2019
6,4/10/2019,274,0,274,3,4,2019
7,4/10/2019,125,116,241,3,4,2019
8,4/10/2019,126,329,455,3,4,2019
9,4/10/2019,107,397,504,3,4,2019
10,4/10/2019,134,106,240,3,4,2019
11,4/10/2019,78,178,256,3,4,2019
12,4/10/2019,93,290,383,3,4,2019
13,4/10/2019,131,66,197,3,4,2019
14,4/10/2019,121,165,286,3,4,2019
15,4/10/2019,100,310,410,3,4,2019
16,4/10/2019,112,51,163,3,4,2019
17,4/10/2019,59,285,344,3,4,2019
18,4/10/2019,35,151,186,3,4,2019
19,4/10/2019,33,272,305,3,4,2019
20,4/10/2019,100,62,162,3,4,2019
21,4/10/2019,206,213,419,3,4,2019
22,4/10/2019,205,94,299,3,4,2019
23,4/10/2019,163,229,392,3,4,2019
0,4/11/2019,106,200,306,4,4,2019
1,4/11/2019,55,63,118,4,4,2019
2,4/11/2019,45,0,45,4,4,2019
3,4/11/2019,72,0,72,4,4,2019
4,4/11/2019,63,1,64,4,4,2019
5,4/11/2019,159,0,159,4,4,2019
6,4/11/2019,294,101,395,4,4,2019
7,4/11/2019,301,70,371,4,4,2019
8,4/11/2019,215,489,704,4,4,2019
9,4/11/2019,140,396,536,4,4,2019
10,4/11/2019,195,237,432,4,4,2019
11,4/11/2019,106,173,279,4,4,2019
12,4/11/2019,130,312,442,4,4,2019
13,4/11/2019,140,193,333,4,4,2019
14,4/11/2019,203,198,401,4,4,2019
15,4/11/2019,137,215,352,4,4,2019
16,4/11/2019,143,201,344,4,4,2019
17,4/11/2019,107,386,493,4,4,2019
18,4/11/2019,80,191,271,4,4,2019
19,4/11/2019,31,304,335,4,4,2019
20,4/11/2019,106,254,360,4,4,2019
21,4/11/2019,284,179,463,4,4,2019
22,4/11/2019,327,173,500,4,4,2019
23,4/11/2019,237,223,460,4,4,2019
0,4/12/2019,197,261,458,5,4,2019
1,4/12/2019,52,407,459,5,4,2019
2,4/12/2019,40,29,69,5,4,2019
3,4/12/2019,91,0,91,5,4,2019
4,4/12/2019,83,0,83,5,4,2019
5,4/12/2019,244,0,244,5,4,2019
6,4/12/2019,357,0,357,5,4,2019
7,4/12/2019,271,189,460,5,4,2019
8,4/12/2019,134,460,594,5,4,2019
9,4/12/2019,151,394,545,5,4,2019
10,4/12/2019,182,161,343,5,4,2019
11,4/12/2019,93,217,310,5,4,2019
12,4/12/2019,130,431,561,5,4,2019
13,4/12/2019,111,242,353,5,4,2019
14,4/12/2019,129,239,368,5,4,2019
15,4/12/2019,114,247,361,5,4,2019
16,4/12/2019,125,204,329,5,4,2019
17,4/12/2019,100,368,468,5,4,2019
18,4/12/2019,42,376,418,5,4,2019
19,4/12/2019,87,400,487,5,4,2019
20,4/12/2019,105,280,385,5,4,2019
21,4/12/2019,260,396,656,5,4,2019
22,4/12/2019,246,166,412,5,4,2019
23,4/12/2019,228,295,523,5,4,2019
0,4/13/2019,224,186,410,6,4,2019
1,4/13/2019,57,368,425,6,4,2019
2,4/13/2019,42,20,62,6,4,2019
3,4/13/2019,74,10,84,6,4,2019
4,4/13/2019,150,1,151,6,4,2019
5,4/13/2019,211,0,211,6,4,2019
6,4/13/2019,336,89,425,6,4,2019
7,4/13/2019,270,271,541,6,4,2019
8,4/13/2019,218,597,815,6,4,2019
9,4/13/2019,177,596,773,6,4,2019
10,4/13/2019,124,434,558,6,4,2019
11,4/13/2019,38,344,382,6,4,2019
12,4/13/2019,77,239,316,6,4,2019
13,4/13/2019,121,135,256,6,4,2019
14,4/13/2019,87,369,456,6,4,2019
15,4/13/2019,118,622,740,6,4,2019
16,4/13/2019,82,206,288,6,4,2019
17,4/13/2019,75,560,635,6,4,2019
18,4/13/2019,36,325,361,6,4,2019
19,4/13/2019,35,459,494,6,4,2019
20,4/13/2019,88,169,257,6,4,2019
21,4/13/2019,217,366,583,6,4,2019
22,4/13/2019,182,423,605,6,4,2019
23,4/13/2019,122,290,412,6,4,2019
0,4/14/2019,78,335,413,7,4,2019
1,4/14/2019,22,40,62,7,4,2019
2,4/14/2019,46,0,46,7,4,2019
3,4/14/2019,58,32,90,7,4,2019
4,4/14/2019,56,0,56,7,4,2019
5,4/14/2019,132,0,132,7,4,2019
6,4/14/2019,164,113,277,7,4,2019
7,4/14/2019,210,392,602,7,4,2019
8,4/14/2019,108,630,738,7,4,2019
9,4/14/2019,116,367,483,7,4,2019
10,4/14/2019,194,128,322,7,4,2019
11,4/14/2019,133,219,352,7,4,2019
12,4/14/2019,88,424,512,7,4,2019
13,4/14/2019,117,475,592,7,4,2019
14,4/14/2019,104,337,441,7,4,2019
15,4/14/2019,62,432,494,7,4,2019
16,4/14/2019,80,93,173,7,4,2019
17,4/14/2019,119,274,393,7,4,2019
18,4/14/2019,33,357,390,7,4,2019
19,4/14/2019,22,242,264,7,4,2019
20,4/14/2019,57,315,372,7,4,2019
21,4/14/2019,150,220,370,7,4,2019
22,4/14/2019,172,166,338,7,4,2019
23,4/14/2019,110,375,485,7,4,2019
0,4/15/2019,46,322,368,1,4,2019
1,4/15/2019,21,83,104,1,4,2019
2,4/15/2019,30,67,97,1,4,2019
3,4/15/2019,21,8,29,1,4,2019
4,4/15/2019,55,0,55,1,4,2019
5,4/15/2019,164,0,164,1,4,2019
6,4/15/2019,183,0,183,1,4,2019
7,4/15/2019,197,37,234,1,4,2019
8,4/15/2019,120,608,728,1,4,2019
9,4/15/2019,92,658,750,1,4,2019
10,4/15/2019,102,366,468,1,4,2019
11,4/15/2019,68,383,451,1,4,2019
12,4/15/2019,110,209,319,1,4,2019
13,4/15/2019,90,158,248,1,4,2019
14,4/15/2019,107,285,392,1,4,2019
15,4/15/2019,122,289,411,1,4,2019
16,4/15/2019,141,166,307,1,4,2019
17,4/15/2019,102,290,392,1,4,2019
18,4/15/2019,26,236,262,1,4,2019
19,4/15/2019,32,291,323,1,4,2019
20,4/15/2019,91,107,198,1,4,2019
21,4/15/2019,155,291,446,1,4,2019
22,4/15/2019,171,276,447,1,4,2019
23,4/15/2019,74,285,359,1,4,2019
0,4/16/2019,37,229,266,2,4,2019
1,4/16/2019,28,65,93,2,4,2019
2,4/16/2019,31,8,39,2,4,2019
3,4/16/2019,44,0,44,2,4,2019
4,4/16/2019,71,1,72,2,4,2019
5,4/16/2019,92,0,92,2,4,2019
6,4/16/2019,184,145,329,2,4,2019
7,4/16/2019,150,210,360,2,4,2019
8,4/16/2019,117,557,674,2,4,2019
9,4/16/2019,99,465,564,2,4,2019
10,4/16/2019,82,239,321,2,4,2019
11,4/16/2019,76,212,288,2,4,2019
12,4/16/2019,133,321,454,2,4,2019
13,4/16/2019,127,75,202,2,4,2019
14,4/16/2019,104,334,438,2,4,2019
15,4/16/2019,131,250,381,2,4,2019
16,4/16/2019,97,138,235,2,4,2019
17,4/16/2019,66,459,525,2,4,2019
18,4/16/2019,32,262,294,2,4,2019
19,4/16/2019,24,109,133,2,4,2019
20,4/16/2019,67,134,201,2,4,2019
21,4/16/2019,201,481,682,2,4,2019
22,4/16/2019,262,249,511,2,4,2019
23,4/16/2019,162,158,320,2,4,2019
0,4/17/2019,58,229,287,3,4,2019
1,4/17/2019,32,60,92,3,4,2019
2,4/17/2019,18,0,18,3,4,2019
3,4/17/2019,61,3,64,3,4,2019
4,4/17/2019,56,0,56,3,4,2019
5,4/17/2019,140,0,140,3,4,2019
6,4/17/2019,268,0,268,3,4,2019
7,4/17/2019,236,248,484,3,4,2019
8,4/17/2019,134,455,589,3,4,2019
9,4/17/2019,112,459,571,3,4,2019
10,4/17/2019,137,134,271,3,4,2019
11,4/17/2019,78,413,491,3,4,2019
12,4/17/2019,82,255,337,3,4,2019
13,4/17/2019,130,199,329,3,4,2019
14,4/17/2019,163,188,351,3,4,2019
15,4/17/2019,102,274,376,3,4,2019
16,4/17/2019,116,254,370,3,4,2019
17,4/17/2019,84,253,337,3,4,2019
18,4/17/2019,29,240,269,3,4,2019
19,4/17/2019,46,262,308,3,4,2019
20,4/17/2019,107,165,272,3,4,2019
21,4/17/2019,251,299,550,3,4,2019
22,4/17/2019,243,184,427,3,4,2019
23,4/17/2019,199,462,661,3,4,2019
0,4/18/2019,126,281,407,4,4,2019
1,4/18/2019,51,22,73,4,4,2019
2,4/18/2019,62,0,62,4,4,2019
3,4/18/2019,78,0,78,4,4,2019
4,4/18/2019,64,0,64,4,4,2019
5,4/18/2019,199,0,199,4,4,2019
6,4/18/2019,349,79,428,4,4,2019
7,4/18/2019,382,140,522,4,4,2019
8,4/18/2019,156,663,819,4,4,2019
9,4/18/2019,58,590,648,4,4,2019
10,4/18/2019,136,188,324,4,4,2019
11,4/18/2019,111,355,466,4,4,2019
12,4/18/2019,162,220,382,4,4,2019
13,4/18/2019,179,72,251,4,4,2019
14,4/18/2019,148,254,402,4,4,2019
15,4/18/2019,167,269,436,4,4,2019
16,4/18/2019,155,93,248,4,4,2019
17,4/18/2019,164,274,438,4,4,2019
18,4/18/2019,92,280,372,4,4,2019
19,4/18/2019,58,258,316,4,4,2019
20,4/18/2019,93,115,208,4,4,2019
21,4/18/2019,274,173,447,4,4,2019
22,4/18/2019,344,229,573,4,4,2019
23,4/18/2019,247,250,497,4,4,2019
0,4/19/2019,194,172,366,5,4,2019
1,4/19/2019,85,81,166,5,4,2019
2,4/19/2019,36,25,61,5,4,2019
3,4/19/2019,47,0,47,5,4,2019
4,4/19/2019,127,0,127,5,4,2019
5,4/19/2019,218,0,218,5,4,2019
6,4/19/2019,409,0,409,5,4,2019
7,4/19/2019,274,223,497,5,4,2019
8,4/19/2019,195,489,684,5,4,2019
9,4/19/2019,188,317,505,5,4,2019
10,4/19/2019,208,146,354,5,4,2019
11,4/19/2019,121,298,419,5,4,2019
12,4/19/2019,193,134,327,5,4,2019
13,4/19/2019,196,157,353,5,4,2019
14,4/19/2019,173,215,388,5,4,2019
15,4/19/2019,172,320,492,5,4,2019
16,4/19/2019,246,86,332,5,4,2019
17,4/19/2019,196,145,341,5,4,2019
18,4/19/2019,87,251,338,5,4,2019
19,4/19/2019,125,114,239,5,4,2019
20,4/19/2019,164,58,222,5,4,2019
21,4/19/2019,338,239,577,5,4,2019
22,4/19/2019,299,173,472,5,4,2019
23,4/19/2019,286,211,497,5,4,2019
0,4/20/2019,153,86,239,6,4,2019
1,4/20/2019,53,14,67,6,4,2019
2,4/20/2019,56,6,62,6,4,2019
3,4/20/2019,71,1,72,6,4,2019
4,4/20/2019,96,0,96,6,4,2019
5,4/20/2019,175,0,175,6,4,2019
6,4/20/2019,324,80,404,6,4,2019
7,4/20/2019,352,253,605,6,4,2019
8,4/20/2019,200,427,627,6,4,2019
9,4/20/2019,262,264,526,6,4,2019
10,4/20/2019,305,127,432,6,4,2019
11,4/20/2019,112,302,414,6,4,2019
12,4/20/2019,175,174,349,6,4,2019
13,4/20/2019,261,71,332,6,4,2019
14,4/20/2019,249,284,533,6,4,2019
15,4/20/2019,333,212,545,6,4,2019
16,4/20/2019,346,253,599,6,4,2019
17,4/20/2019,230,259,489,6,4,2019
18,4/20/2019,54,125,179,6,4,2019
19,4/20/2019,86,262,348,6,4,2019
20,4/20/2019,202,65,267,6,4,2019
21,4/20/2019,316,233,549,6,4,2019
22,4/20/2019,226,151,377,6,4,2019
23,4/20/2019,183,182,365,6,4,2019
0,4/21/2019,108,112,220,7,4,2019
1,4/21/2019,27,25,52,7,4,2019
2,4/21/2019,58,0,58,7,4,2019
3,4/21/2019,93,0,93,7,4,2019
4,4/21/2019,104,0,104,7,4,2019
5,4/21/2019,176,0,176,7,4,2019
6,4/21/2019,313,70,383,7,4,2019
7,4/21/2019,353,275,628,7,4,2019
8,4/21/2019,140,629,769,7,4,2019
9,4/21/2019,220,243,463,7,4,2019
10,4/21/2019,319,46,365,7,4,2019
11,4/21/2019,214,292,506,7,4,2019
12,4/21/2019,205,202,407,7,4,2019
13,4/21/2019,265,142,407,7,4,2019
14,4/21/2019,283,365,648,7,4,2019
15,4/21/2019,211,270,481,7,4,2019
16,4/21/2019,336,90,426,7,4,2019
17,4/21/2019,304,136,440,7,4,2019
18,4/21/2019,79,183,262,7,4,2019
19,4/21/2019,97,234,331,7,4,2019
20,4/21/2019,165,86,251,7,4,2019
21,4/21/2019,276,199,475,7,4,2019
22,4/21/2019,328,216,544,7,4,2019
23,4/21/2019,243,243,486,7,4,2019
0,4/22/2019,116,156,272,1,4,2019
1,4/22/2019,46,39,85,1,4,2019
2,4/22/2019,21,16,37,1,4,2019
3,4/22/2019,61,0,61,1,4,2019
4,4/22/2019,67,0,67,1,4,2019
5,4/22/2019,164,0,164,1,4,2019
6,4/22/2019,331,61,392,1,4,2019
7,4/22/2019,354,264,618,1,4,2019
8,4/22/2019,153,497,650,1,4,2019
9,4/22/2019,153,248,401,1,4,2019
10,4/22/2019,263,158,421,1,4,2019
11,4/22/2019,176,285,461,1,4,2019
12,4/22/2019,152,165,317,1,4,2019
13,4/22/2019,206,108,314,1,4,2019
14,4/22/2019,323,144,467,1,4,2019
15,4/22/2019,251,333,584,1,4,2019
16,4/22/2019,371,263,634,1,4,2019
17,4/22/2019,158,262,420,1,4,2019
18,4/22/2019,81,156,237,1,4,2019
19,4/22/2019,94,208,302,1,4,2019
20,4/22/2019,146,111,257,1,4,2019
21,4/22/2019,223,162,385,1,4,2019
22,4/22/2019,237,193,430,1,4,2019
23,4/22/2019,166,329,495,1,4,2019
0,4/23/2019,91,213,304,2,4,2019
1,4/23/2019,31,62,93,2,4,2019
2,4/23/2019,26,47,73,2,4,2019
3,4/23/2019,72,27,99,2,4,2019
4,4/23/2019,77,1,78,2,4,2019
5,4/23/2019,181,0,181,2,4,2019
6,4/23/2019,341,73,414,2,4,2019
7,4/23/2019,248,173,421,2,4,2019
8,4/23/2019,184,498,682,2,4,2019
9,4/23/2019,154,355,509,2,4,2019
10,4/23/2019,225,148,373,2,4,2019
11,4/23/2019,128,194,322,2,4,2019
12,4/23/2019,194,287,481,2,4,2019
13,4/23/2019,277,109,386,2,4,2019
14,4/23/2019,203,204,407,2,4,2019
15,4/23/2019,202,293,495,2,4,2019
16,4/23/2019,162,199,361,2,4,2019
17,4/23/2019,112,313,425,2,4,2019
18,4/23/2019,68,139,207,2,4,2019
19,4/23/2019,39,167,206,2,4,2019
20,4/23/2019,91,62,153,2,4,2019
21,4/23/2019,225,292,517,2,4,2019
22,4/23/2019,277,189,466,2,4,2019
23,4/23/2019,220,124,344,2,4,2019
0,4/24/2019,112,164,276,3,4,2019
1,4/24/2019,20,109,129,3,4,2019
2,4/24/2019,16,0,16,3,4,2019
3,4/24/2019,49,0,49,3,4,2019
4,4/24/2019,84,0,84,3,4,2019
5,4/24/2019,182,0,182,3,4,2019
6,4/24/2019,319,0,319,3,4,2019
7,4/24/2019,218,0,218,3,4,2019
8,4/24/2019,173,0,173,3,4,2019
9,4/24/2019,166,448,614,3,4,2019
10,4/24/2019,215,285,500,3,4,2019
11,4/24/2019,121,363,484,3,4,2019
12,4/24/2019,174,455,629,3,4,2019
13,4/24/2019,199,87,286,3,4,2019
14,4/24/2019,197,93,290,3,4,2019
15,4/24/2019,237,119,356,3,4,2019
16,4/24/2019,212,82,294,3,4,2019
17,4/24/2019,173,419,592,3,4,2019
18,4/24/2019,49,189,238,3,4,2019
19,4/24/2019,23,188,211,3,4,2019
20,4/24/2019,109,90,199,3,4,2019
21,4/24/2019,244,139,383,3,4,2019
22,4/24/2019,352,180,532,3,4,2019
23,4/24/2019,238,252,490,3,4,2019
0,4/25/2019,179,78,257,4,4,2019
1,4/25/2019,51,36,87,4,4,2019
2,4/25/2019,57,36,93,4,4,2019
3,4/25/2019,71,0,71,4,4,2019
4,4/25/2019,82,0,82,4,4,2019
5,4/25/2019,239,0,239,4,4,2019
6,4/25/2019,474,56,530,4,4,2019
7,4/25/2019,356,156,512,4,4,2019
8,4/25/2019,261,517,778,4,4,2019
9,4/25/2019,168,365,533,4,4,2019
10,4/25/2019,207,56,263,4,4,2019
11,4/25/2019,151,170,321,4,4,2019
12,4/25/2019,154,176,330,4,4,2019
13,4/25/2019,204,63,267,4,4,2019
14,4/25/2019,244,226,470,4,4,2019
15,4/25/2019,219,304,523,4,4,2019
16,4/25/2019,231,162,393,4,4,2019
17,4/25/2019,193,209,402,4,4,2019
18,4/25/2019,87,207,294,4,4,2019
19,4/25/2019,21,137,158,4,4,2019
20,4/25/2019,89,100,189,4,4,2019
21,4/25/2019,270,169,439,4,4,2019
22,4/25/2019,345,129,474,4,4,2019
23,4/25/2019,340,130,470,4,4,2019
0,4/26/2019,253,83,336,5,4,2019
1,4/26/2019,133,67,200,5,4,2019
2,4/26/2019,42,1,43,5,4,2019
3,4/26/2019,88,0,88,5,4,2019
4,4/26/2019,89,0,89,5,4,2019
5,4/26/2019,258,0,258,5,4,2019
6,4/26/2019,446,42,488,5,4,2019
7,4/26/2019,379,245,624,5,4,2019
8,4/26/2019,256,319,575,5,4,2019
9,4/26/2019,181,285,466,5,4,2019
10,4/26/2019,248,178,426,5,4,2019
11,4/26/2019,186,75,261,5,4,2019
12,4/26/2019,179,161,340,5,4,2019
13,4/26/2019,221,95,316,5,4,2019
14,4/26/2019,209,173,382,5,4,2019
15,4/26/2019,209,266,475,5,4,2019
16,4/26/2019,216,112,328,5,4,2019
17,4/26/2019,172,146,318,5,4,2019
18,4/26/2019,71,141,212,5,4,2019
19,4/26/2019,54,146,200,5,4,2019
20,4/26/2019,147,65,212,5,4,2019
21,4/26/2019,287,183,470,5,4,2019
22,4/26/2019,312,132,444,5,4,2019
23,4/26/2019,329,167,496,5,4,2019
0,4/27/2019,194,75,269,6,4,2019
1,4/27/2019,39,57,96,6,4,2019
2,4/27/2019,62,28,90,6,4,2019
3,4/27/2019,74,5,79,6,4,2019
4,4/27/2019,45,0,45,6,4,2019
5,4/27/2019,216,2,218,6,4,2019
6,4/27/2019,406,47,453,6,4,2019
7,4/27/2019,330,245,575,6,4,2019
8,4/27/2019,310,487,797,6,4,2019
9,4/27/2019,199,399,598,6,4,2019
10,4/27/2019,252,99,351,6,4,2019
11,4/27/2019,98,270,368,6,4,2019
12,4/27/2019,171,129,300,6,4,2019
13,4/27/2019,264,103,367,6,4,2019
14,4/27/2019,219,170,389,6,4,2019
15,4/27/2019,305,231,536,6,4,2019
16,4/27/2019,237,247,484,6,4,2019
17,4/27/2019,158,326,484,6,4,2019
18,4/27/2019,65,83,148,6,4,2019
19,4/27/2019,58,214,272,6,4,2019
20,4/27/2019,157,94,251,6,4,2019
21,4/27/2019,269,144,413,6,4,2019
22,4/27/2019,237,197,434,6,4,2019
23,4/27/2019,208,201,409,6,4,2019
0,4/28/2019,165,152,317,7,4,2019
1,4/28/2019,47,20,67,7,4,2019
2,4/28/2019,47,0,47,7,4,2019
3,4/28/2019,92,0,92,7,4,2019
4,4/28/2019,92,0,92,7,4,2019
5,4/28/2019,179,0,179,7,4,2019
6,4/28/2019,387,69,456,7,4,2019
7,4/28/2019,329,369,698,7,4,2019
8,4/28/2019,118,493,611,7,4,2019
9,4/28/2019,191,233,424,7,4,2019
10,4/28/2019,335,134,469,7,4,2019
11,4/28/2019,177,285,462,7,4,2019
12,4/28/2019,201,181,382,7,4,2019
13,4/28/2019,215,247,462,7,4,2019
14,4/28/2019,216,319,535,7,4,2019
15,4/28/2019,210,324,534,7,4,2019
16,4/28/2019,245,152,397,7,4,2019
17,4/28/2019,208,301,509,7,4,2019
18,4/28/2019,64,243,307,7,4,2019
19,4/28/2019,54,212,266,7,4,2019
20,4/28/2019,95,111,206,7,4,2019
21,4/28/2019,200,137,337,7,4,2019
22,4/28/2019,242,328,570,7,4,2019
23,4/28/2019,153,312,465,7,4,2019
0,4/29/2019,87,297,384,1,4,2019
1,4/29/2019,76,5,81,1,4,2019
2,4/29/2019,36,6,42,1,4,2019
3,4/29/2019,47,1,48,1,4,2019
4,4/29/2019,56,2,58,1,4,2019
5,4/29/2019,118,2,120,1,4,2019
6,4/29/2019,237,71,308,1,4,2019
7,4/29/2019,265,311,576,1,4,2019
8,4/29/2019,101,433,534,1,4,2019
9,4/29/2019,104,284,388,1,4,2019
10,4/29/2019,135,177,312,1,4,2019
11,4/29/2019,117,196,313,1,4,2019
12,4/29/2019,108,157,265,1,4,2019
13,4/29/2019,182,166,348,1,4,2019
14,4/29/2019,209,248,457,1,4,2019
15,4/29/2019,172,355,527,1,4,2019
16,4/29/2019,155,265,420,1,4,2019
17,4/29/2019,79,232,311,1,4,2019
18,4/29/2019,25,215,240,1,4,2019
19,4/29/2019,54,184,238,1,4,2019
20,4/29/2019,82,106,188,1,4,2019
21,4/29/2019,213,314,527,1,4,2019
22,4/29/2019,175,208,383,1,4,2019
23,4/29/2019,131,328,459,1,4,2019
0,4/30/2019,64,245,309,2,4,2019
1,4/30/2019,44,3,47,2,4,2019
2,4/30/2019,34,0,34,2,4,2019
3,4/30/2019,42,0,42,2,4,2019
4,4/30/2019,59,1,60,2,4,2019
5,4/30/2019,116,0,116,2,4,2019
6,4/30/2019,263,56,319,2,4,2019
7,4/30/2019,240,204,444,2,4,2019
8,4/30/2019,115,218,333,2,4,2019
9,4/30/2019,92,314,406,2,4,2019
10,4/30/2019,175,121,296,2,4,2019
11,4/30/2019,161,272,433,2,4,2019
12,4/30/2019,152,132,284,2,4,2019
13,4/30/2019,110,171,281,2,4,2019
14,4/30/2019,141,178,319,2,4,2019
15,4/30/2019,89,205,294,2,4,2019
16,4/30/2019,109,108,217,2,4,2019
17,4/30/2019,49,332,381,2,4,2019
18,4/30/2019,31,193,224,2,4,2019
19,4/30/2019,42,154,196,2,4,2019
20,4/30/2019,82,106,188,2,4,2019
21,4/30/2019,209,274,483,2,4,2019
22,4/30/2019,197,298,495,2,4,2019
23,4/30/2019,183,94,277,2,4,2019
0,5/1/2019,93,134,227,3,5,2019
1,5/1/2019,23,70,93,3,5,2019
2,5/1/2019,26,29,55,3,5,2019
3,5/1/2019,80,15,95,3,5,2019
4,5/1/2019,94,0,94,3,5,2019
5,5/1/2019,178,0,178,3,5,2019
6,5/1/2019,257,32,289,3,5,2019
7,5/1/2019,135,164,299,3,5,2019
8,5/1/2019,130,524,654,3,5,2019
9,5/1/2019,139,278,417,3,5,2019
10,5/1/2019,189,66,255,3,5,2019
11,5/1/2019,112,273,385,3,5,2019
12,5/1/2019,121,244,365,3,5,2019
13,5/1/2019,148,61,209,3,5,2019
14,5/1/2019,245,180,425,3,5,2019
15,5/1/2019,152,257,409,3,5,2019
16,5/1/2019,159,99,258,3,5,2019
17,5/1/2019,115,293,408,3,5,2019
18,5/1/2019,37,196,233,3,5,2019
19,5/1/2019,26,128,154,3,5,2019
20,5/1/2019,106,75,181,3,5,2019
21,5/1/2019,233,132,365,3,5,2019
22,5/1/2019,306,121,427,3,5,2019
23,5/1/2019,206,211,417,3,5,2019
0,5/2/2019,149,196,345,4,5,2019
1,5/2/2019,38,1,39,4,5,2019
2,5/2/2019,34,0,34,4,5,2019
3,5/2/2019,108,0,108,4,5,2019
4,5/2/2019,113,0,113,4,5,2019
5,5/2/2019,173,0,173,4,5,2019
6,5/2/2019,399,52,451,4,5,2019
7,5/2/2019,392,178,570,4,5,2019
8,5/2/2019,222,402,624,4,5,2019
9,5/2/2019,126,252,378,4,5,2019
10,5/2/2019,254,75,329,4,5,2019
11,5/2/2019,204,205,409,4,5,2019
12,5/2/2019,160,148,308,4,5,2019
13,5/2/2019,243,125,368,4,5,2019
14,5/2/2019,123,136,259,4,5,2019
15,5/2/2019,184,234,418,4,5,2019
16,5/2/2019,187,119,306,4,5,2019
17,5/2/2019,212,269,481,4,5,2019
18,5/2/2019,74,152,226,4,5,2019
19,5/2/2019,58,139,197,4,5,2019
20,5/2/2019,117,166,283,4,5,2019
21,5/2/2019,286,95,381,4,5,2019
22,5/2/2019,347,192,539,4,5,2019
23,5/2/2019,267,148,415,4,5,2019
0,5/3/2019,213,234,447,5,5,2019
1,5/3/2019,102,52,154,5,5,2019
2,5/3/2019,27,0,27,5,5,2019
3,5/3/2019,67,0,67,5,5,2019
4,5/3/2019,115,0,115,5,5,2019
5,5/3/2019,206,0,206,5,5,2019
6,5/3/2019,400,84,484,5,5,2019
7,5/3/2019,309,130,439,5,5,2019
8,5/3/2019,251,426,677,5,5,2019
9,5/3/2019,117,328,445,5,5,2019
10,5/3/2019,202,150,352,5,5,2019
11,5/3/2019,99,215,314,5,5,2019
12,5/3/2019,121,125,246,5,5,2019
13,5/3/2019,152,106,258,5,5,2019
14,5/3/2019,124,191,315,5,5,2019
15,5/3/2019,94,226,320,5,5,2019
16,5/3/2019,138,86,224,5,5,2019
17,5/3/2019,102,226,328,5,5,2019
18,5/3/2019,46,193,239,5,5,2019
19,5/3/2019,21,205,226,5,5,2019
20,5/3/2019,97,108,205,5,5,2019
21,5/3/2019,302,239,541,5,5,2019
22,5/3/2019,360,118,478,5,5,2019
23,5/3/2019,315,210,525,5,5,2019
0,5/4/2019,165,69,234,6,5,2019
1,5/4/2019,50,28,78,6,5,2019
2,5/4/2019,51,0,51,6,5,2019
3,5/4/2019,54,1,55,6,5,2019
4,5/4/2019,93,0,93,6,5,2019
5,5/4/2019,157,0,157,6,5,2019
6,5/4/2019,306,0,306,6,5,2019
7,5/4/2019,402,185,587,6,5,2019
8,5/4/2019,253,507,760,6,5,2019
9,5/4/2019,152,333,485,6,5,2019
10,5/4/2019,138,279,417,6,5,2019
11,5/4/2019,83,160,243,6,5,2019
12,5/4/2019,109,231,340,6,5,2019
13,5/4/2019,96,51,147,6,5,2019
14,5/4/2019,99,269,368,6,5,2019
15,5/4/2019,166,268,434,6,5,2019
16,5/4/2019,208,50,258,6,5,2019
17,5/4/2019,91,327,418,6,5,2019
18,5/4/2019,32,209,241,6,5,2019
19,5/4/2019,20,330,350,6,5,2019
20,5/4/2019,83,27,110,6,5,2019
21,5/4/2019,180,186,366,6,5,2019
22,5/4/2019,262,171,433,6,5,2019
23,5/4/2019,172,184,356,6,5,2019
0,5/5/2019,82,181,263,7,5,2019
1,5/5/2019,19,11,30,7,5,2019
2,5/5/2019,21,35,56,7,5,2019
3,5/5/2019,57,0,57,7,5,2019
4,5/5/2019,83,0,83,7,5,2019
5,5/5/2019,184,0,184,7,5,2019
6,5/5/2019,262,26,288,7,5,2019
7,5/5/2019,248,282,530,7,5,2019
8,5/5/2019,131,550,681,7,5,2019
9,5/5/2019,159,341,500,7,5,2019
10,5/5/2019,158,63,221,7,5,2019
11,5/5/2019,165,296,461,7,5,2019
12,5/5/2019,194,109,303,7,5,2019
13,5/5/2019,212,219,431,7,5,2019
14,5/5/2019,132,258,390,7,5,2019
15,5/5/2019,164,328,492,7,5,2019
16,5/5/2019,177,183,360,7,5,2019
17,5/5/2019,121,187,308,7,5,2019
18,5/5/2019,61,286,347,7,5,2019
19,5/5/2019,57,94,151,7,5,2019
20,5/5/2019,125,167,292,7,5,2019
21,5/5/2019,205,296,501,7,5,2019
22,5/5/2019,227,206,433,7,5,2019
23,5/5/2019,158,280,438,7,5,2019
0,5/6/2019,107,331,438,1,5,2019
1,5/6/2019,30,131,161,1,5,2019
2,5/6/2019,22,0,22,1,5,2019
3,5/6/2019,41,6,47,1,5,2019
4,5/6/2019,42,0,42,1,5,2019
5,5/6/2019,98,0,98,1,5,2019
6,5/6/2019,259,76,335,1,5,2019
7,5/6/2019,248,256,504,1,5,2019
8,5/6/2019,160,410,570,1,5,2019
9,5/6/2019,109,282,391,1,5,2019
10,5/6/2019,115,192,307,1,5,2019
11,5/6/2019,82,191,273,1,5,2019
12,5/6/2019,106,112,218,1,5,2019
13,5/6/2019,131,78,209,1,5,2019
14,5/6/2019,222,157,379,1,5,2019
15,5/6/2019,224,346,570,1,5,2019
16,5/6/2019,211,142,353,1,5,2019
17,5/6/2019,99,294,393,1,5,2019
18,5/6/2019,34,441,475,1,5,2019
19,5/6/2019,18,220,238,1,5,2019
20,5/6/2019,96,158,254,1,5,2019
21,5/6/2019,162,158,320,1,5,2019
22,5/6/2019,261,184,445,1,5,2019
23,5/6/2019,129,220,349,1,5,2019
0,5/7/2019,69,202,271,2,5,2019
1,5/7/2019,13,69,82,2,5,2019
2,5/7/2019,42,30,72,2,5,2019
3,5/7/2019,62,0,62,2,5,2019
4,5/7/2019,67,0,67,2,5,2019
5,5/7/2019,152,0,152,2,5,2019
6,5/7/2019,285,72,357,2,5,2019
7,5/7/2019,236,115,351,2,5,2019
8,5/7/2019,178,327,505,2,5,2019
9,5/7/2019,84,272,356,2,5,2019
10,5/7/2019,142,187,329,2,5,2019
11,5/7/2019,115,185,300,2,5,2019
12,5/7/2019,179,120,299,2,5,2019
13,5/7/2019,178,193,371,2,5,2019
14,5/7/2019,143,200,343,2,5,2019
15,5/7/2019,120,283,403,2,5,2019
16,5/7/2019,161,61,222,2,5,2019
17,5/7/2019,59,339,398,2,5,2019
18,5/7/2019,10,172,182,2,5,2019
19,5/7/2019,31,211,242,2,5,2019
20,5/7/2019,140,91,231,2,5,2019
21,5/7/2019,222,292,514,2,5,2019
22,5/7/2019,300,161,461,2,5,2019
23,5/7/2019,148,148,296,2,5,2019
0,5/8/2019,95,140,235,3,5,2019
1,5/8/2019,24,1,25,3,5,2019
2,5/8/2019,28,32,60,3,5,2019
3,5/8/2019,74,10,84,3,5,2019
4,5/8/2019,72,0,72,3,5,2019
5,5/8/2019,180,0,180,3,5,2019
6,5/8/2019,274,11,285,3,5,2019
7,5/8/2019,267,165,432,3,5,2019
8,5/8/2019,233,288,521,3,5,2019
9,5/8/2019,172,160,332,3,5,2019
10,5/8/2019,177,105,282,3,5,2019
11,5/8/2019,94,167,261,3,5,2019
12,5/8/2019,170,151,321,3,5,2019
13,5/8/2019,194,101,295,3,5,2019
14,5/8/2019,202,180,382,3,5,2019
15,5/8/2019,141,332,473,3,5,2019
16,5/8/2019,137,129,266,3,5,2019
17,5/8/2019,87,189,276,3,5,2019
18,5/8/2019,12,214,226,3,5,2019
19,5/8/2019,49,126,175,3,5,2019
20,5/8/2019,76,111,187,3,5,2019
21,5/8/2019,229,100,329,3,5,2019
22,5/8/2019,373,144,517,3,5,2019
23,5/8/2019,286,105,391,3,5,2019
0,5/9/2019,113,222,335,4,5,2019
1,5/9/2019,29,49,78,4,5,2019
2,5/9/2019,91,0,91,4,5,2019
3,5/9/2019,128,0,128,4,5,2019
4,5/9/2019,151,1,152,4,5,2019
5,5/9/2019,229,0,229,4,5,2019
6,5/9/2019,351,63,414,4,5,2019
7,5/9/2019,448,231,679,4,5,2019
8,5/9/2019,355,311,666,4,5,2019
9,5/9/2019,139,304,443,4,5,2019
10,5/9/2019,212,48,260,4,5,2019
11,5/9/2019,166,201,367,4,5,2019
12,5/9/2019,142,128,270,4,5,2019
13,5/9/2019,166,105,271,4,5,2019
14,5/9/2019,182,192,374,4,5,2019
15,5/9/2019,195,238,433,4,5,2019
16,5/9/2019,215,31,246,4,5,2019
17,5/9/2019,190,253,443,4,5,2019
18,5/9/2019,64,231,295,4,5,2019
19,5/9/2019,40,138,178,4,5,2019
20,5/9/2019,149,150,299,4,5,2019
21,5/9/2019,282,75,357,4,5,2019
22,5/9/2019,381,142,523,4,5,2019
23,5/9/2019,308,108,416,4,5,2019
0,5/10/2019,271,156,427,5,5,2019
1,5/10/2019,83,98,181,5,5,2019
2,5/10/2019,37,34,71,5,5,2019
3,5/10/2019,71,1,72,5,5,2019
4,5/10/2019,82,6,88,5,5,2019
5,5/10/2019,168,2,170,5,5,2019
6,5/10/2019,353,75,428,5,5,2019
7,5/10/2019,330,200,530,5,5,2019
8,5/10/2019,229,365,594,5,5,2019
9,5/10/2019,156,365,521,5,5,2019
10,5/10/2019,177,52,229,5,5,2019
11,5/10/2019,102,298,400,5,5,2019
12,5/10/2019,115,70,185,5,5,2019
13,5/10/2019,130,68,198,5,5,2019
14,5/10/2019,103,195,298,5,5,2019
15,5/10/2019,83,232,315,5,5,2019
16,5/10/2019,161,216,377,5,5,2019
17,5/10/2019,91,175,266,5,5,2019
18,5/10/2019,44,218,262,5,5,2019
19,5/10/2019,31,103,134,5,5,2019
20,5/10/2019,104,186,290,5,5,2019
21,5/10/2019,226,241,467,5,5,2019
22,5/10/2019,288,107,395,5,5,2019
23,5/10/2019,209,196,405,5,5,2019
0,5/11/2019,141,51,192,6,5,2019
1,5/11/2019,50,27,77,6,5,2019
2,5/11/2019,45,1,46,6,5,2019
3,5/11/2019,57,20,77,6,5,2019
4,5/11/2019,55,9,64,6,5,2019
5,5/11/2019,143,0,143,6,5,2019
6,5/11/2019,247,20,267,6,5,2019
7,5/11/2019,403,270,673,6,5,2019
8,5/11/2019,210,487,697,6,5,2019
9,5/11/2019,115,403,518,6,5,2019
10,5/11/2019,112,122,234,6,5,2019
11,5/11/2019,46,204,250,6,5,2019
12,5/11/2019,109,180,289,6,5,2019
13,5/11/2019,103,62,165,6,5,2019
14,5/11/2019,118,222,340,6,5,2019
15,5/11/2019,107,445,552,6,5,2019
16,5/11/2019,75,132,207,6,5,2019
17,5/11/2019,76,412,488,6,5,2019
18,5/11/2019,25,161,186,6,5,2019
19,5/11/2019,28,314,342,6,5,2019
20,5/11/2019,102,225,327,6,5,2019
21,5/11/2019,149,200,349,6,5,2019
22,5/11/2019,161,229,390,6,5,2019
23,5/11/2019,115,265,380,6,5,2019
0,5/12/2019,64,209,273,7,5,2019
1,5/12/2019,15,54,69,7,5,2019
2,5/12/2019,24,0,24,7,5,2019
3,5/12/2019,88,0,88,7,5,2019
4,5/12/2019,107,0,107,7,5,2019
5,5/12/2019,197,0,197,7,5,2019
6,5/12/2019,260,106,366,7,5,2019
7,5/12/2019,206,371,577,7,5,2019
8,5/12/2019,119,539,658,7,5,2019
9,5/12/2019,103,323,426,7,5,2019
10,5/12/2019,145,47,192,7,5,2019
11,5/12/2019,135,332,467,7,5,2019
12,5/12/2019,156,265,421,7,5,2019
13,5/12/2019,198,217,415,7,5,2019
14,5/12/2019,134,398,532,7,5,2019
15,5/12/2019,133,380,513,7,5,2019
16,5/12/2019,126,162,288,7,5,2019
17,5/12/2019,84,251,335,7,5,2019
18,5/12/2019,75,274,349,7,5,2019
19,5/12/2019,41,234,275,7,5,2019
20,5/12/2019,101,173,274,7,5,2019
21,5/12/2019,139,71,210,7,5,2019
22,5/12/2019,212,427,639,7,5,2019
23,5/12/2019,173,239,412,7,5,2019
0,5/13/2019,63,409,472,1,5,2019
1,5/13/2019,25,46,71,1,5,2019
2,5/13/2019,11,13,24,1,5,2019
3,5/13/2019,43,0,43,1,5,2019
4,5/13/2019,25,0,25,1,5,2019
5,5/13/2019,125,0,125,1,5,2019
6,5/13/2019,213,113,326,1,5,2019
7,5/13/2019,194,214,408,1,5,2019
8,5/13/2019,152,526,678,1,5,2019
9,5/13/2019,83,335,418,1,5,2019
10,5/13/2019,94,151,245,1,5,2019
11,5/13/2019,56,169,225,1,5,2019
12,5/13/2019,97,160,257,1,5,2019
13,5/13/2019,152,89,241,1,5,2019
14,5/13/2019,156,192,348,1,5,2019
15,5/13/2019,156,173,329,1,5,2019
16,5/13/2019,167,178,345,1,5,2019
17,5/13/2019,84,285,369,1,5,2019
18,5/13/2019,20,346,366,1,5,2019
19,5/13/2019,36,114,150,1,5,2019
20,5/13/2019,108,164,272,1,5,2019
21,5/13/2019,154,233,387,1,5,2019
22,5/13/2019,148,215,363,1,5,2019
23,5/13/2019,84,213,297,1,5,2019
0,5/14/2019,33,258,291,2,5,2019
1,5/14/2019,11,169,180,2,5,2019
2,5/14/2019,37,32,69,2,5,2019
3,5/14/2019,64,0,64,2,5,2019
4,5/14/2019,69,0,69,2,5,2019
5,5/14/2019,122,0,122,2,5,2019
6,5/14/2019,226,51,277,2,5,2019
7,5/14/2019,193,200,393,2,5,2019
8,5/14/2019,164,397,561,2,5,2019
9,5/14/2019,85,346,431,2,5,2019
10,5/14/2019,131,82,213,2,5,2019
11,5/14/2019,84,217,301,2,5,2019
12,5/14/2019,101,188,289,2,5,2019
13,5/14/2019,109,176,285,2,5,2019
14,5/14/2019,85,332,417,2,5,2019
15,5/14/2019,87,242,329,2,5,2019
16,5/14/2019,66,137,203,2,5,2019
17,5/14/2019,34,309,343,2,5,2019
18,5/14/2019,20,258,278,2,5,2019
19,5/14/2019,29,171,200,2,5,2019
20,5/14/2019,57,49,106,2,5,2019
21,5/14/2019,184,243,427,2,5,2019
22,5/14/2019,165,342,507,2,5,2019
23,5/14/2019,110,155,265,2,5,2019
0,5/15/2019,60,196,256,3,5,2019
1,5/15/2019,6,0,6,3,5,2019
2,5/15/2019,33,3,36,3,5,2019
3,5/15/2019,31,10,41,3,5,2019
4,5/15/2019,41,0,41,3,5,2019
5,5/15/2019,126,0,126,3,5,2019
6,5/15/2019,204,1,205,3,5,2019
7,5/15/2019,231,212,443,3,5,2019
8,5/15/2019,122,386,508,3,5,2019
9,5/15/2019,97,347,444,3,5,2019
10,5/15/2019,129,161,290,3,5,2019
11,5/15/2019,57,213,270,3,5,2019
12,5/15/2019,76,183,259,3,5,2019
13,5/15/2019,136,82,218,3,5,2019
14,5/15/2019,140,203,343,3,5,2019
15,5/15/2019,127,277,404,3,5,2019
16,5/15/2019,133,197,330,3,5,2019
17,5/15/2019,79,158,237,3,5,2019
18,5/15/2019,15,113,128,3,5,2019
19,5/15/2019,15,173,188,3,5,2019
20,5/15/2019,96,93,189,3,5,2019
21,5/15/2019,191,140,331,3,5,2019
22,5/15/2019,311,184,495,3,5,2019
23,5/15/2019,198,301,499,3,5,2019
0,5/16/2019,67,161,228,4,5,2019
1,5/16/2019,36,14,50,4,5,2019
2,5/16/2019,17,0,17,4,5,2019
3,5/16/2019,115,0,115,4,5,2019
4,5/16/2019,97,0,97,4,5,2019
5,5/16/2019,190,0,190,4,5,2019
6,5/16/2019,309,63,372,4,5,2019
7,5/16/2019,308,154,462,4,5,2019
8,5/16/2019,236,419,655,4,5,2019
9,5/16/2019,95,344,439,4,5,2019
10,5/16/2019,168,108,276,4,5,2019
11,5/16/2019,146,177,323,4,5,2019
12,5/16/2019,173,238,411,4,5,2019
13,5/16/2019,170,188,358,4,5,2019
14,5/16/2019,126,175,301,4,5,2019
15,5/16/2019,202,245,447,4,5,2019
16,5/16/2019,173,151,324,4,5,2019
17,5/16/2019,141,334,475,4,5,2019
18,5/16/2019,64,204,268,4,5,2019
19,5/16/2019,24,138,162,4,5,2019
20,5/16/2019,146,42,188,4,5,2019
21,5/16/2019,237,211,448,4,5,2019
22,5/16/2019,300,216,516,4,5,2019
23,5/16/2019,247,184,431,4,5,2019
0,5/17/2019,163,214,377,5,5,2019
1,5/17/2019,20,54,74,5,5,2019
2,5/17/2019,37,3,40,5,5,2019
3,5/17/2019,71,0,71,5,5,2019
4,5/17/2019,51,0,51,5,5,2019
5,5/17/2019,217,0,217,5,5,2019
6,5/17/2019,322,90,412,5,5,2019
7,5/17/2019,263,108,371,5,5,2019
8,5/17/2019,247,465,712,5,5,2019
9,5/17/2019,148,433,581,5,5,2019
10,5/17/2019,130,136,266,5,5,2019
11,5/17/2019,74,218,292,5,5,2019
12,5/17/2019,105,97,202,5,5,2019
13,5/17/2019,137,72,209,5,5,2019
14,5/17/2019,106,392,498,5,5,2019
15,5/17/2019,117,158,275,5,5,2019
16,5/17/2019,141,160,301,5,5,2019
17,5/17/2019,74,173,247,5,5,2019
18,5/17/2019,33,332,365,5,5,2019
19,5/17/2019,33,196,229,5,5,2019
20,5/17/2019,82,140,222,5,5,2019
21,5/17/2019,255,166,421,5,5,2019
22,5/17/2019,264,112,376,5,5,2019
23,5/17/2019,211,231,442,5,5,2019
0,5/18/2019,139,117,256,6,5,2019
1,5/18/2019,45,71,116,6,5,2019
2,5/18/2019,15,54,69,6,5,2019
3,5/18/2019,67,1,68,6,5,2019
4,5/18/2019,40,0,40,6,5,2019
5,5/18/2019,152,0,152,6,5,2019
6,5/18/2019,303,1,304,6,5,2019
7,5/18/2019,346,174,520,6,5,2019
8,5/18/2019,232,501,733,6,5,2019
9,5/18/2019,124,475,599,6,5,2019
10,5/18/2019,134,225,359,6,5,2019
11,5/18/2019,105,230,335,6,5,2019
12,5/18/2019,126,177,303,6,5,2019
13,5/18/2019,125,188,313,6,5,2019
14,5/18/2019,116,261,377,6,5,2019
15,5/18/2019,179,319,498,6,5,2019
16,5/18/2019,110,195,305,6,5,2019
17,5/18/2019,62,281,343,6,5,2019
18,5/18/2019,20,80,100,6,5,2019
19,5/18/2019,22,330,352,6,5,2019
20,5/18/2019,71,70,141,6,5,2019
21,5/18/2019,152,198,350,6,5,2019
22,5/18/2019,135,266,401,6,5,2019
23,5/18/2019,81,161,242,6,5,2019
0,5/19/2019,38,187,225,7,5,2019
1,5/19/2019,14,11,25,7,5,2019
2,5/19/2019,42,0,42,7,5,2019
3,5/19/2019,78,0,78,7,5,2019
4,5/19/2019,83,0,83,7,5,2019
5,5/19/2019,174,0,174,7,5,2019
6,5/19/2019,293,104,397,7,5,2019
7,5/19/2019,250,289,539,7,5,2019
8,5/19/2019,146,586,732,7,5,2019
9,5/19/2019,125,132,257,7,5,2019
10,5/19/2019,171,126,297,7,5,2019
11,5/19/2019,117,211,328,7,5,2019
12,5/19/2019,138,378,516,7,5,2019
13,5/19/2019,180,132,312,7,5,2019
14,5/19/2019,156,342,498,7,5,2019
15,5/19/2019,176,347,523,7,5,2019
16,5/19/2019,198,149,347,7,5,2019
17,5/19/2019,153,361,514,7,5,2019
18,5/19/2019,62,274,336,7,5,2019
19,5/19/2019,39,217,256,7,5,2019
20,5/19/2019,72,228,300,7,5,2019
21,5/19/2019,187,97,284,7,5,2019
22,5/19/2019,175,253,428,7,5,2019
23,5/19/2019,124,267,391,7,5,2019
0,5/20/2019,71,109,180,1,5,2019
1,5/20/2019,34,196,230,1,5,2019
2,5/20/2019,16,0,16,1,5,2019
3,5/20/2019,43,11,54,1,5,2019
4,5/20/2019,38,0,38,1,5,2019
5,5/20/2019,103,0,103,1,5,2019
6,5/20/2019,218,76,294,1,5,2019
7,5/20/2019,218,138,356,1,5,2019
8,5/20/2019,180,276,456,1,5,2019
9,5/20/2019,68,418,486,1,5,2019
10,5/20/2019,121,214,335,1,5,2019
11,5/20/2019,47,191,238,1,5,2019
12,5/20/2019,91,114,205,1,5,2019
13,5/20/2019,113,109,222,1,5,2019
14,5/20/2019,135,188,323,1,5,2019
15,5/20/2019,183,296,479,1,5,2019
16,5/20/2019,149,75,224,1,5,2019
17,5/20/2019,57,506,563,1,5,2019
18,5/20/2019,12,199,211,1,5,2019
19,5/20/2019,28,219,247,1,5,2019
20,5/20/2019,55,17,72,1,5,2019
21,5/20/2019,162,222,384,1,5,2019
22,5/20/2019,154,146,300,1,5,2019
23,5/20/2019,62,480,542,1,5,2019
0,5/21/2019,32,237,269,2,5,2019
1,5/21/2019,20,40,60,2,5,2019
2,5/21/2019,14,51,65,2,5,2019
3,5/21/2019,65,0,65,2,5,2019
4,5/21/2019,70,0,70,2,5,2019
5,5/21/2019,110,1,111,2,5,2019
6,5/21/2019,259,78,337,2,5,2019
7,5/21/2019,246,148,394,2,5,2019
8,5/21/2019,174,296,470,2,5,2019
9,5/21/2019,129,355,484,2,5,2019
10,5/21/2019,97,157,254,2,5,2019
11,5/21/2019,114,181,295,2,5,2019
12,5/21/2019,195,190,385,2,5,2019
13,5/21/2019,141,144,285,2,5,2019
14,5/21/2019,105,144,249,2,5,2019
15,5/21/2019,141,236,377,2,5,2019
16,5/21/2019,147,210,357,2,5,2019
17,5/21/2019,56,342,398,2,5,2019
18,5/21/2019,21,181,202,2,5,2019
19,5/21/2019,24,73,97,2,5,2019
20,5/21/2019,84,162,246,2,5,2019
21,5/21/2019,214,203,417,2,5,2019
22,5/21/2019,247,204,451,2,5,2019
23,5/21/2019,135,166,301,2,5,2019
0,5/22/2019,73,84,157,3,5,2019
1,5/22/2019,11,3,14,3,5,2019
2,5/22/2019,19,6,25,3,5,2019
3,5/22/2019,28,2,30,3,5,2019
4,5/22/2019,81,46,127,3,5,2019
5,5/22/2019,168,0,168,3,5,2019
6,5/22/2019,221,4,225,3,5,2019
7,5/22/2019,257,209,466,3,5,2019
8,5/22/2019,204,303,507,3,5,2019
9,5/22/2019,163,333,496,3,5,2019
10,5/22/2019,160,116,276,3,5,2019
11,5/22/2019,93,222,315,3,5,2019
12,5/22/2019,126,148,274,3,5,2019
13,5/22/2019,135,79,214,3,5,2019
14,5/22/2019,131,260,391,3,5,2019
15,5/22/2019,169,167,336,3,5,2019
16,5/22/2019,137,203,340,3,5,2019
17,5/22/2019,119,264,383,3,5,2019
18,5/22/2019,33,188,221,3,5,2019
19,5/22/2019,21,134,155,3,5,2019
20,5/22/2019,96,84,180,3,5,2019
21,5/22/2019,298,235,533,3,5,2019
22,5/22/2019,374,201,575,3,5,2019
23,5/22/2019,321,172,493,3,5,2019
0,5/23/2019,149,156,305,4,5,2019
1,5/23/2019,24,1,25,4,5,2019
2,5/23/2019,60,0,60,4,5,2019
3,5/23/2019,121,0,121,4,5,2019
4,5/23/2019,125,0,125,4,5,2019
5,5/23/2019,304,3,307,4,5,2019
6,5/23/2019,467,63,530,4,5,2019
7,5/23/2019,401,202,603,4,5,2019
8,5/23/2019,349,381,730,4,5,2019
9,5/23/2019,151,376,527,4,5,2019
10,5/23/2019,321,69,390,4,5,2019
11,5/23/2019,176,169,345,4,5,2019
12,5/23/2019,203,275,478,4,5,2019
13,5/23/2019,178,93,271,4,5,2019
14,5/23/2019,205,187,392,4,5,2019
15,5/23/2019,244,255,499,4,5,2019
16,5/23/2019,290,31,321,4,5,2019
17,5/23/2019,234,284,518,4,5,2019
18,5/23/2019,62,177,239,4,5,2019
19,5/23/2019,41,149,190,4,5,2019
20,5/23/2019,168,167,335,4,5,2019
21,5/23/2019,424,140,564,4,5,2019
22,5/23/2019,420,130,550,4,5,2019
23,5/23/2019,335,228,563,4,5,2019
0,5/24/2019,345,192,537,5,5,2019
1,5/24/2019,101,3,104,5,5,2019
2,5/24/2019,55,0,55,5,5,2019
3,5/24/2019,139,2,141,5,5,2019
4,5/24/2019,141,0,141,5,5,2019
5,5/24/2019,321,0,321,5,5,2019
6,5/24/2019,474,75,549,5,5,2019
7,5/24/2019,472,187,659,5,5,2019
8,5/24/2019,375,368,743,5,5,2019
9,5/24/2019,276,336,612,5,5,2019
10,5/24/2019,241,127,368,5,5,2019
11,5/24/2019,141,44,185,5,5,2019
12,5/24/2019,239,211,450,5,5,2019
13,5/24/2019,207,155,362,5,5,2019
14,5/24/2019,232,317,549,5,5,2019
15,5/24/2019,242,177,419,5,5,2019
16,5/24/2019,276,97,373,5,5,2019
17,5/24/2019,136,145,281,5,5,2019
18,5/24/2019,67,210,277,5,5,2019
19,5/24/2019,64,165,229,5,5,2019
20,5/24/2019,156,102,258,5,5,2019
21,5/24/2019,285,193,478,5,5,2019
22,5/24/2019,374,125,499,5,5,2019
23,5/24/2019,285,190,475,5,5,2019
0,5/25/2019,357,112,469,6,5,2019
1,5/25/2019,82,60,142,6,5,2019
2,5/25/2019,77,8,85,6,5,2019
3,5/25/2019,68,2,70,6,5,2019
4,5/25/2019,67,0,67,6,5,2019
5,5/25/2019,245,2,247,6,5,2019
6,5/25/2019,424,1,425,6,5,2019
7,5/25/2019,575,213,788,6,5,2019
8,5/25/2019,335,410,745,6,5,2019
9,5/25/2019,224,285,509,6,5,2019
10,5/25/2019,289,127,416,6,5,2019
11,5/25/2019,114,344,458,6,5,2019
12,5/25/2019,165,73,238,6,5,2019
13,5/25/2019,229,99,328,6,5,2019
14,5/25/2019,170,232,402,6,5,2019
15,5/25/2019,222,317,539,6,5,2019
16,5/25/2019,185,261,446,6,5,2019
17,5/25/2019,101,260,361,6,5,2019
18,5/25/2019,60,137,197,6,5,2019
19,5/25/2019,47,219,266,6,5,2019
20,5/25/2019,131,89,220,6,5,2019
21,5/25/2019,220,256,476,6,5,2019
22,5/25/2019,243,87,330,6,5,2019
23,5/25/2019,209,167,376,6,5,2019
0,5/26/2019,117,199,316,7,5,2019
1,5/26/2019,42,4,46,7,5,2019
2,5/26/2019,33,1,34,7,5,2019
3,5/26/2019,134,0,134,7,5,2019
4,5/26/2019,106,0,106,7,5,2019
5,5/26/2019,199,0,199,7,5,2019
6,5/26/2019,295,28,323,7,5,2019
7,5/26/2019,264,242,506,7,5,2019
8,5/26/2019,184,376,560,7,5,2019
9,5/26/2019,116,337,453,7,5,2019
10,5/26/2019,160,60,220,7,5,2019
11,5/26/2019,169,234,403,7,5,2019
12,5/26/2019,183,159,342,7,5,2019
13,5/26/2019,151,150,301,7,5,2019
14,5/26/2019,154,266,420,7,5,2019
15,5/26/2019,148,390,538,7,5,2019
16,5/26/2019,167,84,251,7,5,2019
17,5/26/2019,183,217,400,7,5,2019
18,5/26/2019,43,249,292,7,5,2019
19,5/26/2019,39,228,267,7,5,2019
20,5/26/2019,113,67,180,7,5,2019
21,5/26/2019,193,277,470,7,5,2019
22,5/26/2019,232,222,454,7,5,2019
23,5/26/2019,152,207,359,7,5,2019
0,5/27/2019,112,342,454,1,5,2019
1,5/27/2019,42,62,104,1,5,2019
2,5/27/2019,18,2,20,1,5,2019
3,5/27/2019,45,9,54,1,5,2019
4,5/27/2019,37,0,37,1,5,2019
5,5/27/2019,117,0,117,1,5,2019
6,5/27/2019,254,109,363,1,5,2019
7,5/27/2019,275,282,557,1,5,2019
8,5/27/2019,155,589,744,1,5,2019
9,5/27/2019,178,448,626,1,5,2019
10,5/27/2019,142,263,405,1,5,2019
11,5/27/2019,75,337,412,1,5,2019
12,5/27/2019,134,112,246,1,5,2019
13,5/27/2019,150,325,475,1,5,2019
14,5/27/2019,156,303,459,1,5,2019
15,5/27/2019,201,519,720,1,5,2019
16,5/27/2019,224,201,425,1,5,2019
17,5/27/2019,115,531,646,1,5,2019
18,5/27/2019,16,589,605,1,5,2019
19,5/27/2019,33,273,306,1,5,2019
20,5/27/2019,109,225,334,1,5,2019
21,5/27/2019,177,353,530,1,5,2019
22,5/27/2019,206,383,589,1,5,2019
23,5/27/2019,45,691,736,1,5,2019
0,5/28/2019,34,398,432,2,5,2019
1,5/28/2019,19,13,32,2,5,2019
2,5/28/2019,39,1,40,2,5,2019
3,5/28/2019,85,10,95,2,5,2019
4,5/28/2019,63,0,63,2,5,2019
5,5/28/2019,165,0,165,2,5,2019
6,5/28/2019,209,138,347,2,5,2019
7,5/28/2019,248,361,609,2,5,2019
8,5/28/2019,184,386,570,2,5,2019
9,5/28/2019,112,351,463,2,5,2019
10,5/28/2019,170,133,303,2,5,2019
11,5/28/2019,97,216,313,2,5,2019
12,5/28/2019,124,359,483,2,5,2019
13,5/28/2019,151,172,323,2,5,2019
14,5/28/2019,100,290,390,2,5,2019
15,5/28/2019,108,224,332,2,5,2019
16,5/28/2019,114,302,416,2,5,2019
17,5/28/2019,52,428,480,2,5,2019
18,5/28/2019,26,321,347,2,5,2019
19,5/28/2019,28,161,189,2,5,2019
20,5/28/2019,78,186,264,2,5,2019
21,5/28/2019,230,383,613,2,5,2019
22,5/28/2019,212,167,379,2,5,2019
23,5/28/2019,94,322,416,2,5,2019
0,5/29/2019,77,202,279,3,5,2019
1,5/29/2019,20,16,36,3,5,2019
2,5/29/2019,31,5,36,3,5,2019
3,5/29/2019,52,4,56,3,5,2019
4,5/29/2019,74,0,74,3,5,2019
5,5/29/2019,164,1,165,3,5,2019
6,5/29/2019,219,15,234,3,5,2019
7,5/29/2019,152,236,388,3,5,2019
8,5/29/2019,134,359,493,3,5,2019
9,5/29/2019,99,271,370,3,5,2019
10,5/29/2019,177,193,370,3,5,2019
11,5/29/2019,57,243,300,3,5,2019
12,5/29/2019,85,160,245,3,5,2019
13,5/29/2019,137,3,140,3,5,2019
14,5/29/2019,112,324,436,3,5,2019
15,5/29/2019,189,284,473,3,5,2019
16,5/29/2019,88,150,238,3,5,2019
17,5/29/2019,73,276,349,3,5,2019
18,5/29/2019,18,155,173,3,5,2019
19,5/29/2019,16,180,196,3,5,2019
20,5/29/2019,90,218,308,3,5,2019
21,5/29/2019,249,72,321,3,5,2019
22,5/29/2019,242,273,515,3,5,2019
23,5/29/2019,175,238,413,3,5,2019
0,5/30/2019,54,141,195,4,5,2019
1,5/30/2019,43,1,44,4,5,2019
2,5/30/2019,22,0,22,4,5,2019
3,5/30/2019,86,0,86,4,5,2019
4,5/30/2019,80,0,80,4,5,2019
5,5/30/2019,191,1,192,4,5,2019
6,5/30/2019,331,55,386,4,5,2019
7,5/30/2019,293,202,495,4,5,2019
8,5/30/2019,194,318,512,4,5,2019
9,5/30/2019,128,445,573,4,5,2019
10,5/30/2019,146,8,154,4,5,2019
11,5/30/2019,132,237,369,4,5,2019
12,5/30/2019,126,186,312,4,5,2019
13,5/30/2019,133,81,214,4,5,2019
14,5/30/2019,143,242,385,4,5,2019
15,5/30/2019,114,179,293,4,5,2019
16,5/30/2019,151,168,319,4,5,2019
17,5/30/2019,131,303,434,4,5,2019
18,5/30/2019,59,288,347,4,5,2019
19,5/30/2019,23,37,60,4,5,2019
20,5/30/2019,135,75,210,4,5,2019
21,5/30/2019,279,391,670,4,5,2019
22,5/30/2019,321,117,438,4,5,2019
23,5/30/2019,252,231,483,4,5,2019
0,5/31/2019,121,195,316,5,5,2019
1,5/31/2019,45,66,111,5,5,2019
2,5/31/2019,37,1,38,5,5,2019
3,5/31/2019,108,0,108,5,5,2019
4,5/31/2019,85,0,85,5,5,2019
5,5/31/2019,201,2,203,5,5,2019
6,5/31/2019,307,114,421,5,5,2019
7,5/31/2019,278,187,465,5,5,2019
8,5/31/2019,231,351,582,5,5,2019
9,5/31/2019,157,488,645,5,5,2019
10,5/31/2019,135,194,329,5,5,2019
11,5/31/2019,92,213,305,5,5,2019
12,5/31/2019,93,150,243,5,5,2019
13,5/31/2019,153,67,220,5,5,2019
14,5/31/2019,141,210,351,5,5,2019
15,5/31/2019,145,285,430,5,5,2019
16,5/31/2019,157,221,378,5,5,2019
17,5/31/2019,136,204,340,5,5,2019
18,5/31/2019,38,251,289,5,5,2019
19,5/31/2019,38,227,265,5,5,2019
20,5/31/2019,132,44,176,5,5,2019
21,5/31/2019,273,365,638,5,5,2019
22,5/31/2019,369,274,643,5,5,2019
23,5/31/2019,218,144,362,5,5,2019
0,6/1/2019,91,93,184,6,6,2019
1,6/1/2019,42,171,213,6,6,2019
2,6/1/2019,34,12,46,6,6,2019
3,6/1/2019,76,1,77,6,6,2019
4,6/1/2019,58,0,58,6,6,2019
5,6/1/2019,146,1,147,6,6,2019
6,6/1/2019,313,50,363,6,6,2019
7,6/1/2019,352,189,541,6,6,2019
8,6/1/2019,222,496,718,6,6,2019
9,6/1/2019,150,401,551,6,6,2019
10,6/1/2019,114,107,221,6,6,2019
11,6/1/2019,62,307,369,6,6,2019
12,6/1/2019,114,164,278,6,6,2019
13,6/1/2019,115,178,293,6,6,2019
14,6/1/2019,133,141,274,6,6,2019
15,6/1/2019,122,373,495,6,6,2019
16,6/1/2019,98,181,279,6,6,2019
17,6/1/2019,89,222,311,6,6,2019
18,6/1/2019,39,278,317,6,6,2019
19,6/1/2019,46,221,267,6,6,2019
20,6/1/2019,123,122,245,6,6,2019
21,6/1/2019,202,209,411,6,6,2019
22,6/1/2019,206,196,402,6,6,2019
23,6/1/2019,168,179,347,6,6,2019
0,6/2/2019,84,161,245,7,6,2019
1,6/2/2019,14,36,50,7,6,2019
2,6/2/2019,73,0,73,7,6,2019
3,6/2/2019,106,0,106,7,6,2019
4,6/2/2019,134,0,134,7,6,2019
5,6/2/2019,174,0,174,7,6,2019
6,6/2/2019,246,68,314,7,6,2019
7,6/2/2019,235,389,624,7,6,2019
8,6/2/2019,145,461,606,7,6,2019
9,6/2/2019,143,255,398,7,6,2019
10,6/2/2019,170,50,220,7,6,2019
11,6/2/2019,198,302,500,7,6,2019
12,6/2/2019,165,147,312,7,6,2019
13,6/2/2019,174,189,363,7,6,2019
14,6/2/2019,140,259,399,7,6,2019
15,6/2/2019,198,362,560,7,6,2019
16,6/2/2019,177,168,345,7,6,2019
17,6/2/2019,145,119,264,7,6,2019
18,6/2/2019,65,348,413,7,6,2019
19,6/2/2019,68,138,206,7,6,2019
20,6/2/2019,116,102,218,7,6,2019
21,6/2/2019,242,157,399,7,6,2019
22,6/2/2019,186,244,430,7,6,2019
23,6/2/2019,158,381,539,7,6,2019
0,6/3/2019,102,301,403,1,6,2019
1,6/3/2019,54,0,54,1,6,2019
2,6/3/2019,39,12,51,1,6,2019
3,6/3/2019,67,6,73,1,6,2019
4,6/3/2019,40,0,40,1,6,2019
5,6/3/2019,114,0,114,1,6,2019
6,6/3/2019,263,10,273,1,6,2019
7,6/3/2019,339,349,688,1,6,2019
8,6/3/2019,226,288,514,1,6,2019
9,6/3/2019,198,198,396,1,6,2019
10,6/3/2019,141,103,244,1,6,2019
11,6/3/2019,112,243,355,1,6,2019
12,6/3/2019,152,88,240,1,6,2019
13,6/3/2019,155,127,282,1,6,2019
14,6/3/2019,153,182,335,1,6,2019
15,6/3/2019,168,349,517,1,6,2019
16,6/3/2019,187,166,353,1,6,2019
17,6/3/2019,162,242,404,1,6,2019
18,6/3/2019,44,280,324,1,6,2019
19,6/3/2019,33,181,214,1,6,2019
20,6/3/2019,122,167,289,1,6,2019
21,6/3/2019,244,225,469,1,6,2019
22,6/3/2019,228,104,332,1,6,2019
23,6/3/2019,116,258,374,1,6,2019
0,6/4/2019,86,182,268,2,6,2019
1,6/4/2019,24,0,24,2,6,2019
2,6/4/2019,67,11,78,2,6,2019
3,6/4/2019,68,0,68,2,6,2019
4,6/4/2019,90,1,91,2,6,2019
5,6/4/2019,183,0,183,2,6,2019
6,6/4/2019,278,21,299,2,6,2019
7,6/4/2019,246,185,431,2,6,2019
8,6/4/2019,199,394,593,2,6,2019
9,6/4/2019,131,216,347,2,6,2019
10,6/4/2019,155,135,290,2,6,2019
11,6/4/2019,97,180,277,2,6,2019
12,6/4/2019,127,191,318,2,6,2019
13,6/4/2019,154,134,288,2,6,2019
14,6/4/2019,169,279,448,2,6,2019
15,6/4/2019,126,193,319,2,6,2019
16,6/4/2019,137,193,330,2,6,2019
17,6/4/2019,88,221,309,2,6,2019
18,6/4/2019,27,175,202,2,6,2019
19,6/4/2019,30,105,135,2,6,2019
20,6/4/2019,130,172,302,2,6,2019
21,6/4/2019,230,214,444,2,6,2019
22,6/4/2019,269,55,324,2,6,2019
23,6/4/2019,198,148,346,2,6,2019
0,6/5/2019,114,258,372,3,6,2019
1,6/5/2019,18,22,40,3,6,2019
2,6/5/2019,30,3,33,3,6,2019
3,6/5/2019,96,0,96,3,6,2019
4,6/5/2019,131,0,131,3,6,2019
5,6/5/2019,150,0,150,3,6,2019
6,6/5/2019,284,1,285,3,6,2019
7,6/5/2019,242,116,358,3,6,2019
8,6/5/2019,139,227,366,3,6,2019
9,6/5/2019,158,288,446,3,6,2019
10,6/5/2019,171,202,373,3,6,2019
11,6/5/2019,74,243,317,3,6,2019
12,6/5/2019,143,218,361,3,6,2019
13,6/5/2019,121,32,153,3,6,2019
14,6/5/2019,125,107,232,3,6,2019
15,6/5/2019,131,141,272,3,6,2019
16,6/5/2019,116,149,265,3,6,2019
17,6/5/2019,112,327,439,3,6,2019
18,6/5/2019,37,186,223,3,6,2019
19,6/5/2019,22,130,152,3,6,2019
20,6/5/2019,151,107,258,3,6,2019
21,6/5/2019,345,188,533,3,6,2019
22,6/5/2019,275,148,423,3,6,2019
23,6/5/2019,243,114,357,3,6,2019
0,6/6/2019,167,205,372,4,6,2019
1,6/6/2019,42,13,55,4,6,2019
2,6/6/2019,67,0,67,4,6,2019
3,6/6/2019,131,0,131,4,6,2019
4,6/6/2019,108,10,118,4,6,2019
5,6/6/2019,195,0,195,4,6,2019
6,6/6/2019,344,24,368,4,6,2019
7,6/6/2019,344,214,558,4,6,2019
8,6/6/2019,242,263,505,4,6,2019
9,6/6/2019,135,271,406,4,6,2019
10,6/6/2019,191,3,194,4,6,2019
11,6/6/2019,159,211,370,4,6,2019
12,6/6/2019,223,169,392,4,6,2019
13,6/6/2019,158,39,197,4,6,2019
14,6/6/2019,148,179,327,4,6,2019
15,6/6/2019,166,185,351,4,6,2019
16,6/6/2019,158,112,270,4,6,2019
17,6/6/2019,211,224,435,4,6,2019
18,6/6/2019,56,207,263,4,6,2019
19,6/6/2019,28,88,116,4,6,2019
20,6/6/2019,163,109,272,4,6,2019
21,6/6/2019,404,99,503,4,6,2019
22,6/6/2019,338,196,534,4,6,2019
23,6/6/2019,231,157,388,4,6,2019
0,6/7/2019,242,228,470,5,6,2019
1,6/7/2019,78,83,161,5,6,2019
2,6/7/2019,22,3,25,5,6,2019
3,6/7/2019,101,0,101,5,6,2019
4,6/7/2019,100,0,100,5,6,2019
5,6/7/2019,198,0,198,5,6,2019
6,6/7/2019,364,26,390,5,6,2019
7,6/7/2019,319,56,375,5,6,2019
8,6/7/2019,329,253,582,5,6,2019
9,6/7/2019,175,390,565,5,6,2019
10,6/7/2019,161,115,276,5,6,2019
11,6/7/2019,140,141,281,5,6,2019
12,6/7/2019,184,130,314,5,6,2019
13,6/7/2019,152,84,236,5,6,2019
14,6/7/2019,138,271,409,5,6,2019
15,6/7/2019,120,148,268,5,6,2019
16,6/7/2019,122,136,258,5,6,2019
17,6/7/2019,110,229,339,5,6,2019
18,6/7/2019,63,86,149,5,6,2019
19,6/7/2019,48,132,180,5,6,2019
20,6/7/2019,178,147,325,5,6,2019
21,6/7/2019,316,160,476,5,6,2019
22,6/7/2019,330,75,405,5,6,2019
23,6/7/2019,305,110,415,5,6,2019
0,6/8/2019,202,190,392,6,6,2019
1,6/8/2019,74,136,210,6,6,2019
2,6/8/2019,86,14,100,6,6,2019
3,6/8/2019,112,4,116,6,6,2019
4,6/8/2019,65,1,66,6,6,2019
5,6/8/2019,154,0,154,6,6,2019
6,6/8/2019,413,10,423,6,6,2019
7,6/8/2019,470,160,630,6,6,2019
8,6/8/2019,411,484,895,6,6,2019
9,6/8/2019,255,304,559,6,6,2019
10,6/8/2019,180,159,339,6,6,2019
11,6/8/2019,97,245,342,6,6,2019
12,6/8/2019,185,117,302,6,6,2019
13,6/8/2019,141,125,266,6,6,2019
14,6/8/2019,183,277,460,6,6,2019
15,6/8/2019,163,258,421,6,6,2019
16,6/8/2019,179,186,365,6,6,2019
17,6/8/2019,99,315,414,6,6,2019
18,6/8/2019,57,145,202,6,6,2019
19,6/8/2019,57,226,283,6,6,2019
20,6/8/2019,153,201,354,6,6,2019
21,6/8/2019,239,179,418,6,6,2019
22,6/8/2019,263,93,356,6,6,2019
23,6/8/2019,221,154,375,6,6,2019
0,6/9/2019,163,117,280,7,6,2019
1,6/9/2019,40,59,99,7,6,2019
2,6/9/2019,97,9,106,7,6,2019
3,6/9/2019,123,0,123,7,6,2019
4,6/9/2019,111,0,111,7,6,2019
5,6/9/2019,232,0,232,7,6,2019
6,6/9/2019,296,34,330,7,6,2019
7,6/9/2019,248,407,655,7,6,2019
8,6/9/2019,118,415,533,7,6,2019
9,6/9/2019,188,225,413,7,6,2019
10,6/9/2019,201,95,296,7,6,2019
11,6/9/2019,208,254,462,7,6,2019
12,6/9/2019,200,208,408,7,6,2019
13,6/9/2019,155,120,275,7,6,2019
14,6/9/2019,107,477,584,7,6,2019
15,6/9/2019,114,241,355,7,6,2019
16,6/9/2019,208,156,364,7,6,2019
17,6/9/2019,157,201,358,7,6,2019
18,6/9/2019,64,230,294,7,6,2019
19,6/9/2019,74,188,262,7,6,2019
20,6/9/2019,144,149,293,7,6,2019
21,6/9/2019,290,176,466,7,6,2019
22,6/9/2019,219,135,354,7,6,2019
23,6/9/2019,152,228,380,7,6,2019
0,6/10/2019,132,252,384,1,6,2019
1,6/10/2019,41,4,45,1,6,2019
2,6/10/2019,17,4,21,1,6,2019
3,6/10/2019,59,0,59,1,6,2019
4,6/10/2019,77,0,77,1,6,2019
5,6/10/2019,226,0,226,1,6,2019
6,6/10/2019,290,5,295,1,6,2019
7,6/10/2019,339,265,604,1,6,2019
8,6/10/2019,227,325,552,1,6,2019
9,6/10/2019,135,293,428,1,6,2019
10,6/10/2019,190,82,272,1,6,2019
11,6/10/2019,117,202,319,1,6,2019
12,6/10/2019,166,188,354,1,6,2019
13,6/10/2019,141,174,315,1,6,2019
14,6/10/2019,163,162,325,1,6,2019
15,6/10/2019,150,305,455,1,6,2019
16,6/10/2019,130,160,290,1,6,2019
17,6/10/2019,130,168,298,1,6,2019
18,6/10/2019,66,318,384,1,6,2019
19,6/10/2019,45,214,259,1,6,2019
20,6/10/2019,134,232,366,1,6,2019
21,6/10/2019,325,156,481,1,6,2019
22,6/10/2019,255,114,369,1,6,2019
23,6/10/2019,118,330,448,1,6,2019
0,6/11/2019,128,151,279,2,6,2019
1,6/11/2019,28,31,59,2,6,2019
2,6/11/2019,79,55,134,2,6,2019
3,6/11/2019,95,0,95,2,6,2019
4,6/11/2019,124,1,125,2,6,2019
5,6/11/2019,194,0,194,2,6,2019
6,6/11/2019,318,0,318,2,6,2019
7,6/11/2019,303,1,304,2,6,2019
8,6/11/2019,268,139,407,2,6,2019
9,6/11/2019,218,237,455,2,6,2019
10,6/11/2019,244,292,536,2,6,2019
11,6/11/2019,180,183,363,2,6,2019
12,6/11/2019,204,163,367,2,6,2019
13,6/11/2019,135,6,141,2,6,2019
14,6/11/2019,140,255,395,2,6,2019
15,6/11/2019,176,372,548,2,6,2019
16,6/11/2019,165,180,345,2,6,2019
17,6/11/2019,109,326,435,2,6,2019
18,6/11/2019,56,102,158,2,6,2019
19,6/11/2019,47,271,318,2,6,2019
20,6/11/2019,189,67,256,2,6,2019
21,6/11/2019,276,181,457,2,6,2019
22,6/11/2019,268,130,398,2,6,2019
23,6/11/2019,192,215,407,2,6,2019
0,6/12/2019,161,134,295,3,6,2019
1,6/12/2019,17,60,77,3,6,2019
2,6/12/2019,44,2,46,3,6,2019
3,6/12/2019,127,0,127,3,6,2019
4,6/12/2019,136,0,136,3,6,2019
5,6/12/2019,167,0,167,3,6,2019
6,6/12/2019,331,0,331,3,6,2019
7,6/12/2019,274,60,334,3,6,2019
8,6/12/2019,203,296,499,3,6,2019
9,6/12/2019,226,319,545,3,6,2019
10,6/12/2019,193,158,351,3,6,2019
11,6/12/2019,102,191,293,3,6,2019
12,6/12/2019,92,190,282,3,6,2019
13,6/12/2019,159,40,199,3,6,2019
14,6/12/2019,125,232,357,3,6,2019
15,6/12/2019,97,240,337,3,6,2019
16,6/12/2019,108,118,226,3,6,2019
17,6/12/2019,117,367,484,3,6,2019
18,6/12/2019,28,154,182,3,6,2019
19,6/12/2019,30,183,213,3,6,2019
20,6/12/2019,151,22,173,3,6,2019
21,6/12/2019,326,245,571,3,6,2019
22,6/12/2019,322,56,378,3,6,2019
23,6/12/2019,242,121,363,3,6,2019
0,6/13/2019,220,159,379,4,6,2019
1,6/13/2019,66,9,75,4,6,2019
2,6/13/2019,79,0,79,4,6,2019
3,6/13/2019,141,0,141,4,6,2019
4,6/13/2019,173,1,174,4,6,2019
5,6/13/2019,238,0,238,4,6,2019
6,6/13/2019,404,1,405,4,6,2019
7,6/13/2019,435,205,640,4,6,2019
8,6/13/2019,264,300,564,4,6,2019
9,6/13/2019,177,323,500,4,6,2019
10,6/13/2019,212,44,256,4,6,2019
11,6/13/2019,189,213,402,4,6,2019
12,6/13/2019,264,175,439,4,6,2019
13,6/13/2019,205,135,340,4,6,2019
14,6/13/2019,218,147,365,4,6,2019
15,6/13/2019,167,306,473,4,6,2019
16,6/13/2019,110,33,143,4,6,2019
17,6/13/2019,142,306,448,4,6,2019
18,6/13/2019,43,100,143,4,6,2019
19,6/13/2019,51,208,259,4,6,2019
20,6/13/2019,158,81,239,4,6,2019
21,6/13/2019,336,239,575,4,6,2019
22,6/13/2019,398,183,581,4,6,2019
23,6/13/2019,237,169,406,4,6,2019
0,6/14/2019,212,128,340,5,6,2019
1,6/14/2019,130,78,208,5,6,2019
2,6/14/2019,39,1,40,5,6,2019
3,6/14/2019,128,0,128,5,6,2019
4,6/14/2019,111,0,111,5,6,2019
5,6/14/2019,171,0,171,5,6,2019
6,6/14/2019,435,11,446,5,6,2019
7,6/14/2019,362,115,477,5,6,2019
8,6/14/2019,287,318,605,5,6,2019
9,6/14/2019,243,320,563,5,6,2019
10,6/14/2019,253,130,383,5,6,2019
11,6/14/2019,135,156,291,5,6,2019
12,6/14/2019,191,283,474,5,6,2019
13,6/14/2019,88,40,128,5,6,2019
14,6/14/2019,134,249,383,5,6,2019
15,6/14/2019,138,288,426,5,6,2019
16,6/14/2019,108,32,140,5,6,2019
17,6/14/2019,137,275,412,5,6,2019
18,6/14/2019,75,106,181,5,6,2019
19,6/14/2019,68,415,483,5,6,2019
20,6/14/2019,193,23,216,5,6,2019
21,6/14/2019,371,284,655,5,6,2019
22,6/14/2019,420,0,420,5,6,2019
23,6/14/2019,274,211,485,5,6,2019
0,6/15/2019,251,235,486,6,6,2019
1,6/15/2019,106,84,190,6,6,2019
2,6/15/2019,59,20,79,6,6,2019
3,6/15/2019,141,1,142,6,6,2019
4,6/15/2019,60,0,60,6,6,2019
5,6/15/2019,253,0,253,6,6,2019
6,6/15/2019,334,1,335,6,6,2019
7,6/15/2019,475,253,728,6,6,2019
8,6/15/2019,403,494,897,6,6,2019
9,6/15/2019,393,375,768,6,6,2019
10,6/15/2019,187,216,403,6,6,2019
11,6/15/2019,157,152,309,6,6,2019
12,6/15/2019,204,172,376,6,6,2019
13,6/15/2019,169,219,388,6,6,2019
14,6/15/2019,162,254,416,6,6,2019
15,6/15/2019,237,271,508,6,6,2019
16,6/15/2019,180,197,377,6,6,2019
17,6/15/2019,178,470,648,6,6,2019
18,6/15/2019,52,119,171,6,6,2019
19,6/15/2019,81,322,403,6,6,2019
20,6/15/2019,181,106,287,6,6,2019
21,6/15/2019,338,402,740,6,6,2019
22,6/15/2019,317,111,428,6,6,2019
23,6/15/2019,232,272,504,6,6,2019
0,6/16/2019,168,295,463,7,6,2019
1,6/16/2019,73,43,116,7,6,2019
2,6/16/2019,57,0,57,7,6,2019
3,6/16/2019,183,0,183,7,6,2019
4,6/16/2019,197,0,197,7,6,2019
5,6/16/2019,247,0,247,7,6,2019
6,6/16/2019,349,39,388,7,6,2019
7,6/16/2019,298,341,639,7,6,2019
8,6/16/2019,267,498,765,7,6,2019
9,6/16/2019,203,333,536,7,6,2019
10,6/16/2019,264,11,275,7,6,2019
11,6/16/2019,232,264,496,7,6,2019
12,6/16/2019,160,124,284,7,6,2019
13,6/16/2019,175,258,433,7,6,2019
14,6/16/2019,91,432,523,7,6,2019
15,6/16/2019,130,340,470,7,6,2019
16,6/16/2019,144,83,227,7,6,2019
17,6/16/2019,168,208,376,7,6,2019
18,6/16/2019,78,169,247,7,6,2019
19,6/16/2019,59,161,220,7,6,2019
20,6/16/2019,238,85,323,7,6,2019
21,6/16/2019,287,284,571,7,6,2019
22,6/16/2019,333,182,515,7,6,2019
23,6/16/2019,234,328,562,7,6,2019
0,6/17/2019,182,415,597,1,6,2019
1,6/17/2019,60,18,78,1,6,2019
2,6/17/2019,40,2,42,1,6,2019
3,6/17/2019,60,6,66,1,6,2019
4,6/17/2019,112,0,112,1,6,2019
5,6/17/2019,242,4,246,1,6,2019
6,6/17/2019,322,63,385,1,6,2019
7,6/17/2019,318,225,543,1,6,2019
8,6/17/2019,295,318,613,1,6,2019
9,6/17/2019,261,389,650,1,6,2019
10,6/17/2019,190,114,304,1,6,2019
11,6/17/2019,148,294,442,1,6,2019
12,6/17/2019,187,116,303,1,6,2019
13,6/17/2019,196,70,266,1,6,2019
14,6/17/2019,161,249,410,1,6,2019
15,6/17/2019,139,292,431,1,6,2019
16,6/17/2019,220,244,464,1,6,2019
17,6/17/2019,154,469,623,1,6,2019
18,6/17/2019,73,262,335,1,6,2019
19,6/17/2019,90,263,353,1,6,2019
20,6/17/2019,169,217,386,1,6,2019
21,6/17/2019,288,59,347,1,6,2019
22,6/17/2019,309,79,388,1,6,2019
23,6/17/2019,278,376,654,1,6,2019
0,6/18/2019,131,371,502,2,6,2019
1,6/18/2019,37,34,71,2,6,2019
2,6/18/2019,112,0,112,2,6,2019
3,6/18/2019,114,10,124,2,6,2019
4,6/18/2019,100,0,100,2,6,2019
5,6/18/2019,264,0,264,2,6,2019
6,6/18/2019,351,1,352,2,6,2019
7,6/18/2019,380,208,588,2,6,2019
8,6/18/2019,288,309,597,2,6,2019
9,6/18/2019,205,375,580,2,6,2019
10,6/18/2019,247,68,315,2,6,2019
11,6/18/2019,172,365,537,2,6,2019
12,6/18/2019,193,304,497,2,6,2019
13,6/18/2019,203,142,345,2,6,2019
14,6/18/2019,151,288,439,2,6,2019
15,6/18/2019,117,249,366,2,6,2019
16,6/18/2019,119,241,360,2,6,2019
17,6/18/2019,94,217,311,2,6,2019
18,6/18/2019,42,294,336,2,6,2019
19,6/18/2019,23,138,161,2,6,2019
20,6/18/2019,192,102,294,2,6,2019
21,6/18/2019,350,417,767,2,6,2019
22,6/18/2019,272,70,342,2,6,2019
23,6/18/2019,242,251,493,2,6,2019
0,6/19/2019,114,145,259,3,6,2019
1,6/19/2019,13,66,79,3,6,2019
2,6/19/2019,40,3,43,3,6,2019
3,6/19/2019,110,0,110,3,6,2019
4,6/19/2019,122,0,122,3,6,2019
5,6/19/2019,170,0,170,3,6,2019
6,6/19/2019,378,6,384,3,6,2019
7,6/19/2019,389,179,568,3,6,2019
8,6/19/2019,175,342,517,3,6,2019
9,6/19/2019,220,284,504,3,6,2019
10,6/19/2019,186,173,359,3,6,2019
11,6/19/2019,123,256,379,3,6,2019
12,6/19/2019,176,227,403,3,6,2019
13,6/19/2019,133,26,159,3,6,2019
14,6/19/2019,155,251,406,3,6,2019
15,6/19/2019,146,63,209,3,6,2019
16,6/19/2019,160,384,544,3,6,2019
17,6/19/2019,139,194,333,3,6,2019
18,6/19/2019,75,193,268,3,6,2019
19,6/19/2019,34,193,227,3,6,2019
20,6/19/2019,209,200,409,3,6,2019
21,6/19/2019,323,56,379,3,6,2019
22,6/19/2019,298,70,368,3,6,2019
23,6/19/2019,235,157,392,3,6,2019
0,6/20/2019,181,292,473,4,6,2019
1,6/20/2019,137,97,234,4,6,2019
2,6/20/2019,65,24,89,4,6,2019
3,6/20/2019,115,1,116,4,6,2019
4,6/20/2019,169,1,170,4,6,2019
5,6/20/2019,366,3,369,4,6,2019
6,6/20/2019,475,72,547,4,6,2019
7,6/20/2019,385,120,505,4,6,2019
8,6/20/2019,353,461,814,4,6,2019
9,6/20/2019,258,340,598,4,6,2019
10,6/20/2019,281,65,346,4,6,2019
11,6/20/2019,193,286,479,4,6,2019
12,6/20/2019,172,351,523,4,6,2019
13,6/20/2019,178,67,245,4,6,2019
14,6/20/2019,189,195,384,4,6,2019
15,6/20/2019,175,233,408,4,6,2019
16,6/20/2019,188,186,374,4,6,2019
17,6/20/2019,164,367,531,4,6,2019
18,6/20/2019,73,145,218,4,6,2019
19,6/20/2019,56,280,336,4,6,2019
20,6/20/2019,183,80,263,4,6,2019
21,6/20/2019,379,260,639,4,6,2019
22,6/20/2019,433,149,582,4,6,2019
23,6/20/2019,364,256,620,4,6,2019
0,6/21/2019,217,255,472,5,6,2019
1,6/21/2019,70,144,214,5,6,2019
2,6/21/2019,39,48,87,5,6,2019
3,6/21/2019,133,19,152,5,6,2019
4,6/21/2019,199,0,199,5,6,2019
5,6/21/2019,213,0,213,5,6,2019
6,6/21/2019,418,24,442,5,6,2019
7,6/21/2019,351,187,538,5,6,2019
8,6/21/2019,256,383,639,5,6,2019
9,6/21/2019,186,272,458,5,6,2019
10,6/21/2019,199,191,390,5,6,2019
11,6/21/2019,186,351,537,5,6,2019
12,6/21/2019,185,104,289,5,6,2019
13,6/21/2019,140,278,418,5,6,2019
14,6/21/2019,90,129,219,5,6,2019
15,6/21/2019,156,258,414,5,6,2019
16,6/21/2019,179,224,403,5,6,2019
17,6/21/2019,111,276,387,5,6,2019
18,6/21/2019,78,53,131,5,6,2019
19,6/21/2019,56,454,510,5,6,2019
20,6/21/2019,149,170,319,5,6,2019
21,6/21/2019,392,383,775,5,6,2019
22,6/21/2019,411,105,516,5,6,2019
23,6/21/2019,315,216,531,5,6,2019
0,6/22/2019,192,188,380,6,6,2019
1,6/22/2019,71,83,154,6,6,2019
2,6/22/2019,76,0,76,6,6,2019
3,6/22/2019,92,0,92,6,6,2019
4,6/22/2019,76,0,76,6,6,2019
5,6/22/2019,188,0,188,6,6,2019
6,6/22/2019,381,13,394,6,6,2019
7,6/22/2019,402,243,645,6,6,2019
8,6/22/2019,342,560,902,6,6,2019
9,6/22/2019,256,334,590,6,6,2019
10,6/22/2019,242,254,496,6,6,2019
11,6/22/2019,116,327,443,6,6,2019
12,6/22/2019,170,208,378,6,6,2019
13,6/22/2019,157,308,465,6,6,2019
14,6/22/2019,160,248,408,6,6,2019
15,6/22/2019,182,332,514,6,6,2019
16,6/22/2019,205,144,349,6,6,2019
17,6/22/2019,175,495,670,6,6,2019
18,6/22/2019,64,339,403,6,6,2019
19,6/22/2019,57,306,363,6,6,2019
20,6/22/2019,117,249,366,6,6,2019
21,6/22/2019,301,319,620,6,6,2019
22,6/22/2019,307,161,468,6,6,2019
23,6/22/2019,226,231,457,6,6,2019
0,6/23/2019,138,391,529,7,6,2019
1,6/23/2019,24,86,110,7,6,2019
2,6/23/2019,67,3,70,7,6,2019
3,6/23/2019,109,0,109,7,6,2019
4,6/23/2019,190,0,190,7,6,2019
5,6/23/2019,218,0,218,7,6,2019
6,6/23/2019,300,29,329,7,6,2019
7,6/23/2019,268,375,643,7,6,2019
8,6/23/2019,168,514,682,7,6,2019
9,6/23/2019,343,292,635,7,6,2019
10,6/23/2019,260,4,264,7,6,2019
11,6/23/2019,220,398,618,7,6,2019
12,6/23/2019,159,378,537,7,6,2019
13,6/23/2019,134,300,434,7,6,2019
14,6/23/2019,109,364,473,7,6,2019
15,6/23/2019,169,284,453,7,6,2019
16,6/23/2019,163,190,353,7,6,2019
17,6/23/2019,152,345,497,7,6,2019
18,6/23/2019,55,460,515,7,6,2019
19,6/23/2019,92,260,352,7,6,2019
20,6/23/2019,179,194,373,7,6,2019
21,6/23/2019,282,170,452,7,6,2019
22,6/23/2019,222,237,459,7,6,2019
23,6/23/2019,194,131,325,7,6,2019
0,6/24/2019,186,592,778,1,6,2019
1,6/24/2019,44,14,58,1,6,2019
2,6/24/2019,12,0,12,1,6,2019
3,6/24/2019,66,6,72,1,6,2019
4,6/24/2019,41,0,41,1,6,2019
5,6/24/2019,195,1,196,1,6,2019
6,6/24/2019,262,24,286,1,6,2019
7,6/24/2019,305,305,610,1,6,2019
8,6/24/2019,268,355,623,1,6,2019
9,6/24/2019,193,345,538,1,6,2019
10,6/24/2019,204,261,465,1,6,2019
11,6/24/2019,74,188,262,1,6,2019
12,6/24/2019,156,205,361,1,6,2019
13,6/24/2019,149,64,213,1,6,2019
14,6/24/2019,178,343,521,1,6,2019
15,6/24/2019,152,365,517,1,6,2019
16,6/24/2019,148,223,371,1,6,2019
17,6/24/2019,105,225,330,1,6,2019
18,6/24/2019,47,372,419,1,6,2019
19,6/24/2019,43,320,363,1,6,2019
20,6/24/2019,171,114,285,1,6,2019
21,6/24/2019,262,188,450,1,6,2019
22,6/24/2019,234,226,460,1,6,2019
23,6/24/2019,190,509,699,1,6,2019
0,6/25/2019,124,305,429,2,6,2019
1,6/25/2019,82,241,323,2,6,2019
2,6/25/2019,56,23,79,2,6,2019
3,6/25/2019,157,36,193,2,6,2019
4,6/25/2019,82,1,83,2,6,2019
5,6/25/2019,180,0,180,2,6,2019
6,6/25/2019,309,0,309,2,6,2019
7,6/25/2019,337,191,528,2,6,2019
8,6/25/2019,252,414,666,2,6,2019
9,6/25/2019,177,417,594,2,6,2019
10,6/25/2019,175,91,266,2,6,2019
11,6/25/2019,205,330,535,2,6,2019
12,6/25/2019,164,279,443,2,6,2019
13,6/25/2019,143,166,309,2,6,2019
14,6/25/2019,153,199,352,2,6,2019
15,6/25/2019,119,387,506,2,6,2019
16,6/25/2019,139,235,374,2,6,2019
17,6/25/2019,111,335,446,2,6,2019
18,6/25/2019,30,248,278,2,6,2019
19,6/25/2019,81,204,285,2,6,2019
20,6/25/2019,201,213,414,2,6,2019
21,6/25/2019,278,384,662,2,6,2019
22,6/25/2019,267,84,351,2,6,2019
23,6/25/2019,260,286,546,2,6,2019
0,6/26/2019,173,281,454,3,6,2019
1,6/26/2019,47,16,63,3,6,2019
2,6/26/2019,35,7,42,3,6,2019
3,6/26/2019,75,2,77,3,6,2019
4,6/26/2019,105,3,108,3,6,2019
5,6/26/2019,165,0,165,3,6,2019
6,6/26/2019,288,7,295,3,6,2019
7,6/26/2019,345,285,630,3,6,2019
8,6/26/2019,230,402,632,3,6,2019
9,6/26/2019,191,354,545,3,6,2019
10,6/26/2019,188,221,409,3,6,2019
11,6/26/2019,174,420,594,3,6,2019
12,6/26/2019,151,172,323,3,6,2019
13,6/26/2019,140,93,233,3,6,2019
14,6/26/2019,105,206,311,3,6,2019
15,6/26/2019,122,258,380,3,6,2019
16,6/26/2019,149,284,433,3,6,2019
17,6/26/2019,105,267,372,3,6,2019
18,6/26/2019,38,197,235,3,6,2019
19,6/26/2019,39,282,321,3,6,2019
20,6/26/2019,168,167,335,3,6,2019
21,6/26/2019,301,183,484,3,6,2019
22,6/26/2019,342,77,419,3,6,2019
23,6/26/2019,292,215,507,3,6,2019
0,6/27/2019,224,279,503,4,6,2019
1,6/27/2019,59,140,199,4,6,2019
2,6/27/2019,89,51,140,4,6,2019
3,6/27/2019,102,7,109,4,6,2019
4,6/27/2019,136,8,144,4,6,2019
5,6/27/2019,297,0,297,4,6,2019
6,6/27/2019,367,0,367,4,6,2019
7,6/27/2019,422,244,666,4,6,2019
8,6/27/2019,293,453,746,4,6,2019
9,6/27/2019,239,405,644,4,6,2019
10,6/27/2019,236,156,392,4,6,2019
11,6/27/2019,160,283,443,4,6,2019
12,6/27/2019,140,297,437,4,6,2019
13,6/27/2019,150,94,244,4,6,2019
14,6/27/2019,185,306,491,4,6,2019
15,6/27/2019,180,230,410,4,6,2019
16,6/27/2019,166,189,355,4,6,2019
17,6/27/2019,174,477,651,4,6,2019
18,6/27/2019,69,148,217,4,6,2019
19,6/27/2019,76,290,366,4,6,2019
20,6/27/2019,147,175,322,4,6,2019
21,6/27/2019,451,305,756,4,6,2019
22,6/27/2019,408,85,493,4,6,2019
23,6/27/2019,325,243,568,4,6,2019
0,6/28/2019,167,312,479,5,6,2019
1,6/28/2019,61,152,213,5,6,2019
2,6/28/2019,48,0,48,5,6,2019
3,6/28/2019,96,0,96,5,6,2019
4,6/28/2019,134,0,134,5,6,2019
5,6/28/2019,263,0,263,5,6,2019
6,6/28/2019,419,29,448,5,6,2019
7,6/28/2019,320,230,550,5,6,2019
8,6/28/2019,268,399,667,5,6,2019
9,6/28/2019,223,448,671,5,6,2019
10,6/28/2019,166,217,383,5,6,2019
11,6/28/2019,121,379,500,5,6,2019
12,6/28/2019,197,186,383,5,6,2019
13,6/28/2019,118,78,196,5,6,2019
14,6/28/2019,152,305,457,5,6,2019
15,6/28/2019,171,374,545,5,6,2019
16,6/28/2019,165,131,296,5,6,2019
17,6/28/2019,128,368,496,5,6,2019
18,6/28/2019,51,171,222,5,6,2019
19,6/28/2019,57,388,445,5,6,2019
20,6/28/2019,209,168,377,5,6,2019
21,6/28/2019,345,277,622,5,6,2019
22,6/28/2019,283,201,484,5,6,2019
23,6/28/2019,345,203,548,5,6,2019
0,6/29/2019,228,241,469,6,6,2019
1,6/29/2019,142,167,309,6,6,2019
2,6/29/2019,66,4,70,6,6,2019
3,6/29/2019,126,6,132,6,6,2019
4,6/29/2019,81,0,81,6,6,2019
5,6/29/2019,149,1,150,6,6,2019
6,6/29/2019,335,17,352,6,6,2019
7,6/29/2019,435,192,627,6,6,2019
8,6/29/2019,451,587,1038,6,6,2019
9,6/29/2019,313,624,937,6,6,2019
10,6/29/2019,215,180,395,6,6,2019
11,6/29/2019,97,441,538,6,6,2019
12,6/29/2019,160,255,415,6,6,2019
13,6/29/2019,143,110,253,6,6,2019
14,6/29/2019,166,348,514,6,6,2019
15,6/29/2019,199,438,637,6,6,2019
16,6/29/2019,178,219,397,6,6,2019
17,6/29/2019,133,513,646,6,6,2019
18,6/29/2019,65,208,273,6,6,2019
19,6/29/2019,49,436,485,6,6,2019
20,6/29/2019,181,177,358,6,6,2019
21,6/29/2019,241,351,592,6,6,2019
22,6/29/2019,319,196,515,6,6,2019
23,6/29/2019,198,346,544,6,6,2019
0,6/30/2019,194,317,511,7,6,2019
1,6/30/2019,59,216,275,7,6,2019
2,6/30/2019,43,0,43,7,6,2019
3,6/30/2019,137,0,137,7,6,2019
4,6/30/2019,168,0,168,7,6,2019
5,6/30/2019,142,0,142,7,6,2019
6,6/30/2019,289,14,303,7,6,2019
7,6/30/2019,303,501,804,7,6,2019
8,6/30/2019,230,567,797,7,6,2019
9,6/30/2019,217,465,682,7,6,2019
10,6/30/2019,187,40,227,7,6,2019
11,6/30/2019,209,449,658,7,6,2019
12,6/30/2019,179,331,510,7,6,2019
13,6/30/2019,149,306,455,7,6,2019
14,6/30/2019,133,246,379,7,6,2019
15,6/30/2019,121,493,614,7,6,2019
16,6/30/2019,154,232,386,7,6,2019
17,6/30/2019,157,242,399,7,6,2019
18,6/30/2019,58,255,313,7,6,2019
19,6/30/2019,74,534,608,7,6,2019
20,6/30/2019,163,165,328,7,6,2019
21,6/30/2019,250,239,489,7,6,2019
22,6/30/2019,259,219,478,7,6,2019
23,6/30/2019,207,326,533,7,6,2019
0,7/1/2019,136,560,696,1,7,2019
1,7/1/2019,30,156,186,1,7,2019
2,7/1/2019,22,0,22,1,7,2019
3,7/1/2019,75,0,75,1,7,2019
4,7/1/2019,96,0,96,1,7,2019
5,7/1/2019,154,0,154,1,7,2019
6,7/1/2019,258,0,258,1,7,2019
7,7/1/2019,257,0,257,1,7,2019
8,7/1/2019,176,242,418,1,7,2019
9,7/1/2019,141,292,433,1,7,2019
10,7/1/2019,159,564,723,1,7,2019
11,7/1/2019,77,319,396,1,7,2019
12,7/1/2019,156,136,292,1,7,2019
13,7/1/2019,146,166,312,1,7,2019
14,7/1/2019,138,337,475,1,7,2019
15,7/1/2019,179,338,517,1,7,2019
16,7/1/2019,137,153,290,1,7,2019
17,7/1/2019,141,527,668,1,7,2019
18,7/1/2019,33,449,482,1,7,2019
19,7/1/2019,45,301,346,1,7,2019
20,7/1/2019,112,99,211,1,7,2019
21,7/1/2019,221,261,482,1,7,2019
22,7/1/2019,267,293,560,1,7,2019
23,7/1/2019,220,379,599,1,7,2019
0,7/2/2019,101,361,462,2,7,2019
1,7/2/2019,37,62,99,2,7,2019
2,7/2/2019,80,0,80,2,7,2019
3,7/2/2019,106,0,106,2,7,2019
4,7/2/2019,113,0,113,2,7,2019
5,7/2/2019,170,0,170,2,7,2019
6,7/2/2019,292,91,383,2,7,2019
7,7/2/2019,295,402,697,2,7,2019
8,7/2/2019,285,273,558,2,7,2019
9,7/2/2019,185,472,657,2,7,2019
10,7/2/2019,181,124,305,2,7,2019
11,7/2/2019,202,401,603,2,7,2019
12,7/2/2019,229,253,482,2,7,2019
13,7/2/2019,163,205,368,2,7,2019
14,7/2/2019,155,276,431,2,7,2019
15,7/2/2019,132,318,450,2,7,2019
16,7/2/2019,108,151,259,2,7,2019
17,7/2/2019,144,398,542,2,7,2019
18,7/2/2019,47,172,219,2,7,2019
19,7/2/2019,48,225,273,2,7,2019
20,7/2/2019,181,204,385,2,7,2019
21,7/2/2019,307,374,681,2,7,2019
22,7/2/2019,410,109,519,2,7,2019
23,7/2/2019,266,338,604,2,7,2019
0,7/3/2019,136,153,289,3,7,2019
1,7/3/2019,23,160,183,3,7,2019
2,7/3/2019,38,49,87,3,7,2019
3,7/3/2019,97,6,103,3,7,2019
4,7/3/2019,97,3,100,3,7,2019
5,7/3/2019,215,39,254,3,7,2019
6,7/3/2019,360,61,421,3,7,2019
7,7/3/2019,423,327,750,3,7,2019
8,7/3/2019,267,371,638,3,7,2019
9,7/3/2019,209,432,641,3,7,2019
10,7/3/2019,166,203,369,3,7,2019
11,7/3/2019,138,271,409,3,7,2019
12,7/3/2019,181,282,463,3,7,2019
13,7/3/2019,235,162,397,3,7,2019
14,7/3/2019,170,263,433,3,7,2019
15,7/3/2019,195,207,402,3,7,2019
16,7/3/2019,229,276,505,3,7,2019
17,7/3/2019,158,410,568,3,7,2019
18,7/3/2019,99,270,369,3,7,2019
19,7/3/2019,85,157,242,3,7,2019
20,7/3/2019,208,150,358,3,7,2019
21,7/3/2019,384,301,685,3,7,2019
22,7/3/2019,445,75,520,3,7,2019
23,7/3/2019,349,354,703,3,7,2019
0,7/4/2019,238,376,614,4,7,2019
1,7/4/2019,113,26,139,4,7,2019
2,7/4/2019,89,37,126,4,7,2019
3,7/4/2019,135,2,137,4,7,2019
4,7/4/2019,196,6,202,4,7,2019
5,7/4/2019,293,1,294,4,7,2019
6,7/4/2019,470,136,606,4,7,2019
7,7/4/2019,572,312,884,4,7,2019
8,7/4/2019,419,456,875,4,7,2019
9,7/4/2019,277,274,551,4,7,2019
10,7/4/2019,318,124,442,4,7,2019
11,7/4/2019,187,178,365,4,7,2019
12,7/4/2019,178,280,458,4,7,2019
13,7/4/2019,206,196,402,4,7,2019
14,7/4/2019,161,247,408,4,7,2019
15,7/4/2019,174,224,398,4,7,2019
16,7/4/2019,184,211,395,4,7,2019
17,7/4/2019,126,295,421,4,7,2019
18,7/4/2019,75,204,279,4,7,2019
19,7/4/2019,106,159,265,4,7,2019
20,7/4/2019,171,172,343,4,7,2019
21,7/4/2019,274,215,489,4,7,2019
22,7/4/2019,313,209,522,4,7,2019
23,7/4/2019,205,162,367,4,7,2019
0,7/5/2019,115,239,354,5,7,2019
1,7/5/2019,34,116,150,5,7,2019
2,7/5/2019,36,69,105,5,7,2019
3,7/5/2019,87,0,87,5,7,2019
4,7/5/2019,132,0,132,5,7,2019
5,7/5/2019,235,0,235,5,7,2019
6,7/5/2019,306,53,359,5,7,2019
7,7/5/2019,246,285,531,5,7,2019
8,7/5/2019,180,390,570,5,7,2019
9,7/5/2019,178,294,472,5,7,2019
10,7/5/2019,133,356,489,5,7,2019
11,7/5/2019,113,374,487,5,7,2019
12,7/5/2019,128,223,351,5,7,2019
13,7/5/2019,98,88,186,5,7,2019
14,7/5/2019,139,299,438,5,7,2019
15,7/5/2019,131,246,377,5,7,2019
16,7/5/2019,129,257,386,5,7,2019
17,7/5/2019,127,387,514,5,7,2019
18,7/5/2019,37,178,215,5,7,2019
19,7/5/2019,70,250,320,5,7,2019
20,7/5/2019,139,190,329,5,7,2019
21,7/5/2019,212,462,674,5,7,2019
22,7/5/2019,302,158,460,5,7,2019
23,7/5/2019,258,328,586,5,7,2019
0,7/6/2019,115,120,235,6,7,2019
1,7/6/2019,19,57,76,6,7,2019
2,7/6/2019,57,0,57,6,7,2019
3,7/6/2019,67,3,70,6,7,2019
4,7/6/2019,86,0,86,6,7,2019
5,7/6/2019,127,13,140,6,7,2019
6,7/6/2019,280,5,285,6,7,2019
7,7/6/2019,295,397,692,6,7,2019
8,7/6/2019,247,668,915,6,7,2019
9,7/6/2019,185,446,631,6,7,2019
10,7/6/2019,148,221,369,6,7,2019
11,7/6/2019,96,363,459,6,7,2019
12,7/6/2019,145,133,278,6,7,2019
13,7/6/2019,136,227,363,6,7,2019
14,7/6/2019,138,466,604,6,7,2019
15,7/6/2019,178,255,433,6,7,2019
16,7/6/2019,153,473,626,6,7,2019
17,7/6/2019,100,367,467,6,7,2019
18,7/6/2019,60,210,270,6,7,2019
19,7/6/2019,55,204,259,6,7,2019
20,7/6/2019,195,185,380,6,7,2019
21,7/6/2019,255,307,562,6,7,2019
22,7/6/2019,286,356,642,6,7,2019
23,7/6/2019,208,454,662,6,7,2019
0,7/7/2019,81,313,394,7,7,2019
1,7/7/2019,29,120,149,7,7,2019
2,7/7/2019,54,0,54,7,7,2019
3,7/7/2019,96,9,105,7,7,2019
4,7/7/2019,108,0,108,7,7,2019
5,7/7/2019,157,0,157,7,7,2019
6,7/7/2019,277,103,380,7,7,2019
7,7/7/2019,223,520,743,7,7,2019
8,7/7/2019,115,667,782,7,7,2019
9,7/7/2019,177,377,554,7,7,2019
10,7/7/2019,206,29,235,7,7,2019
11,7/7/2019,110,537,647,7,7,2019
12,7/7/2019,160,453,613,7,7,2019
13,7/7/2019,179,234,413,7,7,2019
14,7/7/2019,99,602,701,7,7,2019
15,7/7/2019,97,353,450,7,7,2019
16,7/7/2019,132,166,298,7,7,2019
17,7/7/2019,144,372,516,7,7,2019
18,7/7/2019,99,543,642,7,7,2019
19,7/7/2019,88,423,511,7,7,2019
20,7/7/2019,129,318,447,7,7,2019
21,7/7/2019,198,286,484,7,7,2019
22,7/7/2019,258,359,617,7,7,2019
23,7/7/2019,192,544,736,7,7,2019
0,7/8/2019,82,531,613,1,7,2019
1,7/8/2019,30,178,208,1,7,2019
2,7/8/2019,15,0,15,1,7,2019
3,7/8/2019,51,26,77,1,7,2019
4,7/8/2019,106,4,110,1,7,2019
5,7/8/2019,146,12,158,1,7,2019
6,7/8/2019,321,171,492,1,7,2019
7,7/8/2019,240,455,695,1,7,2019
8,7/8/2019,185,618,803,1,7,2019
9,7/8/2019,115,353,468,1,7,2019
10,7/8/2019,118,114,232,1,7,2019
11,7/8/2019,76,297,373,1,7,2019
12,7/8/2019,123,147,270,1,7,2019
13,7/8/2019,131,273,404,1,7,2019
14,7/8/2019,117,229,346,1,7,2019
15,7/8/2019,152,447,599,1,7,2019
16,7/8/2019,131,215,346,1,7,2019
17,7/8/2019,164,365,529,1,7,2019
18,7/8/2019,15,382,397,1,7,2019
19,7/8/2019,48,415,463,1,7,2019
20,7/8/2019,127,126,253,1,7,2019
21,7/8/2019,177,220,397,1,7,2019
22,7/8/2019,193,206,399,1,7,2019
23,7/8/2019,155,467,622,1,7,2019
0,7/9/2019,57,292,349,2,7,2019
1,7/9/2019,35,262,297,2,7,2019
2,7/9/2019,51,11,62,2,7,2019
3,7/9/2019,93,0,93,2,7,2019
4,7/9/2019,57,1,58,2,7,2019
5,7/9/2019,155,2,157,2,7,2019
6,7/9/2019,261,106,367,2,7,2019
7,7/9/2019,202,357,559,2,7,2019
8,7/9/2019,189,326,515,2,7,2019
9,7/9/2019,121,482,603,2,7,2019
10,7/9/2019,159,140,299,2,7,2019
11,7/9/2019,134,492,626,2,7,2019
12,7/9/2019,189,278,467,2,7,2019
13,7/9/2019,175,145,320,2,7,2019
14,7/9/2019,134,291,425,2,7,2019
15,7/9/2019,107,260,367,2,7,2019
16,7/9/2019,90,192,282,2,7,2019
17,7/9/2019,94,372,466,2,7,2019
18,7/9/2019,47,181,228,2,7,2019
19,7/9/2019,76,205,281,2,7,2019
20,7/9/2019,151,197,348,2,7,2019
21,7/9/2019,255,490,745,2,7,2019
22,7/9/2019,216,274,490,2,7,2019
23,7/9/2019,176,176,352,2,7,2019
0,7/10/2019,63,277,340,3,7,2019
1,7/10/2019,13,60,73,3,7,2019
2,7/10/2019,26,0,26,3,7,2019
3,7/10/2019,39,22,61,3,7,2019
4,7/10/2019,97,0,97,3,7,2019
5,7/10/2019,131,5,136,3,7,2019
6,7/10/2019,280,72,352,3,7,2019
7,7/10/2019,188,425,613,3,7,2019
8,7/10/2019,148,318,466,3,7,2019
9,7/10/2019,137,470,607,3,7,2019
10,7/10/2019,134,99,233,3,7,2019
11,7/10/2019,80,393,473,3,7,2019
12,7/10/2019,142,136,278,3,7,2019
13,7/10/2019,155,122,277,3,7,2019
14,7/10/2019,138,268,406,3,7,2019
15,7/10/2019,107,259,366,3,7,2019
16,7/10/2019,143,336,479,3,7,2019
17,7/10/2019,116,108,224,3,7,2019
18,7/10/2019,52,194,246,3,7,2019
19,7/10/2019,51,251,302,3,7,2019
20,7/10/2019,85,107,192,3,7,2019
21,7/10/2019,302,164,466,3,7,2019
22,7/10/2019,283,114,397,3,7,2019
23,7/10/2019,248,335,583,3,7,2019
0,7/11/2019,179,191,370,4,7,2019
1,7/11/2019,22,178,200,4,7,2019
2,7/11/2019,42,0,42,4,7,2019
3,7/11/2019,84,31,115,4,7,2019
4,7/11/2019,115,0,115,4,7,2019
5,7/11/2019,220,0,220,4,7,2019
6,7/11/2019,306,110,416,4,7,2019
7,7/11/2019,255,256,511,4,7,2019
8,7/11/2019,215,529,744,4,7,2019
9,7/11/2019,187,349,536,4,7,2019
10,7/11/2019,197,215,412,4,7,2019
11,7/11/2019,150,178,328,4,7,2019
12,7/11/2019,158,333,491,4,7,2019
13,7/11/2019,159,142,301,4,7,2019
14,7/11/2019,131,260,391,4,7,2019
15,7/11/2019,133,175,308,4,7,2019
16,7/11/2019,158,186,344,4,7,2019
17,7/11/2019,149,343,492,4,7,2019
18,7/11/2019,57,294,351,4,7,2019
19,7/11/2019,51,274,325,4,7,2019
20,7/11/2019,157,158,315,4,7,2019
21,7/11/2019,333,83,416,4,7,2019
22,7/11/2019,355,232,587,4,7,2019
23,7/11/2019,307,252,559,4,7,2019
0,7/12/2019,179,314,493,5,7,2019
1,7/12/2019,41,161,202,5,7,2019
2,7/12/2019,42,4,46,5,7,2019
3,7/12/2019,94,1,95,5,7,2019
4,7/12/2019,171,7,178,5,7,2019
5,7/12/2019,203,0,203,5,7,2019
6,7/12/2019,308,109,417,5,7,2019
7,7/12/2019,257,237,494,5,7,2019
8,7/12/2019,217,422,639,5,7,2019
9,7/12/2019,161,479,640,5,7,2019
10,7/12/2019,184,166,350,5,7,2019
11,7/12/2019,124,419,543,5,7,2019
12,7/12/2019,127,107,234,5,7,2019
13,7/12/2019,137,172,309,5,7,2019
14,7/12/2019,137,310,447,5,7,2019
15,7/12/2019,169,175,344,5,7,2019
16,7/12/2019,128,286,414,5,7,2019
17,7/12/2019,108,290,398,5,7,2019
18,7/12/2019,62,133,195,5,7,2019
19,7/12/2019,67,296,363,5,7,2019
20,7/12/2019,150,215,365,5,7,2019
21,7/12/2019,333,370,703,5,7,2019
22,7/12/2019,335,180,515,5,7,2019
23,7/12/2019,244,280,524,5,7,2019
0,7/13/2019,154,292,446,6,7,2019
1,7/13/2019,66,121,187,6,7,2019
2,7/13/2019,55,18,73,6,7,2019
3,7/13/2019,73,0,73,6,7,2019
4,7/13/2019,68,7,75,6,7,2019
5,7/13/2019,167,0,167,6,7,2019
6,7/13/2019,303,9,312,6,7,2019
7,7/13/2019,361,289,650,6,7,2019
8,7/13/2019,271,667,938,6,7,2019
9,7/13/2019,187,565,752,6,7,2019
10,7/13/2019,155,317,472,6,7,2019
11,7/13/2019,97,324,421,6,7,2019
12,7/13/2019,120,199,319,6,7,2019
13,7/13/2019,136,101,237,6,7,2019
14,7/13/2019,153,344,497,6,7,2019
15,7/13/2019,156,241,397,6,7,2019
16,7/13/2019,184,120,304,6,7,2019
17,7/13/2019,122,442,564,6,7,2019
18,7/13/2019,52,353,405,6,7,2019
19,7/13/2019,107,241,348,6,7,2019
20,7/13/2019,107,172,279,6,7,2019
21,7/13/2019,236,352,588,6,7,2019
22,7/13/2019,255,280,535,6,7,2019
23,7/13/2019,227,250,477,6,7,2019
0,7/14/2019,65,307,372,7,7,2019
1,7/14/2019,17,73,90,7,7,2019
2,7/14/2019,43,0,43,7,7,2019
3,7/14/2019,70,0,70,7,7,2019
4,7/14/2019,90,0,90,7,7,2019
5,7/14/2019,190,0,190,7,7,2019
6,7/14/2019,227,100,327,7,7,2019
7,7/14/2019,223,461,684,7,7,2019
8,7/14/2019,159,542,701,7,7,2019
9,7/14/2019,161,488,649,7,7,2019
10,7/14/2019,180,10,190,7,7,2019
11,7/14/2019,158,477,635,7,7,2019
12,7/14/2019,144,326,470,7,7,2019
13,7/14/2019,222,232,454,7,7,2019
14,7/14/2019,103,249,352,7,7,2019
15,7/14/2019,136,370,506,7,7,2019
16,7/14/2019,165,97,262,7,7,2019
17,7/14/2019,135,409,544,7,7,2019
18,7/14/2019,75,170,245,7,7,2019
19,7/14/2019,121,329,450,7,7,2019
20,7/14/2019,135,226,361,7,7,2019
21,7/14/2019,186,250,436,7,7,2019
22,7/14/2019,260,111,371,7,7,2019
23,7/14/2019,205,475,680,7,7,2019
0,7/15/2019,64,288,352,1,7,2019
1,7/15/2019,28,145,173,1,7,2019
2,7/15/2019,26,0,26,1,7,2019
3,7/15/2019,59,12,71,1,7,2019
4,7/15/2019,42,0,42,1,7,2019
5,7/15/2019,124,9,133,1,7,2019
6,7/15/2019,213,125,338,1,7,2019
7,7/15/2019,246,20,266,1,7,2019
8,7/15/2019,208,599,807,1,7,2019
9,7/15/2019,165,446,611,1,7,2019
10,7/15/2019,132,349,481,1,7,2019
11,7/15/2019,78,387,465,1,7,2019
12,7/15/2019,107,208,315,1,7,2019
13,7/15/2019,156,143,299,1,7,2019
14,7/15/2019,195,268,463,1,7,2019
15,7/15/2019,130,288,418,1,7,2019
16,7/15/2019,167,245,412,1,7,2019
17,7/15/2019,152,349,501,1,7,2019
18,7/15/2019,44,333,377,1,7,2019
19,7/15/2019,58,183,241,1,7,2019
20,7/15/2019,100,71,171,1,7,2019
21,7/15/2019,181,334,515,1,7,2019
22,7/15/2019,163,210,373,1,7,2019
23,7/15/2019,179,199,378,1,7,2019
0,7/16/2019,126,358,484,2,7,2019
1,7/16/2019,63,106,169,2,7,2019
2,7/16/2019,68,97,165,2,7,2019
3,7/16/2019,69,1,70,2,7,2019
4,7/16/2019,61,0,61,2,7,2019
5,7/16/2019,149,0,149,2,7,2019
6,7/16/2019,254,0,254,2,7,2019
7,7/16/2019,263,0,263,2,7,2019
8,7/16/2019,155,22,177,2,7,2019
9,7/16/2019,137,646,783,2,7,2019
10,7/16/2019,171,590,761,2,7,2019
11,7/16/2019,140,504,644,2,7,2019
12,7/16/2019,146,254,400,2,7,2019
13,7/16/2019,155,278,433,2,7,2019
14,7/16/2019,134,108,242,2,7,2019
15,7/16/2019,115,119,234,2,7,2019
16,7/16/2019,130,473,603,2,7,2019
17,7/16/2019,119,301,420,2,7,2019
18,7/16/2019,49,350,399,2,7,2019
19,7/16/2019,84,257,341,2,7,2019
20,7/16/2019,124,161,285,2,7,2019
21,7/16/2019,258,263,521,2,7,2019
22,7/16/2019,265,68,333,2,7,2019
23,7/16/2019,215,327,542,2,7,2019
0,7/17/2019,130,321,451,3,7,2019
1,7/17/2019,8,241,249,3,7,2019
2,7/17/2019,19,0,19,3,7,2019
3,7/17/2019,54,0,54,3,7,2019
4,7/17/2019,101,0,101,3,7,2019
5,7/17/2019,127,0,127,3,7,2019
6,7/17/2019,273,0,273,3,7,2019
7,7/17/2019,227,269,496,3,7,2019
8,7/17/2019,189,391,580,3,7,2019
9,7/17/2019,114,591,705,3,7,2019
10,7/17/2019,205,176,381,3,7,2019
11,7/17/2019,136,363,499,3,7,2019
12,7/17/2019,187,173,360,3,7,2019
13,7/17/2019,126,188,314,3,7,2019
14,7/17/2019,187,298,485,3,7,2019
15,7/17/2019,123,247,370,3,7,2019
16,7/17/2019,105,224,329,3,7,2019
17,7/17/2019,138,134,272,3,7,2019
18,7/17/2019,106,194,300,3,7,2019
19,7/17/2019,67,239,306,3,7,2019
20,7/17/2019,129,177,306,3,7,2019
21,7/17/2019,264,282,546,3,7,2019
22,7/17/2019,348,145,493,3,7,2019
23,7/17/2019,342,207,549,3,7,2019
0,7/18/2019,184,259,443,4,7,2019
1,7/18/2019,61,248,309,4,7,2019
2,7/18/2019,2,59,61,4,7,2019
3,7/18/2019,5,3,8,4,7,2019
4,7/18/2019,126,0,126,4,7,2019
5,7/18/2019,382,0,382,4,7,2019
6,7/18/2019,409,91,500,4,7,2019
7,7/18/2019,374,359,733,4,7,2019
8,7/18/2019,252,367,619,4,7,2019
9,7/18/2019,168,492,660,4,7,2019
10,7/18/2019,250,113,363,4,7,2019
11,7/18/2019,156,359,515,4,7,2019
12,7/18/2019,172,297,469,4,7,2019
13,7/18/2019,211,140,351,4,7,2019
14,7/18/2019,171,222,393,4,7,2019
15,7/18/2019,165,204,369,4,7,2019
16,7/18/2019,166,220,386,4,7,2019
17,7/18/2019,164,264,428,4,7,2019
18,7/18/2019,85,192,277,4,7,2019
19,7/18/2019,91,228,319,4,7,2019
20,7/18/2019,180,118,298,4,7,2019
21,7/18/2019,377,297,674,4,7,2019
22,7/18/2019,394,221,615,4,7,2019
23,7/18/2019,319,280,599,4,7,2019
0,7/19/2019,193,309,502,5,7,2019
1,7/19/2019,38,152,190,5,7,2019
2,7/19/2019,46,85,131,5,7,2019
3,7/19/2019,129,0,129,5,7,2019
4,7/19/2019,149,10,159,5,7,2019
5,7/19/2019,257,0,257,5,7,2019
6,7/19/2019,344,84,428,5,7,2019
7,7/19/2019,333,319,652,5,7,2019
8,7/19/2019,232,374,606,5,7,2019
9,7/19/2019,193,454,647,5,7,2019
10,7/19/2019,170,62,232,5,7,2019
11,7/19/2019,125,329,454,5,7,2019
12,7/19/2019,171,122,293,5,7,2019
13,7/19/2019,150,219,369,5,7,2019
14,7/19/2019,106,295,401,5,7,2019
15,7/19/2019,176,291,467,5,7,2019
16,7/19/2019,158,211,369,5,7,2019
17,7/19/2019,162,236,398,5,7,2019
18,7/19/2019,71,262,333,5,7,2019
19,7/19/2019,77,225,302,5,7,2019
20,7/19/2019,149,128,277,5,7,2019
21,7/19/2019,316,256,572,5,7,2019
22,7/19/2019,334,247,581,5,7,2019
23,7/19/2019,347,236,583,5,7,2019
0,7/20/2019,197,467,664,6,7,2019
1,7/20/2019,59,230,289,6,7,2019
2,7/20/2019,31,0,31,6,7,2019
3,7/20/2019,77,15,92,6,7,2019
4,7/20/2019,51,15,66,6,7,2019
5,7/20/2019,163,2,165,6,7,2019
6,7/20/2019,315,0,315,6,7,2019
7,7/20/2019,420,260,680,6,7,2019
8,7/20/2019,304,692,996,6,7,2019
9,7/20/2019,207,488,695,6,7,2019
10,7/20/2019,134,236,370,6,7,2019
11,7/20/2019,57,423,480,6,7,2019
12,7/20/2019,186,152,338,6,7,2019
13,7/20/2019,184,182,366,6,7,2019
14,7/20/2019,224,209,433,6,7,2019
15,7/20/2019,185,326,511,6,7,2019
16,7/20/2019,132,290,422,6,7,2019
17,7/20/2019,194,366,560,6,7,2019
18,7/20/2019,87,127,214,6,7,2019
19,7/20/2019,122,257,379,6,7,2019
20,7/20/2019,202,164,366,6,7,2019
21,7/20/2019,338,269,607,6,7,2019
22,7/20/2019,253,293,546,6,7,2019
23,7/20/2019,189,239,428,6,7,2019
0,7/21/2019,115,172,287,7,7,2019
1,7/21/2019,41,138,179,7,7,2019
2,7/21/2019,54,6,60,7,7,2019
3,7/21/2019,147,0,147,7,7,2019
4,7/21/2019,100,10,110,7,7,2019
5,7/21/2019,204,110,314,7,7,2019
6,7/21/2019,281,62,343,7,7,2019
7,7/21/2019,273,534,807,7,7,2019
8,7/21/2019,166,442,608,7,7,2019
9,7/21/2019,240,310,550,7,7,2019
10,7/21/2019,260,121,381,7,7,2019
11,7/21/2019,145,460,605,7,7,2019
12,7/21/2019,160,249,409,7,7,2019
13,7/21/2019,180,306,486,7,7,2019
14,7/21/2019,142,295,437,7,7,2019
15,7/21/2019,182,362,544,7,7,2019
16,7/21/2019,198,91,289,7,7,2019
17,7/21/2019,225,274,499,7,7,2019
18,7/21/2019,102,204,306,7,7,2019
19,7/21/2019,84,179,263,7,7,2019
20,7/21/2019,194,153,347,7,7,2019
21,7/21/2019,322,251,573,7,7,2019
22,7/21/2019,299,473,772,7,7,2019
23,7/21/2019,132,386,518,7,7,2019
0,7/22/2019,113,172,285,1,7,2019
1,7/22/2019,38,169,207,1,7,2019
2,7/22/2019,45,0,45,1,7,2019
3,7/22/2019,74,9,83,1,7,2019
4,7/22/2019,73,1,74,1,7,2019
5,7/22/2019,134,7,141,1,7,2019
6,7/22/2019,275,200,475,1,7,2019
7,7/22/2019,327,345,672,1,7,2019
8,7/22/2019,197,464,661,1,7,2019
9,7/22/2019,234,362,596,1,7,2019
10,7/22/2019,212,138,350,1,7,2019
11,7/22/2019,108,337,445,1,7,2019
12,7/22/2019,136,182,318,1,7,2019
13,7/22/2019,179,141,320,1,7,2019
14,7/22/2019,158,254,412,1,7,2019
15,7/22/2019,205,464,669,1,7,2019
16,7/22/2019,184,168,352,1,7,2019
17,7/22/2019,144,359,503,1,7,2019
18,7/22/2019,75,267,342,1,7,2019
19,7/22/2019,56,415,471,1,7,2019
20,7/22/2019,132,33,165,1,7,2019
21,7/22/2019,318,309,627,1,7,2019
22,7/22/2019,232,185,417,1,7,2019
23,7/22/2019,191,486,677,1,7,2019
0,7/23/2019,99,306,405,2,7,2019
1,7/23/2019,35,140,175,2,7,2019
2,7/23/2019,108,51,159,2,7,2019
3,7/23/2019,82,0,82,2,7,2019
4,7/23/2019,77,2,79,2,7,2019
5,7/23/2019,178,1,179,2,7,2019
6,7/23/2019,294,90,384,2,7,2019
7,7/23/2019,281,413,694,2,7,2019
8,7/23/2019,215,332,547,2,7,2019
9,7/23/2019,141,492,633,2,7,2019
10,7/23/2019,239,167,406,2,7,2019
11,7/23/2019,173,285,458,2,7,2019
12,7/23/2019,164,340,504,2,7,2019
13,7/23/2019,192,155,347,2,7,2019
14,7/23/2019,112,198,310,2,7,2019
15,7/23/2019,153,308,461,2,7,2019
16,7/23/2019,166,147,313,2,7,2019
17,7/23/2019,153,295,448,2,7,2019
18,7/23/2019,45,188,233,2,7,2019
19,7/23/2019,85,128,213,2,7,2019
20,7/23/2019,203,67,270,2,7,2019
21,7/23/2019,304,317,621,2,7,2019
22,7/23/2019,298,315,613,2,7,2019
23,7/23/2019,239,126,365,2,7,2019
0,7/24/2019,160,219,379,3,7,2019
1,7/24/2019,31,134,165,3,7,2019
2,7/24/2019,36,57,93,3,7,2019
3,7/24/2019,89,0,89,3,7,2019
4,7/24/2019,91,24,115,3,7,2019
5,7/24/2019,128,2,130,3,7,2019
6,7/24/2019,298,75,373,3,7,2019
7,7/24/2019,272,337,609,3,7,2019
8,7/24/2019,201,337,538,3,7,2019
9,7/24/2019,223,337,560,3,7,2019
10,7/24/2019,178,253,431,3,7,2019
11,7/24/2019,116,343,459,3,7,2019
12,7/24/2019,159,232,391,3,7,2019
13,7/24/2019,225,61,286,3,7,2019
14,7/24/2019,199,133,332,3,7,2019
15,7/24/2019,154,300,454,3,7,2019
16,7/24/2019,137,171,308,3,7,2019
17,7/24/2019,133,302,435,3,7,2019
18,7/24/2019,54,185,239,3,7,2019
19,7/24/2019,75,217,292,3,7,2019
20,7/24/2019,130,120,250,3,7,2019
21,7/24/2019,347,129,476,3,7,2019
22,7/24/2019,330,149,479,3,7,2019
23,7/24/2019,279,296,575,3,7,2019
0,7/25/2019,288,306,594,4,7,2019
1,7/25/2019,68,90,158,4,7,2019
2,7/25/2019,64,12,76,4,7,2019
3,7/25/2019,82,0,82,4,7,2019
4,7/25/2019,111,0,111,4,7,2019
5,7/25/2019,300,0,300,4,7,2019
6,7/25/2019,320,68,388,4,7,2019
7,7/25/2019,386,353,739,4,7,2019
8,7/25/2019,295,408,703,4,7,2019
9,7/25/2019,216,406,622,4,7,2019
10,7/25/2019,268,237,505,4,7,2019
11,7/25/2019,153,266,419,4,7,2019
12,7/25/2019,175,273,448,4,7,2019
13,7/25/2019,200,221,421,4,7,2019
14,7/25/2019,210,178,388,4,7,2019
15,7/25/2019,150,67,217,4,7,2019
16,7/25/2019,204,378,582,4,7,2019
17,7/25/2019,141,186,327,4,7,2019
18,7/25/2019,57,255,312,4,7,2019
19,7/25/2019,50,251,301,4,7,2019
20,7/25/2019,153,109,262,4,7,2019
21,7/25/2019,403,253,656,4,7,2019
22,7/25/2019,379,165,544,4,7,2019
23,7/25/2019,354,247,601,4,7,2019
0,7/26/2019,301,304,605,5,7,2019
1,7/26/2019,30,107,137,5,7,2019
2,7/26/2019,48,71,119,5,7,2019
3,7/26/2019,100,6,106,5,7,2019
4,7/26/2019,144,0,144,5,7,2019
5,7/26/2019,209,2,211,5,7,2019
6,7/26/2019,353,67,420,5,7,2019
7,7/26/2019,378,297,675,5,7,2019
8,7/26/2019,253,372,625,5,7,2019
9,7/26/2019,175,337,512,5,7,2019
10,7/26/2019,214,211,425,5,7,2019
11,7/26/2019,172,453,625,5,7,2019
12,7/26/2019,151,68,219,5,7,2019
13,7/26/2019,173,114,287,5,7,2019
14,7/26/2019,191,233,424,5,7,2019
15,7/26/2019,161,236,397,5,7,2019
16,7/26/2019,174,234,408,5,7,2019
17,7/26/2019,162,385,547,5,7,2019
18,7/26/2019,90,212,302,5,7,2019
19,7/26/2019,78,152,230,5,7,2019
20,7/26/2019,110,161,271,5,7,2019
21,7/26/2019,377,192,569,5,7,2019
22,7/26/2019,376,164,540,5,7,2019
23,7/26/2019,341,297,638,5,7,2019
0,7/27/2019,201,323,524,6,7,2019
1,7/27/2019,85,199,284,6,7,2019
2,7/27/2019,32,0,32,6,7,2019
3,7/27/2019,97,6,103,6,7,2019
4,7/27/2019,95,15,110,6,7,2019
5,7/27/2019,152,0,152,6,7,2019
6,7/27/2019,260,0,260,6,7,2019
7,7/27/2019,391,6,397,6,7,2019
8,7/27/2019,362,350,712,6,7,2019
9,7/27/2019,183,606,789,6,7,2019
10,7/27/2019,237,417,654,6,7,2019
11,7/27/2019,90,573,663,6,7,2019
12,7/27/2019,146,248,394,6,7,2019
13,7/27/2019,157,53,210,6,7,2019
14,7/27/2019,204,301,505,6,7,2019
15,7/27/2019,259,152,411,6,7,2019
16,7/27/2019,231,278,509,6,7,2019
17,7/27/2019,120,415,535,6,7,2019
18,7/27/2019,71,474,545,6,7,2019
19,7/27/2019,127,211,338,6,7,2019
20,7/27/2019,210,123,333,6,7,2019
21,7/27/2019,286,269,555,6,7,2019
22,7/27/2019,300,248,548,6,7,2019
23,7/27/2019,231,283,514,6,7,2019
0,7/28/2019,97,214,311,7,7,2019
1,7/28/2019,53,234,287,7,7,2019
2,7/28/2019,41,66,107,7,7,2019
3,7/28/2019,138,0,138,7,7,2019
4,7/28/2019,172,0,172,7,7,2019
5,7/28/2019,206,0,206,7,7,2019
6,7/28/2019,303,84,387,7,7,2019
7,7/28/2019,300,467,767,7,7,2019
8,7/28/2019,159,612,771,7,7,2019
9,7/28/2019,193,300,493,7,7,2019
10,7/28/2019,226,158,384,7,7,2019
11,7/28/2019,145,263,408,7,7,2019
12,7/28/2019,186,304,490,7,7,2019
13,7/28/2019,188,163,351,7,7,2019
14,7/28/2019,159,358,517,7,7,2019
15,7/28/2019,232,477,709,7,7,2019
16,7/28/2019,240,242,482,7,7,2019
17,7/28/2019,230,298,528,7,7,2019
18,7/28/2019,91,195,286,7,7,2019
19,7/28/2019,93,569,662,7,7,2019
20,7/28/2019,119,21,140,7,7,2019
21,7/28/2019,263,187,450,7,7,2019
22,7/28/2019,289,408,697,7,7,2019
23,7/28/2019,176,393,569,7,7,2019
0,7/29/2019,102,252,354,1,7,2019
1,7/29/2019,35,219,254,1,7,2019
2,7/29/2019,24,50,74,1,7,2019
3,7/29/2019,68,12,80,1,7,2019
4,7/29/2019,67,6,73,1,7,2019
5,7/29/2019,156,19,175,1,7,2019
6,7/29/2019,274,137,411,1,7,2019
7,7/29/2019,332,374,706,1,7,2019
8,7/29/2019,258,437,695,1,7,2019
9,7/29/2019,251,453,704,1,7,2019
10,7/29/2019,160,188,348,1,7,2019
11,7/29/2019,97,324,421,1,7,2019
12,7/29/2019,185,151,336,1,7,2019
13,7/29/2019,175,131,306,1,7,2019
14,7/29/2019,221,283,504,1,7,2019
15,7/29/2019,190,407,597,1,7,2019
16,7/29/2019,177,66,243,1,7,2019
17,7/29/2019,161,338,499,1,7,2019
18,7/29/2019,108,307,415,1,7,2019
19,7/29/2019,66,398,464,1,7,2019
20,7/29/2019,105,218,323,1,7,2019
21,7/29/2019,236,253,489,1,7,2019
22,7/29/2019,267,223,490,1,7,2019
23,7/29/2019,179,354,533,1,7,2019
0,7/30/2019,89,341,430,2,7,2019
1,7/30/2019,51,166,217,2,7,2019
2,7/30/2019,58,225,283,2,7,2019
3,7/30/2019,90,0,90,2,7,2019
4,7/30/2019,43,0,43,2,7,2019
5,7/30/2019,162,9,171,2,7,2019
6,7/30/2019,348,61,409,2,7,2019
7,7/30/2019,258,380,638,2,7,2019
8,7/30/2019,177,376,553,2,7,2019
9,7/30/2019,233,461,694,2,7,2019
10,7/30/2019,193,123,316,2,7,2019
11,7/30/2019,189,492,681,2,7,2019
12,7/30/2019,212,272,484,2,7,2019
13,7/30/2019,236,314,550,2,7,2019
14,7/30/2019,140,184,324,2,7,2019
15,7/30/2019,184,292,476,2,7,2019
16,7/30/2019,166,254,420,2,7,2019
17,7/30/2019,123,287,410,2,7,2019
18,7/30/2019,76,165,241,2,7,2019
19,7/30/2019,86,230,316,2,7,2019
20,7/30/2019,136,215,351,2,7,2019
21,7/30/2019,331,382,713,2,7,2019
22,7/30/2019,300,348,648,2,7,2019
23,7/30/2019,208,176,384,2,7,2019
0,7/31/2019,65,156,221,3,7,2019
1,7/31/2019,21,97,118,3,7,2019
2,7/31/2019,34,38,72,3,7,2019
3,7/31/2019,52,28,80,3,7,2019
4,7/31/2019,92,0,92,3,7,2019
5,7/31/2019,129,3,132,3,7,2019
6,7/31/2019,281,47,328,3,7,2019
7,7/31/2019,276,234,510,3,7,2019
8,7/31/2019,245,607,852,3,7,2019
9,7/31/2019,189,331,520,3,7,2019
10,7/31/2019,241,233,474,3,7,2019
11,7/31/2019,164,212,376,3,7,2019
12,7/31/2019,149,316,465,3,7,2019
13,7/31/2019,229,90,319,3,7,2019
14,7/31/2019,174,349,523,3,7,2019
15,7/31/2019,143,160,303,3,7,2019
16,7/31/2019,173,188,361,3,7,2019
17,7/31/2019,132,224,356,3,7,2019
18,7/31/2019,82,251,333,3,7,2019
19,7/31/2019,89,135,224,3,7,2019
20,7/31/2019,186,107,293,3,7,2019
21,7/31/2019,311,185,496,3,7,2019
22,7/31/2019,379,222,601,3,7,2019
23,7/31/2019,282,359,641,3,7,2019
0,8/1/2019,162,319,481,4,8,2019
1,8/1/2019,39,245,284,4,8,2019
2,8/1/2019,42,35,77,4,8,2019
3,8/1/2019,120,0,120,4,8,2019
4,8/1/2019,122,0,122,4,8,2019
5,8/1/2019,267,0,267,4,8,2019
6,8/1/2019,300,83,383,4,8,2019
7,8/1/2019,330,393,723,4,8,2019
8,8/1/2019,288,360,648,4,8,2019
9,8/1/2019,253,427,680,4,8,2019
10,8/1/2019,249,116,365,4,8,2019
11,8/1/2019,102,413,515,4,8,2019
12,8/1/2019,147,213,360,4,8,2019
13,8/1/2019,176,106,282,4,8,2019
14,8/1/2019,216,207,423,4,8,2019
15,8/1/2019,217,300,517,4,8,2019
16,8/1/2019,49,0,49,4,8,2019
17,8/1/2019,74,3,77,4,8,2019
18,8/1/2019,19,0,19,4,8,2019
19,8/1/2019,73,209,282,4,8,2019
20,8/1/2019,167,82,249,4,8,2019
21,8/1/2019,351,229,580,4,8,2019
22,8/1/2019,314,212,526,4,8,2019
23,8/1/2019,367,372,739,4,8,2019
0,8/2/2019,134,253,387,5,8,2019
1,8/2/2019,34,252,286,5,8,2019
2,8/2/2019,45,10,55,5,8,2019
3,8/2/2019,84,0,84,5,8,2019
4,8/2/2019,167,0,167,5,8,2019
5,8/2/2019,208,1,209,5,8,2019
6,8/2/2019,290,79,369,5,8,2019
7,8/2/2019,244,295,539,5,8,2019
8,8/2/2019,207,362,569,5,8,2019
9,8/2/2019,158,407,565,5,8,2019
10,8/2/2019,167,134,301,5,8,2019
11,8/2/2019,176,386,562,5,8,2019
12,8/2/2019,161,197,358,5,8,2019
13,8/2/2019,148,159,307,5,8,2019
14,8/2/2019,196,371,567,5,8,2019
15,8/2/2019,157,173,330,5,8,2019
16,8/2/2019,173,178,351,5,8,2019
17,8/2/2019,117,274,391,5,8,2019
18,8/2/2019,75,285,360,5,8,2019
19,8/2/2019,64,243,307,5,8,2019
20,8/2/2019,189,232,421,5,8,2019
21,8/2/2019,372,343,715,5,8,2019
22,8/2/2019,345,169,514,5,8,2019
23,8/2/2019,303,448,751,5,8,2019
0,8/3/2019,159,232,391,6,8,2019
1,8/3/2019,29,85,114,6,8,2019
2,8/3/2019,64,3,67,6,8,2019
3,8/3/2019,92,4,96,6,8,2019
4,8/3/2019,64,76,140,6,8,2019
5,8/3/2019,121,0,121,6,8,2019
6,8/3/2019,320,24,344,6,8,2019
7,8/3/2019,282,305,587,6,8,2019
8,8/3/2019,322,600,922,6,8,2019
9,8/3/2019,301,406,707,6,8,2019
10,8/3/2019,183,294,477,6,8,2019
11,8/3/2019,96,340,436,6,8,2019
12,8/3/2019,198,148,346,6,8,2019
13,8/3/2019,136,235,371,6,8,2019
14,8/3/2019,182,258,440,6,8,2019
15,8/3/2019,191,198,389,6,8,2019
16,8/3/2019,229,330,559,6,8,2019
17,8/3/2019,170,297,467,6,8,2019
18,8/3/2019,69,291,360,6,8,2019
19,8/3/2019,120,201,321,6,8,2019
20,8/3/2019,166,149,315,6,8,2019
21,8/3/2019,278,304,582,6,8,2019
22,8/3/2019,282,120,402,6,8,2019
23,8/3/2019,148,291,439,6,8,2019
0,8/4/2019,118,370,488,7,8,2019
1,8/4/2019,20,228,248,7,8,2019
2,8/4/2019,41,0,41,7,8,2019
3,8/4/2019,103,0,103,7,8,2019
4,8/4/2019,122,0,122,7,8,2019
5,8/4/2019,127,0,127,7,8,2019
6,8/4/2019,218,0,218,7,8,2019
7,8/4/2019,222,63,285,7,8,2019
8,8/4/2019,186,613,799,7,8,2019
9,8/4/2019,172,674,846,7,8,2019
10,8/4/2019,247,167,414,7,8,2019
11,8/4/2019,184,344,528,7,8,2019
12,8/4/2019,172,306,478,7,8,2019
13,8/4/2019,173,96,269,7,8,2019
14,8/4/2019,168,210,378,7,8,2019
15,8/4/2019,146,421,567,7,8,2019
16,8/4/2019,191,279,470,7,8,2019
17,8/4/2019,215,241,456,7,8,2019
18,8/4/2019,91,277,368,7,8,2019
19,8/4/2019,60,546,606,7,8,2019
20,8/4/2019,170,90,260,7,8,2019
21,8/4/2019,244,281,525,7,8,2019
22,8/4/2019,255,295,550,7,8,2019
23,8/4/2019,190,496,686,7,8,2019
0,8/5/2019,80,319,399,1,8,2019
1,8/5/2019,37,3,40,1,8,2019
2,8/5/2019,29,34,63,1,8,2019
3,8/5/2019,85,0,85,1,8,2019
4,8/5/2019,75,0,75,1,8,2019
5,8/5/2019,108,0,108,1,8,2019
6,8/5/2019,249,0,249,1,8,2019
7,8/5/2019,220,4,224,1,8,2019
8,8/5/2019,155,407,562,1,8,2019
9,8/5/2019,158,554,712,1,8,2019
10,8/5/2019,182,423,605,1,8,2019
11,8/5/2019,115,223,338,1,8,2019
12,8/5/2019,150,99,249,1,8,2019
13,8/5/2019,112,142,254,1,8,2019
14,8/5/2019,164,252,416,1,8,2019
15,8/5/2019,169,431,600,1,8,2019
16,8/5/2019,170,340,510,1,8,2019
17,8/5/2019,126,191,317,1,8,2019
18,8/5/2019,76,178,254,1,8,2019
19,8/5/2019,36,322,358,1,8,2019
20,8/5/2019,77,238,315,1,8,2019
21,8/5/2019,166,246,412,1,8,2019
22,8/5/2019,205,206,411,1,8,2019
23,8/5/2019,211,356,567,1,8,2019
0,8/6/2019,65,278,343,2,8,2019
1,8/6/2019,30,185,215,2,8,2019
2,8/6/2019,48,35,83,2,8,2019
3,8/6/2019,81,64,145,2,8,2019
4,8/6/2019,91,12,103,2,8,2019
5,8/6/2019,142,14,156,2,8,2019
6,8/6/2019,251,96,347,2,8,2019
7,8/6/2019,203,341,544,2,8,2019
8,8/6/2019,205,358,563,2,8,2019
9,8/6/2019,183,275,458,2,8,2019
10,8/6/2019,175,283,458,2,8,2019
11,8/6/2019,173,433,606,2,8,2019
12,8/6/2019,217,256,473,2,8,2019
13,8/6/2019,171,152,323,2,8,2019
14,8/6/2019,153,387,540,2,8,2019
15,8/6/2019,147,160,307,2,8,2019
16,8/6/2019,128,244,372,2,8,2019
17,8/6/2019,82,407,489,2,8,2019
18,8/6/2019,52,114,166,2,8,2019
19,8/6/2019,77,320,397,2,8,2019
20,8/6/2019,115,228,343,2,8,2019
21,8/6/2019,226,361,587,2,8,2019
22,8/6/2019,301,177,478,2,8,2019
23,8/6/2019,138,129,267,2,8,2019
0,8/7/2019,82,199,281,3,8,2019
1,8/7/2019,27,284,311,3,8,2019
2,8/7/2019,22,92,114,3,8,2019
3,8/7/2019,85,15,100,3,8,2019
4,8/7/2019,68,0,68,3,8,2019
5,8/7/2019,154,0,154,3,8,2019
6,8/7/2019,206,132,338,3,8,2019
7,8/7/2019,188,405,593,3,8,2019
8,8/7/2019,202,221,423,3,8,2019
9,8/7/2019,206,270,476,3,8,2019
10,8/7/2019,196,174,370,3,8,2019
11,8/7/2019,115,205,320,3,8,2019
12,8/7/2019,120,179,299,3,8,2019
13,8/7/2019,162,323,485,3,8,2019
14,8/7/2019,160,298,458,3,8,2019
15,8/7/2019,94,209,303,3,8,2019
16,8/7/2019,139,225,364,3,8,2019
17,8/7/2019,116,254,370,3,8,2019
18,8/7/2019,78,244,322,3,8,2019
19,8/7/2019,56,61,117,3,8,2019
20,8/7/2019,86,65,151,3,8,2019
21,8/7/2019,276,190,466,3,8,2019
22,8/7/2019,245,175,420,3,8,2019
23,8/7/2019,232,318,550,3,8,2019
0,8/8/2019,155,409,564,4,8,2019
1,8/8/2019,27,89,116,4,8,2019
2,8/8/2019,27,63,90,4,8,2019
3,8/8/2019,59,78,137,4,8,2019
4,8/8/2019,76,3,79,4,8,2019
5,8/8/2019,274,38,312,4,8,2019
6,8/8/2019,364,68,432,4,8,2019
7,8/8/2019,267,323,590,4,8,2019
8,8/8/2019,210,129,339,4,8,2019
9,8/8/2019,169,502,671,4,8,2019
10,8/8/2019,287,177,464,4,8,2019
11,8/8/2019,131,264,395,4,8,2019
12,8/8/2019,175,268,443,4,8,2019
13,8/8/2019,144,191,335,4,8,2019
14,8/8/2019,129,167,296,4,8,2019
15,8/8/2019,180,210,390,4,8,2019
16,8/8/2019,188,356,544,4,8,2019
17,8/8/2019,109,248,357,4,8,2019
18,8/8/2019,67,328,395,4,8,2019
19,8/8/2019,63,137,200,4,8,2019
20,8/8/2019,118,214,332,4,8,2019
21,8/8/2019,305,138,443,4,8,2019
22,8/8/2019,348,210,558,4,8,2019
23,8/8/2019,249,205,454,4,8,2019
0,8/9/2019,111,402,513,5,8,2019
1,8/9/2019,23,204,227,5,8,2019
2,8/9/2019,38,27,65,5,8,2019
3,8/9/2019,66,0,66,5,8,2019
4,8/9/2019,99,0,99,5,8,2019
5,8/9/2019,194,0,194,5,8,2019
6,8/9/2019,273,55,328,5,8,2019
7,8/9/2019,201,243,444,5,8,2019
8,8/9/2019,203,311,514,5,8,2019
9,8/9/2019,175,253,428,5,8,2019
10,8/9/2019,172,265,437,5,8,2019
11,8/9/2019,82,372,454,5,8,2019
12,8/9/2019,157,122,279,5,8,2019
13,8/9/2019,143,109,252,5,8,2019
14,8/9/2019,179,329,508,5,8,2019
15,8/9/2019,158,200,358,5,8,2019
16,8/9/2019,166,348,514,5,8,2019
17,8/9/2019,157,255,412,5,8,2019
18,8/9/2019,93,221,314,5,8,2019
19,8/9/2019,82,135,217,5,8,2019
20,8/9/2019,145,182,327,5,8,2019
21,8/9/2019,307,322,629,5,8,2019
22,8/9/2019,302,172,474,5,8,2019
23,8/9/2019,263,285,548,5,8,2019
0,8/10/2019,179,357,536,6,8,2019
1,8/10/2019,27,35,62,6,8,2019
2,8/10/2019,55,0,55,6,8,2019
3,8/10/2019,80,11,91,6,8,2019
4,8/10/2019,62,2,64,6,8,2019
5,8/10/2019,132,2,134,6,8,2019
6,8/10/2019,309,0,309,6,8,2019
7,8/10/2019,318,259,577,6,8,2019
8,8/10/2019,334,652,986,6,8,2019
9,8/10/2019,194,336,530,6,8,2019
10,8/10/2019,87,285,372,6,8,2019
11,8/10/2019,76,264,340,6,8,2019
12,8/10/2019,143,72,215,6,8,2019
13,8/10/2019,133,132,265,6,8,2019
14,8/10/2019,138,231,369,6,8,2019
15,8/10/2019,196,334,530,6,8,2019
16,8/10/2019,237,159,396,6,8,2019
17,8/10/2019,171,441,612,6,8,2019
18,8/10/2019,50,192,242,6,8,2019
19,8/10/2019,71,261,332,6,8,2019
20,8/10/2019,133,225,358,6,8,2019
21,8/10/2019,224,181,405,6,8,2019
22,8/10/2019,201,384,585,6,8,2019
23,8/10/2019,153,338,491,6,8,2019
0,8/11/2019,95,286,381,7,8,2019
1,8/11/2019,18,136,154,7,8,2019
2,8/11/2019,34,0,34,7,8,2019
3,8/11/2019,49,0,49,7,8,2019
4,8/11/2019,120,0,120,7,8,2019
5,8/11/2019,220,2,222,7,8,2019
6,8/11/2019,259,124,383,7,8,2019
7,8/11/2019,180,574,754,7,8,2019
8,8/11/2019,143,427,570,7,8,2019
9,8/11/2019,173,349,522,7,8,2019
10,8/11/2019,208,117,325,7,8,2019
11,8/11/2019,98,271,369,7,8,2019
12,8/11/2019,130,269,399,7,8,2019
13,8/11/2019,156,93,249,7,8,2019
14,8/11/2019,129,514,643,7,8,2019
15,8/11/2019,121,300,421,7,8,2019
16,8/11/2019,200,241,441,7,8,2019
17,8/11/2019,179,210,389,7,8,2019
18,8/11/2019,107,328,435,7,8,2019
19,8/11/2019,66,425,491,7,8,2019
20,8/11/2019,181,330,511,7,8,2019
21,8/11/2019,223,67,290,7,8,2019
22,8/11/2019,169,296,465,7,8,2019
23,8/11/2019,90,575,665,7,8,2019
0,8/12/2019,88,339,427,1,8,2019
1,8/12/2019,29,79,108,1,8,2019
2,8/12/2019,8,19,27,1,8,2019
3,8/12/2019,37,19,56,1,8,2019
4,8/12/2019,63,0,63,1,8,2019
5,8/12/2019,99,11,110,1,8,2019
6,8/12/2019,215,164,379,1,8,2019
7,8/12/2019,158,408,566,1,8,2019
8,8/12/2019,132,348,480,1,8,2019
9,8/12/2019,133,324,457,1,8,2019
10,8/12/2019,108,141,249,1,8,2019
11,8/12/2019,82,246,328,1,8,2019
12,8/12/2019,101,215,316,1,8,2019
13,8/12/2019,184,41,225,1,8,2019
14,8/12/2019,140,359,499,1,8,2019
15,8/12/2019,130,307,437,1,8,2019
16,8/12/2019,172,164,336,1,8,2019
17,8/12/2019,121,476,597,1,8,2019
18,8/12/2019,78,251,329,1,8,2019
19,8/12/2019,36,264,300,1,8,2019
20,8/12/2019,81,182,263,1,8,2019
21,8/12/2019,165,169,334,1,8,2019
22,8/12/2019,175,230,405,1,8,2019
23,8/12/2019,122,329,451,1,8,2019
0,8/13/2019,46,276,322,2,8,2019
1,8/13/2019,18,87,105,2,8,2019
2,8/13/2019,51,0,51,2,8,2019
3,8/13/2019,85,13,98,2,8,2019
4,8/13/2019,26,0,26,2,8,2019
5,8/13/2019,105,1,106,2,8,2019
6,8/13/2019,253,107,360,2,8,2019
7,8/13/2019,178,325,503,2,8,2019
8,8/13/2019,147,255,402,2,8,2019
9,8/13/2019,161,547,708,2,8,2019
10,8/13/2019,164,172,336,2,8,2019
11,8/13/2019,140,441,581,2,8,2019
12,8/13/2019,172,219,391,2,8,2019
13,8/13/2019,149,202,351,2,8,2019
14,8/13/2019,128,192,320,2,8,2019
15,8/13/2019,110,251,361,2,8,2019
16,8/13/2019,119,190,309,2,8,2019
17,8/13/2019,96,298,394,2,8,2019
18,8/13/2019,28,222,250,2,8,2019
19,8/13/2019,36,195,231,2,8,2019
20,8/13/2019,114,76,190,2,8,2019
21,8/13/2019,190,410,600,2,8,2019
22,8/13/2019,239,299,538,2,8,2019
23,8/13/2019,157,188,345,2,8,2019
0,8/14/2019,55,155,210,3,8,2019
1,8/14/2019,35,130,165,3,8,2019
2,8/14/2019,18,2,20,3,8,2019
3,8/14/2019,51,52,103,3,8,2019
4,8/14/2019,82,0,82,3,8,2019
5,8/14/2019,106,1,107,3,8,2019
6,8/14/2019,229,51,280,3,8,2019
7,8/14/2019,143,1,144,3,8,2019
8,8/14/2019,201,13,214,3,8,2019
9,8/14/2019,190,344,534,3,8,2019
10,8/14/2019,158,443,601,3,8,2019
11,8/14/2019,87,465,552,3,8,2019
12,8/14/2019,143,287,430,3,8,2019
13,8/14/2019,118,118,236,3,8,2019
14,8/14/2019,159,234,393,3,8,2019
15,8/14/2019,66,239,305,3,8,2019
16,8/14/2019,111,242,353,3,8,2019
17,8/14/2019,117,167,284,3,8,2019
18,8/14/2019,41,222,263,3,8,2019
19,8/14/2019,27,314,341,3,8,2019
20,8/14/2019,100,111,211,3,8,2019
21,8/14/2019,216,262,478,3,8,2019
22,8/14/2019,232,152,384,3,8,2019
23,8/14/2019,175,194,369,3,8,2019
0,8/15/2019,125,333,458,4,8,2019
1,8/15/2019,15,17,32,4,8,2019
2,8/15/2019,50,16,66,4,8,2019
3,8/15/2019,62,0,62,4,8,2019
4,8/15/2019,91,0,91,4,8,2019
5,8/15/2019,210,0,210,4,8,2019
6,8/15/2019,286,0,286,4,8,2019
7,8/15/2019,217,0,217,4,8,2019
8,8/15/2019,195,8,203,4,8,2019
9,8/15/2019,178,525,703,4,8,2019
10,8/15/2019,250,564,814,4,8,2019
11,8/15/2019,75,262,337,4,8,2019
12,8/15/2019,131,205,336,4,8,2019
13,8/15/2019,134,119,253,4,8,2019
14,8/15/2019,112,94,206,4,8,2019
15,8/15/2019,110,113,223,4,8,2019
16,8/15/2019,157,311,468,4,8,2019
17,8/15/2019,117,273,390,4,8,2019
18,8/15/2019,55,209,264,4,8,2019
19,8/15/2019,43,176,219,4,8,2019
20,8/15/2019,104,83,187,4,8,2019
21,8/15/2019,304,215,519,4,8,2019
22,8/15/2019,295,165,460,4,8,2019
23,8/15/2019,175,189,364,4,8,2019
0,8/16/2019,85,190,275,5,8,2019
1,8/16/2019,45,276,321,5,8,2019
2,8/16/2019,42,37,79,5,8,2019
3,8/16/2019,60,9,69,5,8,2019
4,8/16/2019,134,6,140,5,8,2019
5,8/16/2019,134,0,134,5,8,2019
6,8/16/2019,277,15,292,5,8,2019
7,8/16/2019,195,171,366,5,8,2019
8,8/16/2019,163,318,481,5,8,2019
9,8/16/2019,141,402,543,5,8,2019
10,8/16/2019,127,120,247,5,8,2019
11,8/16/2019,77,357,434,5,8,2019
12,8/16/2019,120,136,256,5,8,2019
13,8/16/2019,89,64,153,5,8,2019
14,8/16/2019,146,321,467,5,8,2019
15,8/16/2019,117,120,237,5,8,2019
16,8/16/2019,134,218,352,5,8,2019
17,8/16/2019,131,223,354,5,8,2019
18,8/16/2019,77,132,209,5,8,2019
19,8/16/2019,40,236,276,5,8,2019
20,8/16/2019,109,139,248,5,8,2019
21,8/16/2019,259,284,543,5,8,2019
22,8/16/2019,241,134,375,5,8,2019
23,8/16/2019,215,263,478,5,8,2019
0,8/17/2019,169,254,423,6,8,2019
1,8/17/2019,39,0,39,6,8,2019
2,8/17/2019,24,0,24,6,8,2019
3,8/17/2019,73,2,75,6,8,2019
4,8/17/2019,48,1,49,6,8,2019
5,8/17/2019,90,0,90,6,8,2019
6,8/17/2019,231,9,240,6,8,2019
7,8/17/2019,248,296,544,6,8,2019
8,8/17/2019,238,600,838,6,8,2019
9,8/17/2019,183,482,665,6,8,2019
10,8/17/2019,156,128,284,6,8,2019
11,8/17/2019,53,241,294,6,8,2019
12,8/17/2019,111,120,231,6,8,2019
13,8/17/2019,152,133,285,6,8,2019
14,8/17/2019,167,261,428,6,8,2019
15,8/17/2019,203,201,404,6,8,2019
16,8/17/2019,162,284,446,6,8,2019
17,8/17/2019,100,277,377,6,8,2019
18,8/17/2019,47,156,203,6,8,2019
19,8/17/2019,39,302,341,6,8,2019
20,8/17/2019,104,158,262,6,8,2019
21,8/17/2019,207,349,556,6,8,2019
22,8/17/2019,161,133,294,6,8,2019
23,8/17/2019,147,213,360,6,8,2019
0,8/18/2019,49,248,297,7,8,2019
1,8/18/2019,12,91,103,7,8,2019
2,8/18/2019,29,0,29,7,8,2019
3,8/18/2019,96,0,96,7,8,2019
4,8/18/2019,106,0,106,7,8,2019
5,8/18/2019,180,0,180,7,8,2019
6,8/18/2019,203,50,253,7,8,2019
7,8/18/2019,140,474,614,7,8,2019
8,8/18/2019,115,453,568,7,8,2019
9,8/18/2019,132,257,389,7,8,2019
10,8/18/2019,191,79,270,7,8,2019
11,8/18/2019,134,350,484,7,8,2019
12,8/18/2019,153,264,417,7,8,2019
13,8/18/2019,155,311,466,7,8,2019
14,8/18/2019,97,393,490,7,8,2019
15,8/18/2019,85,272,357,7,8,2019
16,8/18/2019,146,280,426,7,8,2019
17,8/18/2019,159,156,315,7,8,2019
18,8/18/2019,68,281,349,7,8,2019
19,8/18/2019,37,313,350,7,8,2019
20,8/18/2019,105,168,273,7,8,2019
21,8/18/2019,160,95,255,7,8,2019
22,8/18/2019,224,110,334,7,8,2019
23,8/18/2019,137,513,650,7,8,2019
0,8/19/2019,82,386,468,1,8,2019
1,8/19/2019,42,115,157,1,8,2019
2,8/19/2019,16,0,16,1,8,2019
3,8/19/2019,47,19,66,1,8,2019
4,8/19/2019,54,0,54,1,8,2019
5,8/19/2019,105,12,117,1,8,2019
6,8/19/2019,239,138,377,1,8,2019
7,8/19/2019,171,384,555,1,8,2019
8,8/19/2019,129,222,351,1,8,2019
9,8/19/2019,151,288,439,1,8,2019
10,8/19/2019,121,72,193,1,8,2019
11,8/19/2019,83,303,386,1,8,2019
12,8/19/2019,109,41,150,1,8,2019
13,8/19/2019,102,117,219,1,8,2019
14,8/19/2019,104,338,442,1,8,2019
15,8/19/2019,161,238,399,1,8,2019
16,8/19/2019,91,166,257,1,8,2019
17,8/19/2019,113,252,365,1,8,2019
18,8/19/2019,37,182,219,1,8,2019
19,8/19/2019,47,317,364,1,8,2019
20,8/19/2019,79,183,262,1,8,2019
21,8/19/2019,161,81,242,1,8,2019
22,8/19/2019,155,187,342,1,8,2019
23,8/19/2019,124,293,417,1,8,2019
0,8/20/2019,47,284,331,2,8,2019
1,8/20/2019,16,65,81,2,8,2019
2,8/20/2019,44,0,44,2,8,2019
3,8/20/2019,56,0,56,2,8,2019
4,8/20/2019,42,1,43,2,8,2019
5,8/20/2019,102,0,102,2,8,2019
6,8/20/2019,184,92,276,2,8,2019
7,8/20/2019,184,42,226,2,8,2019
8,8/20/2019,134,1,135,2,8,2019
9,8/20/2019,151,59,210,2,8,2019
10,8/20/2019,126,212,338,2,8,2019
11,8/20/2019,122,559,681,2,8,2019
12,8/20/2019,140,528,668,2,8,2019
13,8/20/2019,122,356,478,2,8,2019
14,8/20/2019,119,174,293,2,8,2019
15,8/20/2019,103,144,247,2,8,2019
16,8/20/2019,145,108,253,2,8,2019
17,8/20/2019,107,368,475,2,8,2019
18,8/20/2019,68,131,199,2,8,2019
19,8/20/2019,16,244,260,2,8,2019
20,8/20/2019,78,195,273,2,8,2019
21,8/20/2019,183,175,358,2,8,2019
22,8/20/2019,190,76,266,2,8,2019
23,8/20/2019,90,176,266,2,8,2019
0,8/21/2019,51,279,330,3,8,2019
1,8/21/2019,9,125,134,3,8,2019
2,8/21/2019,27,14,41,3,8,2019
3,8/21/2019,51,34,85,3,8,2019
4,8/21/2019,77,0,77,3,8,2019
5,8/21/2019,100,0,100,3,8,2019
6,8/21/2019,210,2,212,3,8,2019
7,8/21/2019,142,197,339,3,8,2019
8,8/21/2019,176,301,477,3,8,2019
9,8/21/2019,110,384,494,3,8,2019
10,8/21/2019,135,182,317,3,8,2019
11,8/21/2019,86,233,319,3,8,2019
12,8/21/2019,123,166,289,3,8,2019
13,8/21/2019,113,71,184,3,8,2019
14,8/21/2019,101,254,355,3,8,2019
15,8/21/2019,103,178,281,3,8,2019
16,8/21/2019,117,278,395,3,8,2019
17,8/21/2019,85,116,201,3,8,2019
18,8/21/2019,36,108,144,3,8,2019
19,8/21/2019,27,108,135,3,8,2019
20,8/21/2019,109,69,178,3,8,2019
21,8/21/2019,182,334,516,3,8,2019
22,8/21/2019,234,113,347,3,8,2019
23,8/21/2019,152,216,368,3,8,2019
0,8/22/2019,103,172,275,4,8,2019
1,8/22/2019,18,51,69,4,8,2019
2,8/22/2019,44,0,44,4,8,2019
3,8/22/2019,69,0,69,4,8,2019
4,8/22/2019,85,5,90,4,8,2019
5,8/22/2019,184,0,184,4,8,2019
6,8/22/2019,306,118,424,4,8,2019
7,8/22/2019,230,207,437,4,8,2019
8,8/22/2019,168,305,473,4,8,2019
9,8/22/2019,113,495,608,4,8,2019
10,8/22/2019,119,71,190,4,8,2019
11,8/22/2019,112,213,325,4,8,2019
12,8/22/2019,86,205,291,4,8,2019
13,8/22/2019,170,34,204,4,8,2019
14,8/22/2019,127,200,327,4,8,2019
15,8/22/2019,138,183,321,4,8,2019
16,8/22/2019,141,121,262,4,8,2019
17,8/22/2019,140,352,492,4,8,2019
18,8/22/2019,45,164,209,4,8,2019
19,8/22/2019,39,133,172,4,8,2019
20,8/22/2019,90,136,226,4,8,2019
21,8/22/2019,236,199,435,4,8,2019
22,8/22/2019,281,139,420,4,8,2019
23,8/22/2019,251,165,416,4,8,2019
0,8/23/2019,69,213,282,5,8,2019
1,8/23/2019,47,144,191,5,8,2019
2,8/23/2019,18,0,18,5,8,2019
3,8/23/2019,60,0,60,5,8,2019
4,8/23/2019,94,0,94,5,8,2019
5,8/23/2019,179,4,183,5,8,2019
6,8/23/2019,273,108,381,5,8,2019
7,8/23/2019,182,160,342,5,8,2019
8,8/23/2019,185,326,511,5,8,2019
9,8/23/2019,115,312,427,5,8,2019
10,8/23/2019,112,138,250,5,8,2019
11,8/23/2019,109,180,289,5,8,2019
12,8/23/2019,121,193,314,5,8,2019
13,8/23/2019,108,73,181,5,8,2019
14,8/23/2019,119,207,326,5,8,2019
15,8/23/2019,95,149,244,5,8,2019
16,8/23/2019,93,270,363,5,8,2019
17,8/23/2019,100,240,340,5,8,2019
18,8/23/2019,58,164,222,5,8,2019
19,8/23/2019,28,158,186,5,8,2019
20,8/23/2019,107,55,162,5,8,2019
21,8/23/2019,253,242,495,5,8,2019
22,8/23/2019,285,165,450,5,8,2019
23,8/23/2019,192,223,415,5,8,2019
0,8/24/2019,154,89,243,6,8,2019
1,8/24/2019,45,109,154,6,8,2019
2,8/24/2019,47,36,83,6,8,2019
3,8/24/2019,78,0,78,6,8,2019
4,8/24/2019,48,1,49,6,8,2019
5,8/24/2019,156,0,156,6,8,2019
6,8/24/2019,193,39,232,6,8,2019
7,8/24/2019,256,216,472,6,8,2019
8,8/24/2019,265,487,752,6,8,2019
9,8/24/2019,162,312,474,6,8,2019
10,8/24/2019,182,190,372,6,8,2019
11,8/24/2019,41,238,279,6,8,2019
12,8/24/2019,153,76,229,6,8,2019
13,8/24/2019,211,150,361,6,8,2019
14,8/24/2019,130,187,317,6,8,2019
15,8/24/2019,131,205,336,6,8,2019
16,8/24/2019,160,262,422,6,8,2019
17,8/24/2019,112,111,223,6,8,2019
18,8/24/2019,44,206,250,6,8,2019
19,8/24/2019,49,196,245,6,8,2019
20,8/24/2019,104,267,371,6,8,2019
21,8/24/2019,182,170,352,6,8,2019
22,8/24/2019,186,157,343,6,8,2019
23,8/24/2019,141,219,360,6,8,2019
0,8/25/2019,71,82,153,7,8,2019
1,8/25/2019,31,76,107,7,8,2019
2,8/25/2019,32,0,32,7,8,2019
3,8/25/2019,59,3,62,7,8,2019
4,8/25/2019,111,0,111,7,8,2019
5,8/25/2019,177,3,180,7,8,2019
6,8/25/2019,205,49,254,7,8,2019
7,8/25/2019,182,344,526,7,8,2019
8,8/25/2019,105,454,559,7,8,2019
9,8/25/2019,172,206,378,7,8,2019
10,8/25/2019,145,55,200,7,8,2019
11,8/25/2019,120,216,336,7,8,2019
12,8/25/2019,209,213,422,7,8,2019
13,8/25/2019,145,204,349,7,8,2019
14,8/25/2019,126,335,461,7,8,2019
15,8/25/2019,164,176,340,7,8,2019
16,8/25/2019,169,124,293,7,8,2019
17,8/25/2019,182,426,608,7,8,2019
18,8/25/2019,98,256,354,7,8,2019
19,8/25/2019,43,235,278,7,8,2019
20,8/25/2019,74,205,279,7,8,2019
21,8/25/2019,198,237,435,7,8,2019
22,8/25/2019,201,239,440,7,8,2019
23,8/25/2019,118,236,354,7,8,2019
0,8/26/2019,66,293,359,1,8,2019
1,8/26/2019,24,49,73,1,8,2019
2,8/26/2019,18,0,18,1,8,2019
3,8/26/2019,46,3,49,1,8,2019
4,8/26/2019,32,0,32,1,8,2019
5,8/26/2019,75,7,82,1,8,2019
6,8/26/2019,183,88,271,1,8,2019
7,8/26/2019,141,244,385,1,8,2019
8,8/26/2019,140,238,378,1,8,2019
9,8/26/2019,101,203,304,1,8,2019
10,8/26/2019,156,157,313,1,8,2019
11,8/26/2019,136,167,303,1,8,2019
12,8/26/2019,124,106,230,1,8,2019
13,8/26/2019,138,92,230,1,8,2019
14,8/26/2019,161,323,484,1,8,2019
15,8/26/2019,159,103,262,1,8,2019
16,8/26/2019,131,323,454,1,8,2019
17,8/26/2019,66,114,180,1,8,2019
18,8/26/2019,58,175,233,1,8,2019
19,8/26/2019,58,81,139,1,8,2019
20,8/26/2019,93,226,319,1,8,2019
21,8/26/2019,206,91,297,1,8,2019
22,8/26/2019,172,291,463,1,8,2019
23,8/26/2019,105,254,359,1,8,2019
0,8/27/2019,38,154,192,2,8,2019
1,8/27/2019,29,44,73,2,8,2019
2,8/27/2019,24,0,24,2,8,2019
3,8/27/2019,62,0,62,2,8,2019
4,8/27/2019,38,1,39,2,8,2019
5,8/27/2019,114,0,114,2,8,2019
6,8/27/2019,210,102,312,2,8,2019
7,8/27/2019,169,205,374,2,8,2019
8,8/27/2019,144,194,338,2,8,2019
9,8/27/2019,128,268,396,2,8,2019
10,8/27/2019,113,126,239,2,8,2019
11,8/27/2019,153,190,343,2,8,2019
12,8/27/2019,134,179,313,2,8,2019
13,8/27/2019,153,82,235,2,8,2019
14,8/27/2019,82,300,382,2,8,2019
15,8/27/2019,112,115,227,2,8,2019
16,8/27/2019,64,175,239,2,8,2019
17,8/27/2019,46,167,213,2,8,2019
18,8/27/2019,32,180,212,2,8,2019
19,8/27/2019,38,122,160,2,8,2019
20,8/27/2019,94,84,178,2,8,2019
21,8/27/2019,210,276,486,2,8,2019
22,8/27/2019,217,74,291,2,8,2019
23,8/27/2019,136,97,233,2,8,2019
0,8/28/2019,83,56,139,3,8,2019
1,8/28/2019,27,22,49,3,8,2019
2,8/28/2019,24,0,24,3,8,2019
3,8/28/2019,75,3,78,3,8,2019
4,8/28/2019,70,0,70,3,8,2019
5,8/28/2019,105,0,105,3,8,2019
6,8/28/2019,236,27,263,3,8,2019
7,8/28/2019,188,253,441,3,8,2019
8,8/28/2019,156,258,414,3,8,2019
9,8/28/2019,169,289,458,3,8,2019
10,8/28/2019,161,64,225,3,8,2019
11,8/28/2019,92,247,339,3,8,2019
12,8/28/2019,113,188,301,3,8,2019
13,8/28/2019,110,37,147,3,8,2019
14,8/28/2019,151,213,364,3,8,2019
15,8/28/2019,86,77,163,3,8,2019
16,8/28/2019,59,239,298,3,8,2019
17,8/28/2019,92,145,237,3,8,2019
18,8/28/2019,33,129,162,3,8,2019
19,8/28/2019,37,126,163,3,8,2019
20,8/28/2019,122,165,287,3,8,2019
21,8/28/2019,307,118,425,3,8,2019
22,8/28/2019,253,92,345,3,8,2019
23,8/28/2019,326,239,565,3,8,2019
0,8/29/2019,203,37,240,4,8,2019
1,8/29/2019,9,3,12,4,8,2019
2,8/29/2019,50,0,50,4,8,2019
3,8/29/2019,131,48,179,4,8,2019
4,8/29/2019,108,0,108,4,8,2019
5,8/29/2019,334,8,342,4,8,2019
6,8/29/2019,346,62,408,4,8,2019
7,8/29/2019,259,300,559,4,8,2019
8,8/29/2019,238,268,506,4,8,2019
9,8/29/2019,148,271,419,4,8,2019
10,8/29/2019,222,9,231,4,8,2019
11,8/29/2019,128,224,352,4,8,2019
12,8/29/2019,195,188,383,4,8,2019
13,8/29/2019,164,97,261,4,8,2019
14,8/29/2019,197,163,360,4,8,2019
15,8/29/2019,225,144,369,4,8,2019
16,8/29/2019,169,236,405,4,8,2019
17,8/29/2019,145,161,306,4,8,2019
18,8/29/2019,72,104,176,4,8,2019
19,8/29/2019,29,109,138,4,8,2019
20,8/29/2019,167,86,253,4,8,2019
21,8/29/2019,380,177,557,4,8,2019
22,8/29/2019,517,152,669,4,8,2019
23,8/29/2019,346,144,490,4,8,2019
0,8/30/2019,189,160,349,5,8,2019
1,8/30/2019,88,34,122,5,8,2019
2,8/30/2019,57,19,76,5,8,2019
3,8/30/2019,113,0,113,5,8,2019
4,8/30/2019,131,0,131,5,8,2019
5,8/30/2019,217,0,217,5,8,2019
6,8/30/2019,329,70,399,5,8,2019
7,8/30/2019,351,163,514,5,8,2019
8,8/30/2019,296,217,513,5,8,2019
9,8/30/2019,242,230,472,5,8,2019
10,8/30/2019,282,176,458,5,8,2019
11,8/30/2019,141,146,287,5,8,2019
12,8/30/2019,209,126,335,5,8,2019
13,8/30/2019,177,46,223,5,8,2019
14,8/30/2019,194,125,319,5,8,2019
15,8/30/2019,248,250,498,5,8,2019
16,8/30/2019,263,169,432,5,8,2019
17,8/30/2019,170,227,397,5,8,2019
18,8/30/2019,77,101,178,5,8,2019
19,8/30/2019,47,106,153,5,8,2019
20,8/30/2019,182,137,319,5,8,2019
21,8/30/2019,340,64,404,5,8,2019
22,8/30/2019,431,230,661,5,8,2019
23,8/30/2019,398,102,500,5,8,2019
0,8/31/2019,217,204,421,6,8,2019
1,8/31/2019,100,11,111,6,8,2019
2,8/31/2019,103,0,103,6,8,2019
3,8/31/2019,104,4,108,6,8,2019
4,8/31/2019,88,1,89,6,8,2019
5,8/31/2019,175,0,175,6,8,2019
6,8/31/2019,267,47,314,6,8,2019
7,8/31/2019,394,69,463,6,8,2019
8,8/31/2019,334,242,576,6,8,2019
9,8/31/2019,199,528,727,6,8,2019
10,8/31/2019,205,169,374,6,8,2019
11,8/31/2019,81,196,277,6,8,2019
12,8/31/2019,155,140,295,6,8,2019
13,8/31/2019,177,78,255,6,8,2019
14,8/31/2019,140,271,411,6,8,2019
15,8/31/2019,129,97,226,6,8,2019
16,8/31/2019,147,239,386,6,8,2019
17,8/31/2019,144,223,367,6,8,2019
18,8/31/2019,44,93,137,6,8,2019
19,8/31/2019,70,210,280,6,8,2019
20,8/31/2019,102,57,159,6,8,2019
21,8/31/2019,180,253,433,6,8,2019
22,8/31/2019,195,158,353,6,8,2019
23,8/31/2019,132,127,259,6,8,2019
0,9/1/2019,75,56,131,7,9,2019
1,9/1/2019,18,32,50,7,9,2019
2,9/1/2019,41,0,41,7,9,2019
3,9/1/2019,92,0,92,7,9,2019
4,9/1/2019,101,0,101,7,9,2019
5,9/1/2019,158,0,158,7,9,2019
6,9/1/2019,199,52,251,7,9,2019
7,9/1/2019,190,166,356,7,9,2019
8,9/1/2019,126,479,605,7,9,2019
9,9/1/2019,122,343,465,7,9,2019
10,9/1/2019,134,41,175,7,9,2019
11,9/1/2019,140,255,395,7,9,2019
12,9/1/2019,170,58,228,7,9,2019
13,9/1/2019,128,265,393,7,9,2019
14,9/1/2019,124,302,426,7,9,2019
15,9/1/2019,204,267,471,7,9,2019
16,9/1/2019,151,240,391,7,9,2019
17,9/1/2019,128,223,351,7,9,2019
18,9/1/2019,33,260,293,7,9,2019
19,9/1/2019,31,188,219,7,9,2019
20,9/1/2019,90,230,320,7,9,2019
21,9/1/2019,167,34,201,7,9,2019
22,9/1/2019,147,164,311,7,9,2019
23,9/1/2019,88,276,364,7,9,2019
0,9/2/2019,55,258,313,1,9,2019
1,9/2/2019,21,13,34,1,9,2019
2,9/2/2019,15,0,15,1,9,2019
3,9/2/2019,38,0,38,1,9,2019
4,9/2/2019,11,0,11,1,9,2019
5,9/2/2019,95,1,96,1,9,2019
6,9/2/2019,205,99,304,1,9,2019
7,9/2/2019,223,614,837,1,9,2019
8,9/2/2019,144,304,448,1,9,2019
9,9/2/2019,101,387,488,1,9,2019
10,9/2/2019,118,262,380,1,9,2019
11,9/2/2019,43,207,250,1,9,2019
12,9/2/2019,109,202,311,1,9,2019
13,9/2/2019,115,522,637,1,9,2019
14,9/2/2019,144,69,213,1,9,2019
15,9/2/2019,138,520,658,1,9,2019
16,9/2/2019,123,401,524,1,9,2019
17,9/2/2019,81,633,714,1,9,2019
18,9/2/2019,34,239,273,1,9,2019
19,9/2/2019,18,453,471,1,9,2019
20,9/2/2019,56,284,340,1,9,2019
21,9/2/2019,153,342,495,1,9,2019
22,9/2/2019,130,426,556,1,9,2019
23,9/2/2019,68,503,571,1,9,2019
0,9/3/2019,50,443,493,2,9,2019
1,9/3/2019,26,61,87,2,9,2019
2,9/3/2019,44,92,136,2,9,2019
3,9/3/2019,34,69,103,2,9,2019
4,9/3/2019,47,1,48,2,9,2019
5,9/3/2019,95,0,95,2,9,2019
6,9/3/2019,151,86,237,2,9,2019
7,9/3/2019,192,296,488,2,9,2019
8,9/3/2019,148,373,521,2,9,2019
9,9/3/2019,65,282,347,2,9,2019
10,9/3/2019,99,299,398,2,9,2019
11,9/3/2019,77,272,349,2,9,2019
12,9/3/2019,99,368,467,2,9,2019
13,9/3/2019,97,207,304,2,9,2019
14,9/3/2019,68,337,405,2,9,2019
15,9/3/2019,59,162,221,2,9,2019
16,9/3/2019,39,206,245,2,9,2019
17,9/3/2019,49,405,454,2,9,2019
18,9/3/2019,15,345,360,2,9,2019
19,9/3/2019,22,70,92,2,9,2019
20,9/3/2019,115,316,431,2,9,2019
21,9/3/2019,165,367,532,2,9,2019
22,9/3/2019,165,95,260,2,9,2019
23,9/3/2019,123,310,433,2,9,2019
0,9/4/2019,50,96,146,3,9,2019
1,9/4/2019,12,0,12,3,9,2019
2,9/4/2019,14,5,19,3,9,2019
3,9/4/2019,33,6,39,3,9,2019
4,9/4/2019,69,0,69,3,9,2019
5,9/4/2019,109,0,109,3,9,2019
6,9/4/2019,144,31,175,3,9,2019
7,9/4/2019,132,287,419,3,9,2019
8,9/4/2019,107,375,482,3,9,2019
9,9/4/2019,79,258,337,3,9,2019
10,9/4/2019,101,130,231,3,9,2019
11,9/4/2019,97,158,255,3,9,2019
12,9/4/2019,99,160,259,3,9,2019
13,9/4/2019,92,87,179,3,9,2019
14,9/4/2019,68,187,255,3,9,2019
15,9/4/2019,69,221,290,3,9,2019
16,9/4/2019,86,183,269,3,9,2019
17,9/4/2019,61,144,205,3,9,2019
18,9/4/2019,13,221,234,3,9,2019
19,9/4/2019,23,28,51,3,9,2019
20,9/4/2019,68,188,256,3,9,2019
21,9/4/2019,208,196,404,3,9,2019
22,9/4/2019,205,94,299,3,9,2019
23,9/4/2019,131,243,374,3,9,2019
0,9/5/2019,57,143,200,4,9,2019
1,9/5/2019,14,0,14,4,9,2019
2,9/5/2019,34,0,34,4,9,2019
3,9/5/2019,56,0,56,4,9,2019
4,9/5/2019,51,0,51,4,9,2019
5,9/5/2019,156,11,167,4,9,2019
6,9/5/2019,200,90,290,4,9,2019
7,9/5/2019,221,248,469,4,9,2019
8,9/5/2019,155,199,354,4,9,2019
9,9/5/2019,105,262,367,4,9,2019
10,9/5/2019,131,63,194,4,9,2019
11,9/5/2019,91,197,288,4,9,2019
12,9/5/2019,133,139,272,4,9,2019
13,9/5/2019,109,203,312,4,9,2019
14,9/5/2019,114,48,162,4,9,2019
15,9/5/2019,118,154,272,4,9,2019
16,9/5/2019,112,219,331,4,9,2019
17,9/5/2019,110,244,354,4,9,2019
18,9/5/2019,28,149,177,4,9,2019
19,9/5/2019,20,145,165,4,9,2019
20,9/5/2019,91,191,282,4,9,2019
21,9/5/2019,207,94,301,4,9,2019
22,9/5/2019,282,170,452,4,9,2019
23,9/5/2019,202,62,264,4,9,2019
0,9/6/2019,155,181,336,5,9,2019
1,9/6/2019,21,15,36,5,9,2019
2,9/6/2019,19,26,45,5,9,2019
3,9/6/2019,97,0,97,5,9,2019
4,9/6/2019,100,1,101,5,9,2019
5,9/6/2019,206,2,208,5,9,2019
6,9/6/2019,261,42,303,5,9,2019
7,9/6/2019,177,182,359,5,9,2019
8,9/6/2019,151,312,463,5,9,2019
9,9/6/2019,95,265,360,5,9,2019
10,9/6/2019,169,120,289,5,9,2019
11,9/6/2019,128,176,304,5,9,2019
12,9/6/2019,121,106,227,5,9,2019
13,9/6/2019,103,256,359,5,9,2019
14,9/6/2019,105,178,283,5,9,2019
15,9/6/2019,108,76,184,5,9,2019
16,9/6/2019,63,200,263,5,9,2019
17,9/6/2019,75,159,234,5,9,2019
18,9/6/2019,52,202,254,5,9,2019
19,9/6/2019,49,56,105,5,9,2019
20,9/6/2019,105,137,242,5,9,2019
21,9/6/2019,277,236,513,5,9,2019
22,9/6/2019,287,136,423,5,9,2019
23,9/6/2019,223,127,350,5,9,2019
0,9/7/2019,116,122,238,6,9,2019
1,9/7/2019,32,12,44,6,9,2019
2,9/7/2019,45,0,45,6,9,2019
3,9/7/2019,52,10,62,6,9,2019
4,9/7/2019,83,1,84,6,9,2019
5,9/7/2019,122,0,122,6,9,2019
6,9/7/2019,258,0,258,6,9,2019
7,9/7/2019,274,0,274,6,9,2019
8,9/7/2019,191,217,408,6,9,2019
9,9/7/2019,126,523,649,6,9,2019
10,9/7/2019,171,351,522,6,9,2019
11,9/7/2019,118,185,303,6,9,2019
12,9/7/2019,101,167,268,6,9,2019
13,9/7/2019,95,203,298,6,9,2019
14,9/7/2019,86,129,215,6,9,2019
15,9/7/2019,123,120,243,6,9,2019
16,9/7/2019,114,260,374,6,9,2019
17,9/7/2019,62,288,350,6,9,2019
18,9/7/2019,15,124,139,6,9,2019
19,9/7/2019,17,160,177,6,9,2019
20,9/7/2019,101,229,330,6,9,2019
21,9/7/2019,178,235,413,6,9,2019
22,9/7/2019,184,210,394,6,9,2019
23,9/7/2019,106,69,175,6,9,2019
0,9/8/2019,60,69,129,7,9,2019
1,9/8/2019,22,71,93,7,9,2019
2,9/8/2019,37,5,42,7,9,2019
3,9/8/2019,103,0,103,7,9,2019
4,9/8/2019,117,0,117,7,9,2019
5,9/8/2019,151,0,151,7,9,2019
6,9/8/2019,193,2,195,7,9,2019
7,9/8/2019,202,384,586,7,9,2019
8,9/8/2019,102,301,403,7,9,2019
9,9/8/2019,77,175,252,7,9,2019
10,9/8/2019,185,44,229,7,9,2019
11,9/8/2019,138,277,415,7,9,2019
12,9/8/2019,128,117,245,7,9,2019
13,9/8/2019,154,319,473,7,9,2019
14,9/8/2019,107,256,363,7,9,2019
15,9/8/2019,144,228,372,7,9,2019
16,9/8/2019,120,200,320,7,9,2019
17,9/8/2019,88,272,360,7,9,2019
18,9/8/2019,56,223,279,7,9,2019
19,9/8/2019,43,219,262,7,9,2019
20,9/8/2019,78,224,302,7,9,2019
21,9/8/2019,177,53,230,7,9,2019
22,9/8/2019,181,196,377,7,9,2019
23,9/8/2019,126,203,329,7,9,2019
0,9/9/2019,59,225,284,1,9,2019
1,9/9/2019,24,5,29,1,9,2019
2,9/9/2019,16,0,16,1,9,2019
3,9/9/2019,25,3,28,1,9,2019
4,9/9/2019,32,0,32,1,9,2019
5,9/9/2019,102,3,105,1,9,2019
6,9/9/2019,172,46,218,1,9,2019
7,9/9/2019,211,288,499,1,9,2019
8,9/9/2019,118,176,294,1,9,2019
9,9/9/2019,82,261,343,1,9,2019
10,9/9/2019,135,108,243,1,9,2019
11,9/9/2019,83,217,300,1,9,2019
12,9/9/2019,107,107,214,1,9,2019
13,9/9/2019,122,168,290,1,9,2019
14,9/9/2019,153,92,245,1,9,2019
15,9/9/2019,137,250,387,1,9,2019
16,9/9/2019,118,245,363,1,9,2019
17,9/9/2019,86,236,322,1,9,2019
18,9/9/2019,43,163,206,1,9,2019
19,9/9/2019,30,70,100,1,9,2019
20,9/9/2019,67,174,241,1,9,2019
21,9/9/2019,163,44,207,1,9,2019
22,9/9/2019,183,210,393,1,9,2019
23,9/9/2019,108,312,420,1,9,2019
0,9/10/2019,50,125,175,2,9,2019
1,9/10/2019,17,29,46,2,9,2019
2,9/10/2019,41,0,41,2,9,2019
3,9/10/2019,51,1,52,2,9,2019
4,9/10/2019,48,0,48,2,9,2019
5,9/10/2019,120,0,120,2,9,2019
6,9/10/2019,185,51,236,2,9,2019
7,9/10/2019,159,303,462,2,9,2019
8,9/10/2019,112,285,397,2,9,2019
9,9/10/2019,106,264,370,2,9,2019
10,9/10/2019,128,112,240,2,9,2019
11,9/10/2019,91,220,311,2,9,2019
12,9/10/2019,138,110,248,2,9,2019
13,9/10/2019,102,220,322,2,9,2019
14,9/10/2019,60,121,181,2,9,2019
15,9/10/2019,84,134,218,2,9,2019
16,9/10/2019,77,166,243,2,9,2019
17,9/10/2019,65,213,278,2,9,2019
18,9/10/2019,32,144,176,2,9,2019
19,9/10/2019,29,50,79,2,9,2019
20,9/10/2019,77,128,205,2,9,2019
21,9/10/2019,193,266,459,2,9,2019
22,9/10/2019,212,76,288,2,9,2019
23,9/10/2019,142,130,272,2,9,2019
0,9/11/2019,80,162,242,3,9,2019
1,9/11/2019,30,0,30,3,9,2019
2,9/11/2019,77,3,80,3,9,2019
3,9/11/2019,77,7,84,3,9,2019
4,9/11/2019,112,0,112,3,9,2019
5,9/11/2019,125,0,125,3,9,2019
6,9/11/2019,200,12,212,3,9,2019
7,9/11/2019,195,283,478,3,9,2019
8,9/11/2019,135,227,362,3,9,2019
9,9/11/2019,122,184,306,3,9,2019
10,9/11/2019,173,243,416,3,9,2019
11,9/11/2019,81,257,338,3,9,2019
12,9/11/2019,100,197,297,3,9,2019
13,9/11/2019,174,118,292,3,9,2019
14,9/11/2019,93,222,315,3,9,2019
15,9/11/2019,104,90,194,3,9,2019
16,9/11/2019,166,121,287,3,9,2019
17,9/11/2019,75,130,205,3,9,2019
18,9/11/2019,18,215,233,3,9,2019
19,9/11/2019,30,129,159,3,9,2019
20,9/11/2019,115,169,284,3,9,2019
21,9/11/2019,205,114,319,3,9,2019
22,9/11/2019,164,132,296,3,9,2019
23,9/11/2019,115,283,398,3,9,2019
0,9/12/2019,94,69,163,4,9,2019
1,9/12/2019,20,0,20,4,9,2019
2,9/12/2019,49,0,49,4,9,2019
3,9/12/2019,72,0,72,4,9,2019
4,9/12/2019,85,0,85,4,9,2019
5,9/12/2019,163,0,163,4,9,2019
6,9/12/2019,301,102,403,4,9,2019
7,9/12/2019,200,406,606,4,9,2019
8,9/12/2019,122,155,277,4,9,2019
9,9/12/2019,115,495,610,4,9,2019
10,9/12/2019,114,23,137,4,9,2019
11,9/12/2019,88,255,343,4,9,2019
12,9/12/2019,100,170,270,4,9,2019
13,9/12/2019,86,227,313,4,9,2019
14,9/12/2019,156,56,212,4,9,2019
15,9/12/2019,142,161,303,4,9,2019
16,9/12/2019,137,246,383,4,9,2019
17,9/12/2019,159,333,492,4,9,2019
18,9/12/2019,70,202,272,4,9,2019
19,9/12/2019,24,172,196,4,9,2019
20,9/12/2019,107,176,283,4,9,2019
21,9/12/2019,222,224,446,4,9,2019
22,9/12/2019,253,283,536,4,9,2019
23,9/12/2019,175,222,397,4,9,2019
0,9/13/2019,92,227,319,5,9,2019
1,9/13/2019,24,51,75,5,9,2019
2,9/13/2019,27,0,27,5,9,2019
3,9/13/2019,62,2,64,5,9,2019
4,9/13/2019,43,0,43,5,9,2019
5,9/13/2019,148,8,156,5,9,2019
6,9/13/2019,231,82,313,5,9,2019
7,9/13/2019,117,239,356,5,9,2019
8,9/13/2019,107,282,389,5,9,2019
9,9/13/2019,102,247,349,5,9,2019
10,9/13/2019,103,142,245,5,9,2019
11,9/13/2019,68,269,337,5,9,2019
12,9/13/2019,97,97,194,5,9,2019
13,9/13/2019,82,209,291,5,9,2019
14,9/13/2019,117,228,345,5,9,2019
15,9/13/2019,96,137,233,5,9,2019
16,9/13/2019,80,238,318,5,9,2019
17,9/13/2019,89,172,261,5,9,2019
18,9/13/2019,60,334,394,5,9,2019
19,9/13/2019,33,191,224,5,9,2019
20,9/13/2019,96,175,271,5,9,2019
21,9/13/2019,253,159,412,5,9,2019
22,9/13/2019,215,253,468,5,9,2019
23,9/13/2019,159,303,462,5,9,2019
0,9/14/2019,88,291,379,6,9,2019
1,9/14/2019,29,13,42,6,9,2019
2,9/14/2019,37,9,46,6,9,2019
3,9/14/2019,58,32,90,6,9,2019
4,9/14/2019,22,0,22,6,9,2019
5,9/14/2019,128,0,128,6,9,2019
6,9/14/2019,262,58,320,6,9,2019
7,9/14/2019,178,275,453,6,9,2019
8,9/14/2019,168,491,659,6,9,2019
9,9/14/2019,110,365,475,6,9,2019
10,9/14/2019,104,97,201,6,9,2019
11,9/14/2019,64,273,337,6,9,2019
12,9/14/2019,94,143,237,6,9,2019
13,9/14/2019,123,183,306,6,9,2019
14,9/14/2019,108,212,320,6,9,2019
15,9/14/2019,173,90,263,6,9,2019
16,9/14/2019,118,325,443,6,9,2019
17,9/14/2019,86,214,300,6,9,2019
18,9/14/2019,20,252,272,6,9,2019
19,9/14/2019,39,110,149,6,9,2019
20,9/14/2019,89,189,278,6,9,2019
21,9/14/2019,250,167,417,6,9,2019
22,9/14/2019,205,156,361,6,9,2019
23,9/14/2019,133,97,230,6,9,2019
0,9/15/2019,51,118,169,7,9,2019
1,9/15/2019,19,2,21,7,9,2019
2,9/15/2019,33,0,33,7,9,2019
3,9/15/2019,100,0,100,7,9,2019
4,9/15/2019,117,1,118,7,9,2019
5,9/15/2019,169,1,170,7,9,2019
6,9/15/2019,277,57,334,7,9,2019
7,9/15/2019,196,330,526,7,9,2019
8,9/15/2019,98,410,508,7,9,2019
9,9/15/2019,109,220,329,7,9,2019
10,9/15/2019,148,96,244,7,9,2019
11,9/15/2019,133,201,334,7,9,2019
12,9/15/2019,165,201,366,7,9,2019
13,9/15/2019,120,152,272,7,9,2019
14,9/15/2019,142,383,525,7,9,2019
15,9/15/2019,162,95,257,7,9,2019
16,9/15/2019,134,230,364,7,9,2019
17,9/15/2019,130,211,341,7,9,2019
18,9/15/2019,52,181,233,7,9,2019
19,9/15/2019,55,104,159,7,9,2019
20,9/15/2019,146,186,332,7,9,2019
21,9/15/2019,212,199,411,7,9,2019
22,9/15/2019,173,150,323,7,9,2019
23,9/15/2019,149,186,335,7,9,2019
0,9/16/2019,104,161,265,1,9,2019
1,9/16/2019,26,0,26,1,9,2019
2,9/16/2019,25,3,28,1,9,2019
3,9/16/2019,62,0,62,1,9,2019
4,9/16/2019,83,0,83,1,9,2019
5,9/16/2019,98,0,98,1,9,2019
6,9/16/2019,203,110,313,1,9,2019
7,9/16/2019,255,64,319,1,9,2019
8,9/16/2019,225,231,456,1,9,2019
9,9/16/2019,208,261,469,1,9,2019
10,9/16/2019,128,192,320,1,9,2019
11,9/16/2019,140,149,289,1,9,2019
12,9/16/2019,108,49,157,1,9,2019
13,9/16/2019,156,97,253,1,9,2019
14,9/16/2019,198,29,227,1,9,2019
15,9/16/2019,287,122,409,1,9,2019
16,9/16/2019,276,130,406,1,9,2019
17,9/16/2019,142,136,278,1,9,2019
18,9/16/2019,57,90,147,1,9,2019
19,9/16/2019,63,9,72,1,9,2019
20,9/16/2019,109,87,196,1,9,2019
21,9/16/2019,211,48,259,1,9,2019
22,9/16/2019,251,169,420,1,9,2019
23,9/16/2019,132,159,291,1,9,2019
0,9/17/2019,62,130,192,2,9,2019
1,9/17/2019,26,0,26,2,9,2019
2,9/17/2019,28,0,28,2,9,2019
3,9/17/2019,119,1,120,2,9,2019
4,9/17/2019,95,0,95,2,9,2019
5,9/17/2019,167,9,176,2,9,2019
6,9/17/2019,309,25,334,2,9,2019
7,9/17/2019,285,157,442,2,9,2019
8,9/17/2019,168,248,416,2,9,2019
9,9/17/2019,136,163,299,2,9,2019
10,9/17/2019,160,32,192,2,9,2019
11,9/17/2019,156,173,329,2,9,2019
12,9/17/2019,195,196,391,2,9,2019
13,9/17/2019,213,108,321,2,9,2019
14,9/17/2019,84,201,285,2,9,2019
15,9/17/2019,136,39,175,2,9,2019
16,9/17/2019,162,132,294,2,9,2019
17,9/17/2019,99,152,251,2,9,2019
18,9/17/2019,44,142,186,2,9,2019
19,9/17/2019,20,110,130,2,9,2019
20,9/17/2019,106,90,196,2,9,2019
21,9/17/2019,227,243,470,2,9,2019
22,9/17/2019,199,118,317,2,9,2019
23,9/17/2019,163,127,290,2,9,2019
0,9/18/2019,87,57,144,3,9,2019
1,9/18/2019,15,73,88,3,9,2019
2,9/18/2019,59,23,82,3,9,2019
3,9/18/2019,85,0,85,3,9,2019
4,9/18/2019,79,0,79,3,9,2019
5,9/18/2019,119,0,119,3,9,2019
6,9/18/2019,243,1,244,3,9,2019
7,9/18/2019,171,368,539,3,9,2019
8,9/18/2019,138,232,370,3,9,2019
9,9/18/2019,112,149,261,3,9,2019
10,9/18/2019,157,187,344,3,9,2019
11,9/18/2019,113,120,233,3,9,2019
12,9/18/2019,148,135,283,3,9,2019
13,9/18/2019,114,115,229,3,9,2019
14,9/18/2019,127,125,252,3,9,2019
15,9/18/2019,122,175,297,3,9,2019
16,9/18/2019,141,110,251,3,9,2019
17,9/18/2019,107,176,283,3,9,2019
18,9/18/2019,38,150,188,3,9,2019
19,9/18/2019,27,201,228,3,9,2019
20,9/18/2019,94,214,308,3,9,2019
21,9/18/2019,275,55,330,3,9,2019
22,9/18/2019,286,140,426,3,9,2019
23,9/18/2019,133,206,339,3,9,2019
0,9/19/2019,87,113,200,4,9,2019
1,9/19/2019,5,0,5,4,9,2019
2,9/19/2019,31,0,31,4,9,2019
3,9/19/2019,80,0,80,4,9,2019
4,9/19/2019,74,0,74,4,9,2019
5,9/19/2019,257,4,261,4,9,2019
6,9/19/2019,327,57,384,4,9,2019
7,9/19/2019,290,385,675,4,9,2019
8,9/19/2019,227,231,458,4,9,2019
9,9/19/2019,145,394,539,4,9,2019
10,9/19/2019,167,40,207,4,9,2019
11,9/19/2019,120,228,348,4,9,2019
12,9/19/2019,114,125,239,4,9,2019
13,9/19/2019,87,119,206,4,9,2019
14,9/19/2019,136,123,259,4,9,2019
15,9/19/2019,155,162,317,4,9,2019
16,9/19/2019,205,138,343,4,9,2019
17,9/19/2019,167,191,358,4,9,2019
18,9/19/2019,76,142,218,4,9,2019
19,9/19/2019,34,229,263,4,9,2019
20,9/19/2019,114,165,279,4,9,2019
21,9/19/2019,285,130,415,4,9,2019
22,9/19/2019,329,117,446,4,9,2019
23,9/19/2019,247,155,402,4,9,2019
0,9/20/2019,188,170,358,5,9,2019
1,9/20/2019,64,79,143,5,9,2019
2,9/20/2019,37,1,38,5,9,2019
3,9/20/2019,92,16,108,5,9,2019
4,9/20/2019,115,7,122,5,9,2019
5,9/20/2019,235,0,235,5,9,2019
6,9/20/2019,355,68,423,5,9,2019
7,9/20/2019,218,177,395,5,9,2019
8,9/20/2019,195,314,509,5,9,2019
9,9/20/2019,100,259,359,5,9,2019
10,9/20/2019,186,99,285,5,9,2019
11,9/20/2019,101,166,267,5,9,2019
12,9/20/2019,159,131,290,5,9,2019
13,9/20/2019,132,201,333,5,9,2019
14,9/20/2019,101,167,268,5,9,2019
15,9/20/2019,194,45,239,5,9,2019
16,9/20/2019,126,232,358,5,9,2019
17,9/20/2019,150,187,337,5,9,2019
18,9/20/2019,66,129,195,5,9,2019
19,9/20/2019,42,100,142,5,9,2019
20,9/20/2019,116,216,332,5,9,2019
21,9/20/2019,265,147,412,5,9,2019
22,9/20/2019,315,138,453,5,9,2019
23,9/20/2019,249,182,431,5,9,2019
0,9/21/2019,159,132,291,6,9,2019
1,9/21/2019,34,0,34,6,9,2019
2,9/21/2019,47,4,51,6,9,2019
3,9/21/2019,78,0,78,6,9,2019
4,9/21/2019,102,0,102,6,9,2019
5,9/21/2019,152,0,152,6,9,2019
6,9/21/2019,286,3,289,6,9,2019
7,9/21/2019,319,201,520,6,9,2019
8,9/21/2019,284,537,821,6,9,2019
9,9/21/2019,160,294,454,6,9,2019
10,9/21/2019,137,144,281,6,9,2019
11,9/21/2019,119,237,356,6,9,2019
12,9/21/2019,131,121,252,6,9,2019
13,9/21/2019,159,216,375,6,9,2019
14,9/21/2019,122,170,292,6,9,2019
15,9/21/2019,200,189,389,6,9,2019
16,9/21/2019,143,150,293,6,9,2019
17,9/21/2019,90,291,381,6,9,2019
18,9/21/2019,30,234,264,6,9,2019
19,9/21/2019,21,106,127,6,9,2019
20,9/21/2019,113,262,375,6,9,2019
21,9/21/2019,240,146,386,6,9,2019
22,9/21/2019,225,92,317,6,9,2019
23,9/21/2019,134,167,301,6,9,2019
0,9/22/2019,84,189,273,7,9,2019
1,9/22/2019,38,20,58,7,9,2019
2,9/22/2019,60,0,60,7,9,2019
3,9/22/2019,117,0,117,7,9,2019
4,9/22/2019,165,0,165,7,9,2019
5,9/22/2019,187,0,187,7,9,2019
6,9/22/2019,222,0,222,7,9,2019
7,9/22/2019,253,0,253,7,9,2019
8,9/22/2019,127,29,156,7,9,2019
9,9/22/2019,153,290,443,7,9,2019
10,9/22/2019,155,353,508,7,9,2019
11,9/22/2019,162,529,691,7,9,2019
12,9/22/2019,146,383,529,7,9,2019
13,9/22/2019,130,189,319,7,9,2019
14,9/22/2019,131,133,264,7,9,2019
15,9/22/2019,191,118,309,7,9,2019
16,9/22/2019,189,309,498,7,9,2019
17,9/22/2019,135,411,546,7,9,2019
18,9/22/2019,65,303,368,7,9,2019
19,9/22/2019,45,320,365,7,9,2019
20,9/22/2019,109,159,268,7,9,2019
21,9/22/2019,218,45,263,7,9,2019
22,9/22/2019,258,114,372,7,9,2019
23,9/22/2019,120,315,435,7,9,2019
0,9/23/2019,65,312,377,1,9,2019
1,9/23/2019,19,58,77,1,9,2019
2,9/23/2019,7,7,14,1,9,2019
3,9/23/2019,50,0,50,1,9,2019
4,9/23/2019,32,1,33,1,9,2019
5,9/23/2019,125,7,132,1,9,2019
6,9/23/2019,240,70,310,1,9,2019
7,9/23/2019,249,342,591,1,9,2019
8,9/23/2019,152,284,436,1,9,2019
9,9/23/2019,95,334,429,1,9,2019
10,9/23/2019,153,76,229,1,9,2019
11,9/23/2019,70,249,319,1,9,2019
12,9/23/2019,103,64,167,1,9,2019
13,9/23/2019,150,181,331,1,9,2019
14,9/23/2019,174,113,287,1,9,2019
15,9/23/2019,227,219,446,1,9,2019
16,9/23/2019,104,285,389,1,9,2019
17,9/23/2019,136,327,463,1,9,2019
18,9/23/2019,43,275,318,1,9,2019
19,9/23/2019,22,141,163,1,9,2019
20,9/23/2019,57,136,193,1,9,2019
21,9/23/2019,139,253,392,1,9,2019
22,9/23/2019,131,237,368,1,9,2019
23,9/23/2019,76,291,367,1,9,2019
0,9/24/2019,26,187,213,2,9,2019
1,9/24/2019,9,1,10,2,9,2019
2,9/24/2019,29,0,29,2,9,2019
3,9/24/2019,68,0,68,2,9,2019
4,9/24/2019,101,0,101,2,9,2019
5,9/24/2019,133,8,141,2,9,2019
6,9/24/2019,254,72,326,2,9,2019
7,9/24/2019,195,230,425,2,9,2019
8,9/24/2019,142,166,308,2,9,2019
9,9/24/2019,125,114,239,2,9,2019
10,9/24/2019,179,118,297,2,9,2019
11,9/24/2019,132,119,251,2,9,2019
12,9/24/2019,156,254,410,2,9,2019
13,9/24/2019,124,167,291,2,9,2019
14,9/24/2019,86,241,327,2,9,2019
15,9/24/2019,94,56,150,2,9,2019
16,9/24/2019,97,50,147,2,9,2019
17,9/24/2019,46,285,331,2,9,2019
18,9/24/2019,14,99,113,2,9,2019
19,9/24/2019,35,100,135,2,9,2019
20,9/24/2019,84,215,299,2,9,2019
21,9/24/2019,228,241,469,2,9,2019
22,9/24/2019,216,83,299,2,9,2019
23,9/24/2019,149,212,361,2,9,2019
0,9/25/2019,63,53,116,3,9,2019
1,9/25/2019,22,0,22,3,9,2019
2,9/25/2019,29,1,30,3,9,2019
3,9/25/2019,74,0,74,3,9,2019
4,9/25/2019,108,0,108,3,9,2019
5,9/25/2019,118,0,118,3,9,2019
6,9/25/2019,261,21,282,3,9,2019
7,9/25/2019,155,250,405,3,9,2019
8,9/25/2019,164,206,370,3,9,2019
9,9/25/2019,122,297,419,3,9,2019
10,9/25/2019,170,135,305,3,9,2019
11,9/25/2019,110,259,369,3,9,2019
12,9/25/2019,141,85,226,3,9,2019
13,9/25/2019,120,113,233,3,9,2019
14,9/25/2019,118,115,233,3,9,2019
15,9/25/2019,108,172,280,3,9,2019
16,9/25/2019,94,178,272,3,9,2019
17,9/25/2019,88,155,243,3,9,2019
18,9/25/2019,7,216,223,3,9,2019
19,9/25/2019,31,35,66,3,9,2019
20,9/25/2019,112,173,285,3,9,2019
21,9/25/2019,376,95,471,3,9,2019
22,9/25/2019,272,114,386,3,9,2019
23,9/25/2019,209,201,410,3,9,2019
0,9/26/2019,153,90,243,4,9,2019
1,9/26/2019,26,0,26,4,9,2019
2,9/26/2019,46,0,46,4,9,2019
3,9/26/2019,109,0,109,4,9,2019
4,9/26/2019,90,0,90,4,9,2019
5,9/26/2019,255,26,281,4,9,2019
6,9/26/2019,407,63,470,4,9,2019
7,9/26/2019,323,336,659,4,9,2019
8,9/26/2019,266,253,519,4,9,2019
9,9/26/2019,146,326,472,4,9,2019
10,9/26/2019,165,70,235,4,9,2019
11,9/26/2019,164,211,375,4,9,2019
12,9/26/2019,147,152,299,4,9,2019
13,9/26/2019,154,137,291,4,9,2019
14,9/26/2019,126,92,218,4,9,2019
15,9/26/2019,153,120,273,4,9,2019
16,9/26/2019,180,251,431,4,9,2019
17,9/26/2019,181,112,293,4,9,2019
18,9/26/2019,76,210,286,4,9,2019
19,9/26/2019,33,100,133,4,9,2019
20,9/26/2019,120,150,270,4,9,2019
21,9/26/2019,297,274,571,4,9,2019
22,9/26/2019,371,157,528,4,9,2019
23,9/26/2019,302,216,518,4,9,2019
0,9/27/2019,336,165,501,5,9,2019
1,9/27/2019,41,7,48,5,9,2019
2,9/27/2019,74,0,74,5,9,2019
3,9/27/2019,96,1,97,5,9,2019
4,9/27/2019,135,0,135,5,9,2019
5,9/27/2019,211,1,212,5,9,2019
6,9/27/2019,357,75,432,5,9,2019
7,9/27/2019,285,136,421,5,9,2019
8,9/27/2019,233,358,591,5,9,2019
9,9/27/2019,95,277,372,5,9,2019
10,9/27/2019,193,111,304,5,9,2019
11,9/27/2019,139,149,288,5,9,2019
12,9/27/2019,164,122,286,5,9,2019
13,9/27/2019,146,166,312,5,9,2019
14,9/27/2019,143,218,361,5,9,2019
15,9/27/2019,154,92,246,5,9,2019
16,9/27/2019,164,213,377,5,9,2019
17,9/27/2019,103,219,322,5,9,2019
18,9/27/2019,56,179,235,5,9,2019
19,9/27/2019,42,84,126,5,9,2019
20,9/27/2019,161,221,382,5,9,2019
21,9/27/2019,317,183,500,5,9,2019
22,9/27/2019,296,93,389,5,9,2019
23,9/27/2019,225,261,486,5,9,2019
0,9/28/2019,121,132,253,6,9,2019
1,9/28/2019,41,12,53,6,9,2019
2,9/28/2019,61,3,64,6,9,2019
3,9/28/2019,84,0,84,6,9,2019
4,9/28/2019,137,0,137,6,9,2019
5,9/28/2019,122,0,122,6,9,2019
6,9/28/2019,359,30,389,6,9,2019
7,9/28/2019,340,202,542,6,9,2019
8,9/28/2019,293,403,696,6,9,2019
9,9/28/2019,162,278,440,6,9,2019
10,9/28/2019,165,110,275,6,9,2019
11,9/28/2019,140,247,387,6,9,2019
12,9/28/2019,130,122,252,6,9,2019
13,9/28/2019,128,299,427,6,9,2019
14,9/28/2019,143,81,224,6,9,2019
15,9/28/2019,166,130,296,6,9,2019
16,9/28/2019,190,179,369,6,9,2019
17,9/28/2019,64,282,346,6,9,2019
18,9/28/2019,31,138,169,6,9,2019
19,9/28/2019,58,248,306,6,9,2019
20,9/28/2019,132,236,368,6,9,2019
21,9/28/2019,232,137,369,6,9,2019
22,9/28/2019,198,145,343,6,9,2019
23,9/28/2019,127,188,315,6,9,2019
0,9/29/2019,104,112,216,7,9,2019
1,9/29/2019,35,52,87,7,9,2019
2,9/29/2019,35,0,35,7,9,2019
3,9/29/2019,102,0,102,7,9,2019
4,9/29/2019,156,0,156,7,9,2019
5,9/29/2019,177,3,180,7,9,2019
6,9/29/2019,221,62,283,7,9,2019
7,9/29/2019,243,277,520,7,9,2019
8,9/29/2019,113,561,674,7,9,2019
9,9/29/2019,118,140,258,7,9,2019
10,9/29/2019,212,83,295,7,9,2019
11,9/29/2019,136,172,308,7,9,2019
12,9/29/2019,177,267,444,7,9,2019
13,9/29/2019,121,176,297,7,9,2019
14,9/29/2019,104,362,466,7,9,2019
15,9/29/2019,194,241,435,7,9,2019
16,9/29/2019,176,247,423,7,9,2019
17,9/29/2019,154,223,377,7,9,2019
18,9/29/2019,75,345,420,7,9,2019
19,9/29/2019,60,286,346,7,9,2019
20,9/29/2019,91,256,347,7,9,2019
21,9/29/2019,247,155,402,7,9,2019
22,9/29/2019,195,153,348,7,9,2019
23,9/29/2019,100,284,384,7,9,2019
0,9/30/2019,75,232,307,1,9,2019
1,9/30/2019,40,5,45,1,9,2019
2,9/30/2019,20,17,37,1,9,2019
3,9/30/2019,33,8,41,1,9,2019
4,9/30/2019,38,0,38,1,9,2019
5,9/30/2019,132,0,132,1,9,2019
6,9/30/2019,262,93,355,1,9,2019
7,9/30/2019,225,372,597,1,9,2019
8,9/30/2019,164,263,427,1,9,2019
9,9/30/2019,124,336,460,1,9,2019
10,9/30/2019,193,113,306,1,9,2019
11,9/30/2019,87,168,255,1,9,2019
12,9/30/2019,88,162,250,1,9,2019
13,9/30/2019,154,92,246,1,9,2019
14,9/30/2019,199,70,269,1,9,2019
15,9/30/2019,179,184,363,1,9,2019
16,9/30/2019,116,372,488,1,9,2019
17,9/30/2019,156,213,369,1,9,2019
18,9/30/2019,42,313,355,1,9,2019
19,9/30/2019,23,265,288,1,9,2019
20,9/30/2019,88,291,379,1,9,2019
21,9/30/2019,181,89,270,1,9,2019
22,9/30/2019,166,295,461,1,9,2019
23,9/30/2019,73,349,422,1,9,2019
0,10/1/2019,20,211,231,2,10,2019
1,10/1/2019,15,74,89,2,10,2019
2,10/1/2019,41,0,41,2,10,2019
3,10/1/2019,81,0,81,2,10,2019
4,10/1/2019,45,0,45,2,10,2019
5,10/1/2019,106,1,107,2,10,2019
6,10/1/2019,229,54,283,2,10,2019
7,10/1/2019,215,136,351,2,10,2019
8,10/1/2019,188,404,592,2,10,2019
9,10/1/2019,114,307,421,2,10,2019
10,10/1/2019,134,91,225,2,10,2019
11,10/1/2019,93,192,285,2,10,2019
12,10/1/2019,114,262,376,2,10,2019
13,10/1/2019,109,123,232,2,10,2019
14,10/1/2019,89,344,433,2,10,2019
15,10/1/2019,115,83,198,2,10,2019
16,10/1/2019,134,148,282,2,10,2019
17,10/1/2019,61,276,337,2,10,2019
18,10/1/2019,29,125,154,2,10,2019
19,10/1/2019,13,205,218,2,10,2019
20,10/1/2019,124,217,341,2,10,2019
21,10/1/2019,267,293,560,2,10,2019
22,10/1/2019,268,169,437,2,10,2019
23,10/1/2019,150,211,361,2,10,2019
0,10/2/2019,21,84,105,3,10,2019
1,10/2/2019,9,58,67,3,10,2019
2,10/2/2019,17,0,17,3,10,2019
3,10/2/2019,67,0,67,3,10,2019
4,10/2/2019,77,0,77,3,10,2019
5,10/2/2019,145,0,145,3,10,2019
6,10/2/2019,237,19,256,3,10,2019
7,10/2/2019,201,292,493,3,10,2019
8,10/2/2019,138,226,364,3,10,2019
9,10/2/2019,147,317,464,3,10,2019
10,10/2/2019,132,115,247,3,10,2019
11,10/2/2019,86,170,256,3,10,2019
12,10/2/2019,77,87,164,3,10,2019
13,10/2/2019,91,78,169,3,10,2019
14,10/2/2019,124,209,333,3,10,2019
15,10/2/2019,62,139,201,3,10,2019
16,10/2/2019,104,143,247,3,10,2019
17,10/2/2019,101,155,256,3,10,2019
18,10/2/2019,35,208,243,3,10,2019
19,10/2/2019,28,80,108,3,10,2019
20,10/2/2019,119,232,351,3,10,2019
21,10/2/2019,252,87,339,3,10,2019
22,10/2/2019,246,55,301,3,10,2019
23,10/2/2019,222,346,568,3,10,2019
0,10/3/2019,55,83,138,4,10,2019
1,10/3/2019,24,3,27,4,10,2019
2,10/3/2019,35,0,35,4,10,2019
3,10/3/2019,84,0,84,4,10,2019
4,10/3/2019,79,0,79,4,10,2019
5,10/3/2019,236,0,236,4,10,2019
6,10/3/2019,350,44,394,4,10,2019
7,10/3/2019,290,324,614,4,10,2019
8,10/3/2019,196,180,376,4,10,2019
9,10/3/2019,80,363,443,4,10,2019
10,10/3/2019,176,75,251,4,10,2019
11,10/3/2019,141,140,281,4,10,2019
12,10/3/2019,99,208,307,4,10,2019
13,10/3/2019,157,117,274,4,10,2019
14,10/3/2019,179,202,381,4,10,2019
15,10/3/2019,143,172,315,4,10,2019
16,10/3/2019,86,113,199,4,10,2019
17,10/3/2019,118,278,396,4,10,2019
18,10/3/2019,65,122,187,4,10,2019
19,10/3/2019,33,223,256,4,10,2019
20,10/3/2019,111,131,242,4,10,2019
21,10/3/2019,245,243,488,4,10,2019
22,10/3/2019,261,169,430,4,10,2019
23,10/3/2019,309,234,543,4,10,2019
0,10/4/2019,189,49,238,5,10,2019
1,10/4/2019,18,35,53,5,10,2019
2,10/4/2019,23,0,23,5,10,2019
3,10/4/2019,55,0,55,5,10,2019
4,10/4/2019,88,0,88,5,10,2019
5,10/4/2019,215,3,218,5,10,2019
6,10/4/2019,320,59,379,5,10,2019
7,10/4/2019,296,160,456,5,10,2019
8,10/4/2019,196,282,478,5,10,2019
9,10/4/2019,138,268,406,5,10,2019
10,10/4/2019,160,179,339,5,10,2019
11,10/4/2019,114,108,222,5,10,2019
12,10/4/2019,104,120,224,5,10,2019
13,10/4/2019,93,105,198,5,10,2019
14,10/4/2019,125,221,346,5,10,2019
15,10/4/2019,131,129,260,5,10,2019
16,10/4/2019,129,106,235,5,10,2019
17,10/4/2019,130,173,303,5,10,2019
18,10/4/2019,45,113,158,5,10,2019
19,10/4/2019,34,269,303,5,10,2019
20,10/4/2019,89,215,304,5,10,2019
21,10/4/2019,225,205,430,5,10,2019
22,10/4/2019,320,161,481,5,10,2019
23,10/4/2019,228,110,338,5,10,2019
0,10/5/2019,40,140,180,6,10,2019
1,10/5/2019,9,50,59,6,10,2019
2,10/5/2019,29,2,31,6,10,2019
3,10/5/2019,103,0,103,6,10,2019
4,10/5/2019,61,0,61,6,10,2019
5,10/5/2019,190,0,190,6,10,2019
6,10/5/2019,323,25,348,6,10,2019
7,10/5/2019,329,199,528,6,10,2019
8,10/5/2019,278,423,701,6,10,2019
9,10/5/2019,171,253,424,6,10,2019
10,10/5/2019,143,175,318,6,10,2019
11,10/5/2019,87,216,303,6,10,2019
12,10/5/2019,141,207,348,6,10,2019
13,10/5/2019,124,100,224,6,10,2019
14,10/5/2019,109,269,378,6,10,2019
15,10/5/2019,135,215,350,6,10,2019
16,10/5/2019,102,217,319,6,10,2019
17,10/5/2019,103,256,359,6,10,2019
18,10/5/2019,21,149,170,6,10,2019
19,10/5/2019,54,257,311,6,10,2019
20,10/5/2019,114,269,383,6,10,2019
21,10/5/2019,168,181,349,6,10,2019
22,10/5/2019,204,161,365,6,10,2019
23,10/5/2019,146,158,304,6,10,2019
0,10/6/2019,32,113,145,7,10,2019
1,10/6/2019,10,7,17,7,10,2019
2,10/6/2019,24,0,24,7,10,2019
3,10/6/2019,87,0,87,7,10,2019
4,10/6/2019,133,0,133,7,10,2019
5,10/6/2019,160,6,166,7,10,2019
6,10/6/2019,299,49,348,7,10,2019
7,10/6/2019,250,373,623,7,10,2019
8,10/6/2019,127,479,606,7,10,2019
9,10/6/2019,113,242,355,7,10,2019
10,10/6/2019,186,83,269,7,10,2019
11,10/6/2019,141,282,423,7,10,2019
12,10/6/2019,143,278,421,7,10,2019
13,10/6/2019,157,163,320,7,10,2019
14,10/6/2019,118,435,553,7,10,2019
15,10/6/2019,113,175,288,7,10,2019
16,10/6/2019,160,217,377,7,10,2019
17,10/6/2019,158,166,324,7,10,2019
18,10/6/2019,91,408,499,7,10,2019
19,10/6/2019,29,307,336,7,10,2019
20,10/6/2019,95,186,281,7,10,2019
21,10/6/2019,218,189,407,7,10,2019
22,10/6/2019,223,198,421,7,10,2019
23,10/6/2019,98,442,540,7,10,2019
0,10/7/2019,44,132,176,1,10,2019
1,10/7/2019,8,1,9,1,10,2019
2,10/7/2019,12,0,12,1,10,2019
3,10/7/2019,35,0,35,1,10,2019
4,10/7/2019,46,0,46,1,10,2019
5,10/7/2019,108,16,124,1,10,2019
6,10/7/2019,209,66,275,1,10,2019
7,10/7/2019,225,344,569,1,10,2019
8,10/7/2019,146,288,434,1,10,2019
9,10/7/2019,68,373,441,1,10,2019
10,10/7/2019,126,53,179,1,10,2019
11,10/7/2019,97,149,246,1,10,2019
12,10/7/2019,98,246,344,1,10,2019
13,10/7/2019,125,95,220,1,10,2019
14,10/7/2019,124,212,336,1,10,2019
15,10/7/2019,103,209,312,1,10,2019
16,10/7/2019,138,298,436,1,10,2019
17,10/7/2019,49,356,405,1,10,2019
18,10/7/2019,19,143,162,1,10,2019
19,10/7/2019,24,193,217,1,10,2019
20,10/7/2019,77,205,282,1,10,2019
21,10/7/2019,154,157,311,1,10,2019
22,10/7/2019,173,155,328,1,10,2019
23,10/7/2019,65,321,386,1,10,2019
0,10/8/2019,13,231,244,2,10,2019
1,10/8/2019,13,6,19,2,10,2019
2,10/8/2019,16,0,16,2,10,2019
3,10/8/2019,68,0,68,2,10,2019
4,10/8/2019,92,0,92,2,10,2019
5,10/8/2019,132,1,133,2,10,2019
6,10/8/2019,195,89,284,2,10,2019
7,10/8/2019,181,243,424,2,10,2019
8,10/8/2019,154,274,428,2,10,2019
9,10/8/2019,97,317,414,2,10,2019
10,10/8/2019,118,149,267,2,10,2019
11,10/8/2019,113,116,229,2,10,2019
12,10/8/2019,140,280,420,2,10,2019
13,10/8/2019,128,189,317,2,10,2019
14,10/8/2019,95,318,413,2,10,2019
15,10/8/2019,113,113,226,2,10,2019
16,10/8/2019,93,125,218,2,10,2019
17,10/8/2019,64,249,313,2,10,2019
18,10/8/2019,42,212,254,2,10,2019
19,10/8/2019,18,88,106,2,10,2019
20,10/8/2019,101,172,273,2,10,2019
21,10/8/2019,228,234,462,2,10,2019
22,10/8/2019,206,179,385,2,10,2019
23,10/8/2019,158,131,289,2,10,2019
0,10/9/2019,33,165,198,3,10,2019
1,10/9/2019,19,0,19,3,10,2019
2,10/9/2019,14,0,14,3,10,2019
3,10/9/2019,72,0,72,3,10,2019
4,10/9/2019,93,0,93,3,10,2019
5,10/9/2019,162,0,162,3,10,2019
6,10/9/2019,286,0,286,3,10,2019
7,10/9/2019,206,279,485,3,10,2019
8,10/9/2019,181,252,433,3,10,2019
9,10/9/2019,113,221,334,3,10,2019
10,10/9/2019,133,105,238,3,10,2019
11,10/9/2019,91,84,175,3,10,2019
12,10/9/2019,132,291,423,3,10,2019
13,10/9/2019,98,28,126,3,10,2019
14,10/9/2019,74,241,315,3,10,2019
15,10/9/2019,113,130,243,3,10,2019
16,10/9/2019,106,94,200,3,10,2019
17,10/9/2019,96,174,270,3,10,2019
18,10/9/2019,22,195,217,3,10,2019
19,10/9/2019,22,170,192,3,10,2019
20,10/9/2019,96,152,248,3,10,2019
21,10/9/2019,268,127,395,3,10,2019
22,10/9/2019,328,92,420,3,10,2019
23,10/9/2019,242,169,411,3,10,2019
0,10/10/2019,84,100,184,4,10,2019
1,10/10/2019,6,86,92,4,10,2019
2,10/10/2019,43,0,43,4,10,2019
3,10/10/2019,89,1,90,4,10,2019
4,10/10/2019,137,0,137,4,10,2019
5,10/10/2019,265,0,265,4,10,2019
6,10/10/2019,408,52,460,4,10,2019
7,10/10/2019,313,342,655,4,10,2019
8,10/10/2019,232,213,445,4,10,2019
9,10/10/2019,72,215,287,4,10,2019
10,10/10/2019,215,25,240,4,10,2019
11,10/10/2019,154,196,350,4,10,2019
12,10/10/2019,118,298,416,4,10,2019
13,10/10/2019,134,57,191,4,10,2019
14,10/10/2019,140,180,320,4,10,2019
15,10/10/2019,148,175,323,4,10,2019
16,10/10/2019,157,174,331,4,10,2019
17,10/10/2019,190,208,398,4,10,2019
18,10/10/2019,111,143,254,4,10,2019
19,10/10/2019,18,135,153,4,10,2019
20,10/10/2019,132,158,290,4,10,2019
21,10/10/2019,282,222,504,4,10,2019
22,10/10/2019,318,166,484,4,10,2019
23,10/10/2019,279,160,439,4,10,2019
0,10/11/2019,243,115,358,5,10,2019
1,10/11/2019,35,26,61,5,10,2019
2,10/11/2019,32,0,32,5,10,2019
3,10/11/2019,81,0,81,5,10,2019
4,10/11/2019,99,0,99,5,10,2019
5,10/11/2019,222,0,222,5,10,2019
6,10/11/2019,313,105,418,5,10,2019
7,10/11/2019,282,119,401,5,10,2019
8,10/11/2019,196,290,486,5,10,2019
9,10/11/2019,167,263,430,5,10,2019
10,10/11/2019,224,130,354,5,10,2019
11,10/11/2019,141,75,216,5,10,2019
12,10/11/2019,127,253,380,5,10,2019
13,10/11/2019,115,200,315,5,10,2019
14,10/11/2019,169,110,279,5,10,2019
15,10/11/2019,156,94,250,5,10,2019
16,10/11/2019,194,250,444,5,10,2019
17,10/11/2019,96,165,261,5,10,2019
18,10/11/2019,65,237,302,5,10,2019
19,10/11/2019,47,111,158,5,10,2019
20,10/11/2019,106,136,242,5,10,2019
21,10/11/2019,288,166,454,5,10,2019
22,10/11/2019,297,161,458,5,10,2019
23,10/11/2019,192,210,402,5,10,2019
0,10/12/2019,77,120,197,6,10,2019
1,10/12/2019,8,14,22,6,10,2019
2,10/12/2019,23,0,23,6,10,2019
3,10/12/2019,51,0,51,6,10,2019
4,10/12/2019,96,0,96,6,10,2019
5,10/12/2019,149,0,149,6,10,2019
6,10/12/2019,302,17,319,6,10,2019
7,10/12/2019,426,295,721,6,10,2019
8,10/12/2019,314,419,733,6,10,2019
9,10/12/2019,152,390,542,6,10,2019
10,10/12/2019,145,92,237,6,10,2019
11,10/12/2019,106,292,398,6,10,2019
12,10/12/2019,161,170,331,6,10,2019
13,10/12/2019,157,92,249,6,10,2019
14,10/12/2019,103,275,378,6,10,2019
15,10/12/2019,120,237,357,6,10,2019
16,10/12/2019,157,271,428,6,10,2019
17,10/12/2019,127,252,379,6,10,2019
18,10/12/2019,27,160,187,6,10,2019
19,10/12/2019,39,237,276,6,10,2019
20,10/12/2019,126,185,311,6,10,2019
21,10/12/2019,214,318,532,6,10,2019
22,10/12/2019,183,134,317,6,10,2019
23,10/12/2019,107,153,260,6,10,2019
0,10/13/2019,42,154,196,7,10,2019
1,10/13/2019,4,0,4,7,10,2019
2,10/13/2019,27,0,27,7,10,2019
3,10/13/2019,75,0,75,7,10,2019
4,10/13/2019,110,1,111,7,10,2019
5,10/13/2019,177,0,177,7,10,2019
6,10/13/2019,247,98,345,7,10,2019
7,10/13/2019,241,161,402,7,10,2019
8,10/13/2019,154,594,748,7,10,2019
9,10/13/2019,108,342,450,7,10,2019
10,10/13/2019,161,133,294,7,10,2019
11,10/13/2019,156,162,318,7,10,2019
12,10/13/2019,113,233,346,7,10,2019
13,10/13/2019,130,206,336,7,10,2019
14,10/13/2019,131,264,395,7,10,2019
15,10/13/2019,179,412,591,7,10,2019
16,10/13/2019,131,216,347,7,10,2019
17,10/13/2019,110,321,431,7,10,2019
18,10/13/2019,52,315,367,7,10,2019
19,10/13/2019,39,198,237,7,10,2019
20,10/13/2019,99,254,353,7,10,2019
21,10/13/2019,185,101,286,7,10,2019
22,10/13/2019,225,295,520,7,10,2019
23,10/13/2019,130,303,433,7,10,2019
0,10/14/2019,59,227,286,1,10,2019
1,10/14/2019,3,77,80,1,10,2019
2,10/14/2019,22,0,22,1,10,2019
3,10/14/2019,58,0,58,1,10,2019
4,10/14/2019,81,0,81,1,10,2019
5,10/14/2019,80,0,80,1,10,2019
6,10/14/2019,172,5,177,1,10,2019
7,10/14/2019,198,265,463,1,10,2019
8,10/14/2019,135,348,483,1,10,2019
9,10/14/2019,109,343,452,1,10,2019
10,10/14/2019,124,123,247,1,10,2019
11,10/14/2019,67,141,208,1,10,2019
12,10/14/2019,64,224,288,1,10,2019
13,10/14/2019,126,102,228,1,10,2019
14,10/14/2019,197,299,496,1,10,2019
15,10/14/2019,171,260,431,1,10,2019
16,10/14/2019,133,314,447,1,10,2019
17,10/14/2019,148,259,407,1,10,2019
18,10/14/2019,23,229,252,1,10,2019
19,10/14/2019,39,196,235,1,10,2019
20,10/14/2019,64,294,358,1,10,2019
21,10/14/2019,222,154,376,1,10,2019
22,10/14/2019,138,328,466,1,10,2019
23,10/14/2019,113,349,462,1,10,2019
0,10/15/2019,37,166,203,2,10,2019
1,10/15/2019,10,108,118,2,10,2019
2,10/15/2019,33,0,33,2,10,2019
3,10/15/2019,51,0,51,2,10,2019
4,10/15/2019,100,0,100,2,10,2019
5,10/15/2019,137,1,138,2,10,2019
6,10/15/2019,187,53,240,2,10,2019
7,10/15/2019,195,203,398,2,10,2019
8,10/15/2019,166,271,437,2,10,2019
9,10/15/2019,126,286,412,2,10,2019
10,10/15/2019,124,143,267,2,10,2019
11,10/15/2019,106,158,264,2,10,2019
12,10/15/2019,102,304,406,2,10,2019
13,10/15/2019,136,103,239,2,10,2019
14,10/15/2019,94,247,341,2,10,2019
15,10/15/2019,78,214,292,2,10,2019
16,10/15/2019,144,137,281,2,10,2019
17,10/15/2019,125,295,420,2,10,2019
18,10/15/2019,12,64,76,2,10,2019
19,10/15/2019,25,224,249,2,10,2019
20,10/15/2019,94,226,320,2,10,2019
21,10/15/2019,194,194,388,2,10,2019
22,10/15/2019,196,182,378,2,10,2019
23,10/15/2019,128,190,318,2,10,2019
0,10/16/2019,83,99,182,3,10,2019
1,10/16/2019,11,5,16,3,10,2019
2,10/16/2019,26,0,26,3,10,2019
3,10/16/2019,72,3,75,3,10,2019
4,10/16/2019,101,0,101,3,10,2019
5,10/16/2019,144,1,145,3,10,2019
6,10/16/2019,232,2,234,3,10,2019
7,10/16/2019,149,197,346,3,10,2019
8,10/16/2019,186,333,519,3,10,2019
9,10/16/2019,115,258,373,3,10,2019
10,10/16/2019,142,89,231,3,10,2019
11,10/16/2019,93,206,299,3,10,2019
12,10/16/2019,76,370,446,3,10,2019
13,10/16/2019,111,52,163,3,10,2019
14,10/16/2019,131,193,324,3,10,2019
15,10/16/2019,108,177,285,3,10,2019
16,10/16/2019,157,224,381,3,10,2019
17,10/16/2019,94,247,341,3,10,2019
18,10/16/2019,18,152,170,3,10,2019
19,10/16/2019,25,119,144,3,10,2019
20,10/16/2019,91,123,214,3,10,2019
21,10/16/2019,254,152,406,3,10,2019
22,10/16/2019,252,213,465,3,10,2019
23,10/16/2019,191,190,381,3,10,2019
0,10/17/2019,115,98,213,4,10,2019
1,10/17/2019,20,0,20,4,10,2019
2,10/17/2019,42,0,42,4,10,2019
3,10/17/2019,94,0,94,4,10,2019
4,10/17/2019,77,0,77,4,10,2019
5,10/17/2019,250,0,250,4,10,2019
6,10/17/2019,465,19,484,4,10,2019
7,10/17/2019,331,267,598,4,10,2019
8,10/17/2019,199,263,462,4,10,2019
9,10/17/2019,119,293,412,4,10,2019
10,10/17/2019,192,91,283,4,10,2019
11,10/17/2019,199,229,428,4,10,2019
12,10/17/2019,110,231,341,4,10,2019
13,10/17/2019,151,96,247,4,10,2019
14,10/17/2019,183,198,381,4,10,2019
15,10/17/2019,155,181,336,4,10,2019
16,10/17/2019,155,144,299,4,10,2019
17,10/17/2019,196,245,441,4,10,2019
18,10/17/2019,65,147,212,4,10,2019
19,10/17/2019,16,347,363,4,10,2019
20,10/17/2019,146,137,283,4,10,2019
21,10/17/2019,230,285,515,4,10,2019
22,10/17/2019,444,106,550,4,10,2019
23,10/17/2019,264,84,348,4,10,2019
0,10/18/2019,108,153,261,5,10,2019
1,10/18/2019,38,41,79,5,10,2019
2,10/18/2019,46,18,64,5,10,2019
3,10/18/2019,68,0,68,5,10,2019
4,10/18/2019,137,0,137,5,10,2019
5,10/18/2019,153,0,153,5,10,2019
6,10/18/2019,358,90,448,5,10,2019
7,10/18/2019,293,108,401,5,10,2019
8,10/18/2019,179,250,429,5,10,2019
9,10/18/2019,145,272,417,5,10,2019
10,10/18/2019,135,77,212,5,10,2019
11,10/18/2019,93,117,210,5,10,2019
12,10/18/2019,159,116,275,5,10,2019
13,10/18/2019,138,108,246,5,10,2019
14,10/18/2019,167,176,343,5,10,2019
15,10/18/2019,165,181,346,5,10,2019
16,10/18/2019,115,214,329,5,10,2019
17,10/18/2019,111,143,254,5,10,2019
18,10/18/2019,50,202,252,5,10,2019
19,10/18/2019,31,164,195,5,10,2019
20,10/18/2019,134,204,338,5,10,2019
21,10/18/2019,265,122,387,5,10,2019
22,10/18/2019,361,204,565,5,10,2019
23,10/18/2019,215,134,349,5,10,2019
0,10/19/2019,154,206,360,6,10,2019
1,10/19/2019,30,4,34,6,10,2019
2,10/19/2019,35,0,35,6,10,2019
3,10/19/2019,76,7,83,6,10,2019
4,10/19/2019,81,0,81,6,10,2019
5,10/19/2019,162,1,163,6,10,2019
6,10/19/2019,323,1,324,6,10,2019
7,10/19/2019,397,208,605,6,10,2019
8,10/19/2019,288,516,804,6,10,2019
9,10/19/2019,145,276,421,6,10,2019
10,10/19/2019,148,142,290,6,10,2019
11,10/19/2019,74,291,365,6,10,2019
12,10/19/2019,136,114,250,6,10,2019
13,10/19/2019,148,100,248,6,10,2019
14,10/19/2019,128,238,366,6,10,2019
15,10/19/2019,178,225,403,6,10,2019
16,10/19/2019,107,256,363,6,10,2019
17,10/19/2019,102,214,316,6,10,2019
18,10/19/2019,19,138,157,6,10,2019
19,10/19/2019,21,206,227,6,10,2019
20,10/19/2019,120,257,377,6,10,2019
21,10/19/2019,196,267,463,6,10,2019
22,10/19/2019,231,101,332,6,10,2019
23,10/19/2019,100,189,289,6,10,2019
0,10/20/2019,83,124,207,7,10,2019
1,10/20/2019,20,16,36,7,10,2019
2,10/20/2019,38,0,38,7,10,2019
3,10/20/2019,89,0,89,7,10,2019
4,10/20/2019,140,0,140,7,10,2019
5,10/20/2019,162,0,162,7,10,2019
6,10/20/2019,318,67,385,7,10,2019
7,10/20/2019,181,330,511,7,10,2019
8,10/20/2019,165,420,585,7,10,2019
9,10/20/2019,163,189,352,7,10,2019
10,10/20/2019,192,138,330,7,10,2019
11,10/20/2019,134,184,318,7,10,2019
12,10/20/2019,185,132,317,7,10,2019
13,10/20/2019,173,225,398,7,10,2019
14,10/20/2019,137,354,491,7,10,2019
15,10/20/2019,232,250,482,7,10,2019
16,10/20/2019,129,191,320,7,10,2019
17,10/20/2019,195,244,439,7,10,2019
18,10/20/2019,59,286,345,7,10,2019
19,10/20/2019,42,227,269,7,10,2019
20,10/20/2019,106,148,254,7,10,2019
21,10/20/2019,207,282,489,7,10,2019
22,10/20/2019,219,246,465,7,10,2019
23,10/20/2019,161,128,289,7,10,2019
0,10/21/2019,78,317,395,1,10,2019
1,10/21/2019,27,62,89,1,10,2019
2,10/21/2019,20,10,30,1,10,2019
3,10/21/2019,45,4,49,1,10,2019
4,10/21/2019,53,0,53,1,10,2019
5,10/21/2019,142,0,142,1,10,2019
6,10/21/2019,206,25,231,1,10,2019
7,10/21/2019,152,351,503,1,10,2019
8,10/21/2019,159,205,364,1,10,2019
9,10/21/2019,103,285,388,1,10,2019
10,10/21/2019,152,125,277,1,10,2019
11,10/21/2019,116,218,334,1,10,2019
12,10/21/2019,98,154,252,1,10,2019
13,10/21/2019,110,96,206,1,10,2019
14,10/21/2019,185,213,398,1,10,2019
15,10/21/2019,219,303,522,1,10,2019
16,10/21/2019,112,304,416,1,10,2019
17,10/21/2019,99,300,399,1,10,2019
18,10/21/2019,39,133,172,1,10,2019
19,10/21/2019,24,225,249,1,10,2019
20,10/21/2019,54,176,230,1,10,2019
21,10/21/2019,168,144,312,1,10,2019
22,10/21/2019,165,192,357,1,10,2019
23,10/21/2019,94,427,521,1,10,2019
0,10/22/2019,47,168,215,2,10,2019
1,10/22/2019,36,0,36,2,10,2019
2,10/22/2019,32,0,32,2,10,2019
3,10/22/2019,48,1,49,2,10,2019
4,10/22/2019,63,0,63,2,10,2019
5,10/22/2019,105,0,105,2,10,2019
6,10/22/2019,226,75,301,2,10,2019
7,10/22/2019,251,177,428,2,10,2019
8,10/22/2019,177,210,387,2,10,2019
9,10/22/2019,133,280,413,2,10,2019
10,10/22/2019,166,113,279,2,10,2019
11,10/22/2019,137,203,340,2,10,2019
12,10/22/2019,137,228,365,2,10,2019
13,10/22/2019,171,141,312,2,10,2019
14,10/22/2019,96,304,400,2,10,2019
15,10/22/2019,158,168,326,2,10,2019
16,10/22/2019,121,199,320,2,10,2019
17,10/22/2019,58,237,295,2,10,2019
18,10/22/2019,31,96,127,2,10,2019
19,10/22/2019,34,202,236,2,10,2019
20,10/22/2019,74,45,119,2,10,2019
21,10/22/2019,181,358,539,2,10,2019
22,10/22/2019,303,221,524,2,10,2019
23,10/22/2019,114,163,277,2,10,2019
0,10/23/2019,52,105,157,3,10,2019
1,10/23/2019,22,4,26,3,10,2019
2,10/23/2019,25,0,25,3,10,2019
3,10/23/2019,94,0,94,3,10,2019
4,10/23/2019,95,0,95,3,10,2019
5,10/23/2019,148,1,149,3,10,2019
6,10/23/2019,263,12,275,3,10,2019
7,10/23/2019,197,200,397,3,10,2019
8,10/23/2019,158,220,378,3,10,2019
9,10/23/2019,158,94,252,3,10,2019
10,10/23/2019,115,87,202,3,10,2019
11,10/23/2019,79,302,381,3,10,2019
12,10/23/2019,133,125,258,3,10,2019
13,10/23/2019,97,25,122,3,10,2019
14,10/23/2019,103,230,333,3,10,2019
15,10/23/2019,152,148,300,3,10,2019
16,10/23/2019,137,122,259,3,10,2019
17,10/23/2019,96,164,260,3,10,2019
18,10/23/2019,34,233,267,3,10,2019
19,10/23/2019,19,188,207,3,10,2019
20,10/23/2019,86,207,293,3,10,2019
21,10/23/2019,275,44,319,3,10,2019
22,10/23/2019,290,164,454,3,10,2019
23,10/23/2019,244,174,418,3,10,2019
0,10/24/2019,122,90,212,4,10,2019
1,10/24/2019,37,0,37,4,10,2019
2,10/24/2019,22,0,22,4,10,2019
3,10/24/2019,63,0,63,4,10,2019
4,10/24/2019,140,0,140,4,10,2019
5,10/24/2019,215,0,215,4,10,2019
6,10/24/2019,434,104,538,4,10,2019
7,10/24/2019,372,253,625,4,10,2019
8,10/24/2019,243,218,461,4,10,2019
9,10/24/2019,191,278,469,4,10,2019
10,10/24/2019,215,35,250,4,10,2019
11,10/24/2019,152,147,299,4,10,2019
12,10/24/2019,161,248,409,4,10,2019
13,10/24/2019,177,108,285,4,10,2019
14,10/24/2019,151,187,338,4,10,2019
15,10/24/2019,183,103,286,4,10,2019
16,10/24/2019,116,147,263,4,10,2019
17,10/24/2019,133,327,460,4,10,2019
18,10/24/2019,48,49,97,4,10,2019
19,10/24/2019,20,246,266,4,10,2019
20,10/24/2019,109,144,253,4,10,2019
21,10/24/2019,265,193,458,4,10,2019
22,10/24/2019,387,183,570,4,10,2019
23,10/24/2019,320,98,418,4,10,2019
0,10/25/2019,193,131,324,5,10,2019
1,10/25/2019,50,84,134,5,10,2019
2,10/25/2019,46,14,60,5,10,2019
3,10/25/2019,91,12,103,5,10,2019
4,10/25/2019,78,1,79,5,10,2019
5,10/25/2019,261,0,261,5,10,2019
6,10/25/2019,394,74,468,5,10,2019
7,10/25/2019,286,195,481,5,10,2019
8,10/25/2019,236,235,471,5,10,2019
9,10/25/2019,203,342,545,5,10,2019
10,10/25/2019,173,121,294,5,10,2019
11,10/25/2019,133,145,278,5,10,2019
12,10/25/2019,126,138,264,5,10,2019
13,10/25/2019,121,54,175,5,10,2019
14,10/25/2019,179,152,331,5,10,2019
15,10/25/2019,183,182,365,5,10,2019
16,10/25/2019,105,144,249,5,10,2019
17,10/25/2019,94,335,429,5,10,2019
18,10/25/2019,84,163,247,5,10,2019
19,10/25/2019,43,112,155,5,10,2019
20,10/25/2019,116,154,270,5,10,2019
21,10/25/2019,219,218,437,5,10,2019
22,10/25/2019,366,124,490,5,10,2019
23,10/25/2019,205,208,413,5,10,2019
0,10/26/2019,108,127,235,6,10,2019
1,10/26/2019,24,14,38,6,10,2019
2,10/26/2019,53,16,69,6,10,2019
3,10/26/2019,64,0,64,6,10,2019
4,10/26/2019,97,1,98,6,10,2019
5,10/26/2019,194,0,194,6,10,2019
6,10/26/2019,322,4,326,6,10,2019
7,10/26/2019,283,219,502,6,10,2019
8,10/26/2019,269,546,815,6,10,2019
9,10/26/2019,187,127,314,6,10,2019
10,10/26/2019,198,237,435,6,10,2019
11,10/26/2019,107,300,407,6,10,2019
12,10/26/2019,129,120,249,6,10,2019
13,10/26/2019,184,98,282,6,10,2019
14,10/26/2019,155,340,495,6,10,2019
15,10/26/2019,181,272,453,6,10,2019
16,10/26/2019,137,182,319,6,10,2019
17,10/26/2019,74,253,327,6,10,2019
18,10/26/2019,65,217,282,6,10,2019
19,10/26/2019,79,168,247,6,10,2019
20,10/26/2019,93,299,392,6,10,2019
21,10/26/2019,177,221,398,6,10,2019
22,10/26/2019,157,246,403,6,10,2019
23,10/26/2019,183,182,365,6,10,2019
0,10/27/2019,137,45,182,7,10,2019
1,10/27/2019,24,48,72,7,10,2019
2,10/27/2019,28,0,28,7,10,2019
3,10/27/2019,36,0,36,7,10,2019
4,10/27/2019,97,0,97,7,10,2019
5,10/27/2019,85,0,85,7,10,2019
6,10/27/2019,203,0,203,7,10,2019
7,10/27/2019,275,71,346,7,10,2019
8,10/27/2019,247,395,642,7,10,2019
9,10/27/2019,146,528,674,7,10,2019
10,10/27/2019,187,163,350,7,10,2019
11,10/27/2019,176,87,263,7,10,2019
12,10/27/2019,106,394,500,7,10,2019
13,10/27/2019,110,183,293,7,10,2019
14,10/27/2019,92,297,389,7,10,2019
15,10/27/2019,145,122,267,7,10,2019
16,10/27/2019,149,293,442,7,10,2019
17,10/27/2019,111,178,289,7,10,2019
18,10/27/2019,140,316,456,7,10,2019
19,10/27/2019,45,203,248,7,10,2019
20,10/27/2019,94,362,456,7,10,2019
21,10/27/2019,199,143,342,7,10,2019
22,10/27/2019,153,142,295,7,10,2019
23,10/27/2019,155,201,356,7,10,2019
0,10/28/2019,145,258,403,1,10,2019
1,10/28/2019,89,121,210,1,10,2019
2,10/28/2019,57,96,153,1,10,2019
3,10/28/2019,16,2,18,1,10,2019
4,10/28/2019,56,0,56,1,10,2019
5,10/28/2019,70,0,70,1,10,2019
6,10/28/2019,149,0,149,1,10,2019
7,10/28/2019,244,55,299,1,10,2019
8,10/28/2019,204,296,500,1,10,2019
9,10/28/2019,132,364,496,1,10,2019
10,10/28/2019,167,215,382,1,10,2019
11,10/28/2019,140,198,338,1,10,2019
12,10/28/2019,105,246,351,1,10,2019
13,10/28/2019,84,281,365,1,10,2019
14,10/28/2019,97,139,236,1,10,2019
15,10/28/2019,127,286,413,1,10,2019
16,10/28/2019,202,257,459,1,10,2019
17,10/28/2019,143,234,377,1,10,2019
18,10/28/2019,128,127,255,1,10,2019
19,10/28/2019,58,185,243,1,10,2019
20,10/28/2019,66,345,411,1,10,2019
21,10/28/2019,172,173,345,1,10,2019
22,10/28/2019,205,175,380,1,10,2019
23,10/28/2019,157,263,420,1,10,2019
0,10/29/2019,90,228,318,2,10,2019
1,10/29/2019,35,156,191,2,10,2019
2,10/29/2019,48,24,72,2,10,2019
3,10/29/2019,33,0,33,2,10,2019
4,10/29/2019,71,1,72,2,10,2019
5,10/29/2019,101,0,101,2,10,2019
6,10/29/2019,165,0,165,2,10,2019
7,10/29/2019,255,57,312,2,10,2019
8,10/29/2019,182,313,495,2,10,2019
9,10/29/2019,202,282,484,2,10,2019
10,10/29/2019,169,225,394,2,10,2019
11,10/29/2019,164,167,331,2,10,2019
12,10/29/2019,148,335,483,2,10,2019
13,10/29/2019,126,207,333,2,10,2019
14,10/29/2019,168,161,329,2,10,2019
15,10/29/2019,87,181,268,2,10,2019
16,10/29/2019,107,320,427,2,10,2019
17,10/29/2019,99,95,194,2,10,2019
18,10/29/2019,69,225,294,2,10,2019
19,10/29/2019,50,229,279,2,10,2019
20,10/29/2019,84,258,342,2,10,2019
21,10/29/2019,213,88,301,2,10,2019
22,10/29/2019,228,71,299,2,10,2019
23,10/29/2019,168,269,437,2,10,2019
0,10/30/2019,183,160,343,3,10,2019
1,10/30/2019,101,101,202,3,10,2019
2,10/30/2019,61,0,61,3,10,2019
3,10/30/2019,57,0,57,3,10,2019
4,10/30/2019,82,0,82,3,10,2019
5,10/30/2019,68,0,68,3,10,2019
6,10/30/2019,212,0,212,3,10,2019
7,10/30/2019,318,0,318,3,10,2019
8,10/30/2019,269,244,513,3,10,2019
9,10/30/2019,186,197,383,3,10,2019
10,10/30/2019,253,388,641,3,10,2019
11,10/30/2019,237,185,422,3,10,2019
12,10/30/2019,137,258,395,3,10,2019
13,10/30/2019,107,263,370,3,10,2019
14,10/30/2019,141,143,284,3,10,2019
15,10/30/2019,147,92,239,3,10,2019
16,10/30/2019,121,245,366,3,10,2019
17,10/30/2019,150,115,265,3,10,2019
18,10/30/2019,126,168,294,3,10,2019
19,10/30/2019,60,238,298,3,10,2019
20,10/30/2019,77,236,313,3,10,2019
21,10/30/2019,252,205,457,3,10,2019
22,10/30/2019,240,73,313,3,10,2019
23,10/30/2019,317,245,562,3,10,2019
0,10/31/2019,199,144,343,4,10,2019
1,10/31/2019,64,81,145,4,10,2019
2,10/31/2019,50,42,92,4,10,2019
3,10/31/2019,75,0,75,4,10,2019
4,10/31/2019,115,0,115,4,10,2019
5,10/31/2019,231,0,231,4,10,2019
6,10/31/2019,308,0,308,4,10,2019
7,10/31/2019,320,55,375,4,10,2019
8,10/31/2019,349,352,701,4,10,2019
9,10/31/2019,151,311,462,4,10,2019
10,10/31/2019,217,249,466,4,10,2019
11,10/31/2019,235,114,349,4,10,2019
12,10/31/2019,150,302,452,4,10,2019
13,10/31/2019,129,122,251,4,10,2019
14,10/31/2019,102,166,268,4,10,2019
15,10/31/2019,93,232,325,4,10,2019
16,10/31/2019,153,139,292,4,10,2019
17,10/31/2019,162,60,222,4,10,2019
18,10/31/2019,165,201,366,4,10,2019
19,10/31/2019,124,154,278,4,10,2019
20,10/31/2019,85,144,229,4,10,2019
21,10/31/2019,171,152,323,4,10,2019
22,10/31/2019,345,143,488,4,10,2019
23,10/31/2019,254,118,372,4,10,2019
0,11/1/2019,178,247,425,5,11,2019
1,11/1/2019,50,29,79,5,11,2019
2,11/1/2019,71,0,71,5,11,2019
3,11/1/2019,155,0,155,5,11,2019
4,11/1/2019,115,0,115,5,11,2019
5,11/1/2019,155,0,155,5,11,2019
6,11/1/2019,356,64,420,5,11,2019
7,11/1/2019,353,43,396,5,11,2019
8,11/1/2019,338,260,598,5,11,2019
9,11/1/2019,310,169,479,5,11,2019
10,11/1/2019,142,293,435,5,11,2019
11,11/1/2019,129,134,263,5,11,2019
12,11/1/2019,123,250,373,5,11,2019
13,11/1/2019,168,0,168,5,11,2019
14,11/1/2019,177,56,233,5,11,2019
15,11/1/2019,177,278,455,5,11,2019
16,11/1/2019,143,193,336,5,11,2019
17,11/1/2019,138,76,214,5,11,2019
18,11/1/2019,132,93,225,5,11,2019
19,11/1/2019,99,194,293,5,11,2019
20,11/1/2019,83,165,248,5,11,2019
21,11/1/2019,218,146,364,5,11,2019
22,11/1/2019,270,138,408,5,11,2019
23,11/1/2019,264,110,374,5,11,2019
0,11/2/2019,226,135,361,6,11,2019
1,11/2/2019,92,50,142,6,11,2019
2,11/2/2019,75,13,88,6,11,2019
3,11/2/2019,107,0,107,6,11,2019
4,11/2/2019,63,1,64,6,11,2019
5,11/2/2019,87,1,88,6,11,2019
6,11/2/2019,233,0,233,6,11,2019
7,11/2/2019,317,113,430,6,11,2019
8,11/2/2019,390,398,788,6,11,2019
9,11/2/2019,293,246,539,6,11,2019
10,11/2/2019,174,240,414,6,11,2019
11,11/2/2019,153,136,289,6,11,2019
12,11/2/2019,119,262,381,6,11,2019
13,11/2/2019,159,65,224,6,11,2019
14,11/2/2019,172,162,334,6,11,2019
15,11/2/2019,167,252,419,6,11,2019
16,11/2/2019,135,314,449,6,11,2019
17,11/2/2019,127,121,248,6,11,2019
18,11/2/2019,155,58,213,6,11,2019
19,11/2/2019,61,311,372,6,11,2019
20,11/2/2019,83,175,258,6,11,2019
21,11/2/2019,164,230,394,6,11,2019
22,11/2/2019,177,145,322,6,11,2019
23,11/2/2019,151,124,275,6,11,2019
0,11/3/2019,86,126,212,7,11,2019
1,11/3/2019,72,12,84,7,11,2019
2,11/3/2019,45,0,45,7,11,2019
3,11/3/2019,72,0,72,7,11,2019
4,11/3/2019,85,0,85,7,11,2019
5,11/3/2019,169,0,169,7,11,2019
6,11/3/2019,292,56,348,7,11,2019
7,11/3/2019,282,332,614,7,11,2019
8,11/3/2019,164,631,795,7,11,2019
9,11/3/2019,124,301,425,7,11,2019
10,11/3/2019,176,147,323,7,11,2019
11,11/3/2019,183,385,568,7,11,2019
12,11/3/2019,197,192,389,7,11,2019
13,11/3/2019,179,301,480,7,11,2019
14,11/3/2019,170,187,357,7,11,2019
15,11/3/2019,128,342,470,7,11,2019
16,11/3/2019,160,199,359,7,11,2019
17,11/3/2019,126,254,380,7,11,2019
18,11/3/2019,87,214,301,7,11,2019
19,11/3/2019,62,404,466,7,11,2019
20,11/3/2019,161,74,235,7,11,2019
21,11/3/2019,186,201,387,7,11,2019
22,11/3/2019,168,367,535,7,11,2019
23,11/3/2019,148,465,613,7,11,2019
0,11/4/2019,69,207,276,1,11,2019
1,11/4/2019,37,0,37,1,11,2019
2,11/4/2019,12,0,12,1,11,2019
3,11/4/2019,69,0,69,1,11,2019
4,11/4/2019,87,0,87,1,11,2019
5,11/4/2019,146,0,146,1,11,2019
6,11/4/2019,246,59,305,1,11,2019
7,11/4/2019,214,399,613,1,11,2019
8,11/4/2019,126,356,482,1,11,2019
9,11/4/2019,121,358,479,1,11,2019
10,11/4/2019,149,186,335,1,11,2019
11,11/4/2019,143,221,364,1,11,2019
12,11/4/2019,104,207,311,1,11,2019
13,11/4/2019,121,272,393,1,11,2019
14,11/4/2019,160,102,262,1,11,2019
15,11/4/2019,180,442,622,1,11,2019
16,11/4/2019,159,171,330,1,11,2019
17,11/4/2019,140,352,492,1,11,2019
18,11/4/2019,63,240,303,1,11,2019
19,11/4/2019,43,495,538,1,11,2019
20,11/4/2019,108,93,201,1,11,2019
21,11/4/2019,207,146,353,1,11,2019
22,11/4/2019,197,309,506,1,11,2019
23,11/4/2019,61,430,491,1,11,2019
0,11/5/2019,43,251,294,2,11,2019
1,11/5/2019,41,14,55,2,11,2019
2,11/5/2019,18,49,67,2,11,2019
3,11/5/2019,48,1,49,2,11,2019
4,11/5/2019,120,0,120,2,11,2019
5,11/5/2019,118,1,119,2,11,2019
6,11/5/2019,183,47,230,2,11,2019
7,11/5/2019,236,350,586,2,11,2019
8,11/5/2019,172,335,507,2,11,2019
9,11/5/2019,107,179,286,2,11,2019
10,11/5/2019,103,312,415,2,11,2019
11,11/5/2019,100,156,256,2,11,2019
12,11/5/2019,115,166,281,2,11,2019
13,11/5/2019,158,227,385,2,11,2019
14,11/5/2019,104,228,332,2,11,2019
15,11/5/2019,123,296,419,2,11,2019
16,11/5/2019,124,193,317,2,11,2019
17,11/5/2019,103,223,326,2,11,2019
18,11/5/2019,23,171,194,2,11,2019
19,11/5/2019,30,190,220,2,11,2019
20,11/5/2019,72,54,126,2,11,2019
21,11/5/2019,237,340,577,2,11,2019
22,11/5/2019,236,182,418,2,11,2019
23,11/5/2019,152,280,432,2,11,2019
0,11/6/2019,71,230,301,3,11,2019
1,11/6/2019,20,23,43,3,11,2019
2,11/6/2019,33,0,33,3,11,2019
3,11/6/2019,54,0,54,3,11,2019
4,11/6/2019,86,0,86,3,11,2019
5,11/6/2019,91,0,91,3,11,2019
6,11/6/2019,253,0,253,3,11,2019
7,11/6/2019,170,256,426,3,11,2019
8,11/6/2019,187,270,457,3,11,2019
9,11/6/2019,139,239,378,3,11,2019
10,11/6/2019,96,242,338,3,11,2019
11,11/6/2019,155,175,330,3,11,2019
12,11/6/2019,142,173,315,3,11,2019
13,11/6/2019,137,107,244,3,11,2019
14,11/6/2019,86,199,285,3,11,2019
15,11/6/2019,121,216,337,3,11,2019
16,11/6/2019,106,138,244,3,11,2019
17,11/6/2019,78,90,168,3,11,2019
18,11/6/2019,64,206,270,3,11,2019
19,11/6/2019,40,200,240,3,11,2019
20,11/6/2019,81,85,166,3,11,2019
21,11/6/2019,167,164,331,3,11,2019
22,11/6/2019,227,189,416,3,11,2019
23,11/6/2019,149,202,351,3,11,2019
0,11/7/2019,88,175,263,4,11,2019
1,11/7/2019,25,0,25,4,11,2019
2,11/7/2019,60,1,61,4,11,2019
3,11/7/2019,149,0,149,4,11,2019
4,11/7/2019,247,0,247,4,11,2019
5,11/7/2019,334,2,336,4,11,2019
6,11/7/2019,380,14,394,4,11,2019
7,11/7/2019,332,5,337,4,11,2019
8,11/7/2019,271,357,628,4,11,2019
9,11/7/2019,239,265,504,4,11,2019
10,11/7/2019,166,88,254,4,11,2019
11,11/7/2019,279,192,471,4,11,2019
12,11/7/2019,152,243,395,4,11,2019
13,11/7/2019,205,146,351,4,11,2019
14,11/7/2019,153,106,259,4,11,2019
15,11/7/2019,106,321,427,4,11,2019
16,11/7/2019,185,68,253,4,11,2019
17,11/7/2019,176,166,342,4,11,2019
18,11/7/2019,97,221,318,4,11,2019
19,11/7/2019,50,366,416,4,11,2019
20,11/7/2019,165,145,310,4,11,2019
21,11/7/2019,317,164,481,4,11,2019
22,11/7/2019,334,150,484,4,11,2019
23,11/7/2019,299,0,299,4,11,2019
0,11/8/2019,162,3,165,5,11,2019
1,11/8/2019,75,3,78,5,11,2019
2,11/8/2019,55,1,56,5,11,2019
3,11/8/2019,127,32,159,5,11,2019
4,11/8/2019,165,65,230,5,11,2019
5,11/8/2019,265,26,291,5,11,2019
6,11/8/2019,380,46,426,5,11,2019
7,11/8/2019,318,164,482,5,11,2019
8,11/8/2019,334,268,602,5,11,2019
9,11/8/2019,187,161,348,5,11,2019
10,11/8/2019,121,215,336,5,11,2019
11,11/8/2019,227,182,409,5,11,2019
12,11/8/2019,104,89,193,5,11,2019
13,11/8/2019,164,226,390,5,11,2019
14,11/8/2019,157,131,288,5,11,2019
15,11/8/2019,175,223,398,5,11,2019
16,11/8/2019,117,164,281,5,11,2019
17,11/8/2019,155,76,231,5,11,2019
18,11/8/2019,76,129,205,5,11,2019
19,11/8/2019,81,284,365,5,11,2019
20,11/8/2019,150,281,431,5,11,2019
21,11/8/2019,279,226,505,5,11,2019
22,11/8/2019,327,173,500,5,11,2019
23,11/8/2019,207,170,377,5,11,2019
0,11/9/2019,167,174,341,6,11,2019
1,11/9/2019,67,123,190,6,11,2019
2,11/9/2019,93,0,93,6,11,2019
3,11/9/2019,130,1,131,6,11,2019
4,11/9/2019,142,0,142,6,11,2019
5,11/9/2019,162,0,162,6,11,2019
6,11/9/2019,374,0,374,6,11,2019
7,11/9/2019,316,279,595,6,11,2019
8,11/9/2019,337,338,675,6,11,2019
9,11/9/2019,218,365,583,6,11,2019
10,11/9/2019,132,269,401,6,11,2019
11,11/9/2019,122,284,406,6,11,2019
12,11/9/2019,149,223,372,6,11,2019
13,11/9/2019,164,172,336,6,11,2019
14,11/9/2019,118,281,399,6,11,2019
15,11/9/2019,152,190,342,6,11,2019
16,11/9/2019,158,229,387,6,11,2019
17,11/9/2019,88,425,513,6,11,2019
18,11/9/2019,53,200,253,6,11,2019
19,11/9/2019,48,368,416,6,11,2019
20,11/9/2019,88,129,217,6,11,2019
21,11/9/2019,264,71,335,6,11,2019
22,11/9/2019,171,345,516,6,11,2019
23,11/9/2019,157,159,316,6,11,2019
0,11/10/2019,91,106,197,7,11,2019
1,11/10/2019,21,0,21,7,11,2019
2,11/10/2019,44,0,44,7,11,2019
3,11/10/2019,81,0,81,7,11,2019
4,11/10/2019,98,0,98,7,11,2019
5,11/10/2019,192,0,192,7,11,2019
6,11/10/2019,228,1,229,7,11,2019
7,11/10/2019,230,0,230,7,11,2019
8,11/10/2019,127,64,191,7,11,2019
9,11/10/2019,119,387,506,7,11,2019
10,11/10/2019,151,535,686,7,11,2019
11,11/10/2019,185,364,549,7,11,2019
12,11/10/2019,131,373,504,7,11,2019
13,11/10/2019,138,190,328,7,11,2019
14,11/10/2019,134,117,251,7,11,2019
15,11/10/2019,143,417,560,7,11,2019
16,11/10/2019,147,19,166,7,11,2019
17,11/10/2019,119,204,323,7,11,2019
18,11/10/2019,85,335,420,7,11,2019
19,11/10/2019,72,424,496,7,11,2019
20,11/10/2019,131,58,189,7,11,2019
21,11/10/2019,197,122,319,7,11,2019
22,11/10/2019,201,319,520,7,11,2019
23,11/10/2019,102,441,543,7,11,2019
0,11/11/2019,86,99,185,1,11,2019
1,11/11/2019,22,214,236,1,11,2019
2,11/11/2019,13,61,74,1,11,2019
3,11/11/2019,59,0,59,1,11,2019
4,11/11/2019,77,0,77,1,11,2019
5,11/11/2019,134,0,134,1,11,2019
6,11/11/2019,216,47,263,1,11,2019
7,11/11/2019,187,385,572,1,11,2019
8,11/11/2019,147,424,571,1,11,2019
9,11/11/2019,138,316,454,1,11,2019
10,11/11/2019,111,218,329,1,11,2019
11,11/11/2019,115,188,303,1,11,2019
12,11/11/2019,103,221,324,1,11,2019
13,11/11/2019,94,265,359,1,11,2019
14,11/11/2019,131,217,348,1,11,2019
15,11/11/2019,175,357,532,1,11,2019
16,11/11/2019,143,350,493,1,11,2019
17,11/11/2019,155,149,304,1,11,2019
18,11/11/2019,47,440,487,1,11,2019
19,11/11/2019,17,292,309,1,11,2019
20,11/11/2019,115,261,376,1,11,2019
21,11/11/2019,149,79,228,1,11,2019
22,11/11/2019,132,319,451,1,11,2019
23,11/11/2019,73,632,705,1,11,2019
0,11/12/2019,54,453,507,2,11,2019
1,11/12/2019,57,14,71,2,11,2019
2,11/12/2019,25,0,25,2,11,2019
3,11/12/2019,105,1,106,2,11,2019
4,11/12/2019,70,0,70,2,11,2019
5,11/12/2019,162,0,162,2,11,2019
6,11/12/2019,275,0,275,2,11,2019
7,11/12/2019,192,0,192,2,11,2019
8,11/12/2019,174,1,175,2,11,2019
9,11/12/2019,71,219,290,2,11,2019
10,11/12/2019,83,384,467,2,11,2019
11,11/12/2019,94,416,510,2,11,2019
12,11/12/2019,108,145,253,2,11,2019
13,11/12/2019,113,206,319,2,11,2019
14,11/12/2019,86,165,251,2,11,2019
15,11/12/2019,112,230,342,2,11,2019
16,11/12/2019,109,97,206,2,11,2019
17,11/12/2019,64,288,352,2,11,2019
18,11/12/2019,35,173,208,2,11,2019
19,11/12/2019,30,397,427,2,11,2019
20,11/12/2019,81,76,157,2,11,2019
21,11/12/2019,153,0,153,2,11,2019
22,11/12/2019,105,0,105,2,11,2019
23,11/12/2019,59,0,59,2,11,2019
0,11/13/2019,53,0,53,3,11,2019
1,11/13/2019,29,0,29,3,11,2019
2,11/13/2019,35,0,35,3,11,2019
3,11/13/2019,0,0,0,3,11,2019
4,11/13/2019,0,0,0,3,11,2019
5,11/13/2019,120,0,120,3,11,2019
6,11/13/2019,202,0,202,3,11,2019
7,11/13/2019,236,0,236,3,11,2019
8,11/13/2019,203,96,299,3,11,2019
9,11/13/2019,147,562,709,3,11,2019
10,11/13/2019,136,442,578,3,11,2019
11,11/13/2019,174,430,604,3,11,2019
12,11/13/2019,95,291,386,3,11,2019
13,11/13/2019,74,101,175,3,11,2019
14,11/13/2019,107,141,248,3,11,2019
15,11/13/2019,65,114,179,3,11,2019
16,11/13/2019,87,226,313,3,11,2019
17,11/13/2019,94,185,279,3,11,2019
18,11/13/2019,38,207,245,3,11,2019
19,11/13/2019,30,420,450,3,11,2019
20,11/13/2019,99,212,311,3,11,2019
21,11/13/2019,219,224,443,3,11,2019
22,11/13/2019,175,132,307,3,11,2019
23,11/13/2019,117,303,420,3,11,2019
0,11/14/2019,82,164,246,4,11,2019
1,11/14/2019,27,80,107,4,11,2019
2,11/14/2019,46,49,95,4,11,2019
3,11/14/2019,88,39,127,4,11,2019
4,11/14/2019,165,0,165,4,11,2019
5,11/14/2019,241,0,241,4,11,2019
6,11/14/2019,242,0,242,4,11,2019
7,11/14/2019,245,56,301,4,11,2019
8,11/14/2019,214,32,246,4,11,2019
9,11/14/2019,137,390,527,4,11,2019
10,11/14/2019,149,217,366,4,11,2019
11,11/14/2019,147,524,671,4,11,2019
12,11/14/2019,97,563,660,4,11,2019
13,11/14/2019,158,263,421,4,11,2019
14,11/14/2019,104,110,214,4,11,2019
15,11/14/2019,74,197,271,4,11,2019
16,11/14/2019,118,166,284,4,11,2019
17,11/14/2019,127,198,325,4,11,2019
18,11/14/2019,65,401,466,4,11,2019
19,11/14/2019,17,612,629,4,11,2019
20,11/14/2019,105,220,325,4,11,2019
21,11/14/2019,205,163,368,4,11,2019
22,11/14/2019,250,216,466,4,11,2019
23,11/14/2019,153,413,566,4,11,2019
0,11/15/2019,73,549,622,5,11,2019
1,11/15/2019,52,46,98,5,11,2019
2,11/15/2019,37,0,37,5,11,2019
3,11/15/2019,139,38,177,5,11,2019
4,11/15/2019,151,5,156,5,11,2019
5,11/15/2019,168,0,168,5,11,2019
6,11/15/2019,280,121,401,5,11,2019
7,11/15/2019,297,222,519,5,11,2019
8,11/15/2019,186,516,702,5,11,2019
9,11/15/2019,153,374,527,5,11,2019
10,11/15/2019,144,306,450,5,11,2019
11,11/15/2019,85,225,310,5,11,2019
12,11/15/2019,81,319,400,5,11,2019
13,11/15/2019,123,133,256,5,11,2019
14,11/15/2019,107,181,288,5,11,2019
15,11/15/2019,78,291,369,5,11,2019
16,11/15/2019,86,280,366,5,11,2019
17,11/15/2019,74,192,266,5,11,2019
18,11/15/2019,65,267,332,5,11,2019
19,11/15/2019,32,377,409,5,11,2019
20,11/15/2019,99,170,269,5,11,2019
21,11/15/2019,164,368,532,5,11,2019
22,11/15/2019,262,208,470,5,11,2019
23,11/15/2019,185,224,409,5,11,2019
0,11/16/2019,92,313,405,6,11,2019
1,11/16/2019,45,18,63,6,11,2019
2,11/16/2019,45,0,45,6,11,2019
3,11/16/2019,113,1,114,6,11,2019
4,11/16/2019,126,0,126,6,11,2019
5,11/16/2019,140,3,143,6,11,2019
6,11/16/2019,301,0,301,6,11,2019
7,11/16/2019,311,383,694,6,11,2019
8,11/16/2019,232,427,659,6,11,2019
9,11/16/2019,156,276,432,6,11,2019
10,11/16/2019,118,238,356,6,11,2019
11,11/16/2019,88,364,452,6,11,2019
12,11/16/2019,106,115,221,6,11,2019
13,11/16/2019,106,262,368,6,11,2019
14,11/16/2019,94,296,390,6,11,2019
15,11/16/2019,145,207,352,6,11,2019
16,11/16/2019,114,307,421,6,11,2019
17,11/16/2019,70,167,237,6,11,2019
18,11/16/2019,55,185,240,6,11,2019
19,11/16/2019,31,397,428,6,11,2019
20,11/16/2019,105,141,246,6,11,2019
21,11/16/2019,191,280,471,6,11,2019
22,11/16/2019,197,258,455,6,11,2019
23,11/16/2019,136,231,367,6,11,2019
0,11/17/2019,115,77,192,7,11,2019
1,11/17/2019,33,0,33,7,11,2019
2,11/17/2019,69,0,69,7,11,2019
3,11/17/2019,95,0,95,7,11,2019
4,11/17/2019,84,0,84,7,11,2019
5,11/17/2019,202,1,203,7,11,2019
6,11/17/2019,265,99,364,7,11,2019
7,11/17/2019,278,338,616,7,11,2019
8,11/17/2019,109,373,482,7,11,2019
9,11/17/2019,139,321,460,7,11,2019
10,11/17/2019,206,89,295,7,11,2019
11,11/17/2019,212,280,492,7,11,2019
12,11/17/2019,174,371,545,7,11,2019
13,11/17/2019,144,224,368,7,11,2019
14,11/17/2019,146,163,309,7,11,2019
15,11/17/2019,192,214,406,7,11,2019
16,11/17/2019,159,246,405,7,11,2019
17,11/17/2019,123,221,344,7,11,2019
18,11/17/2019,41,320,361,7,11,2019
19,11/17/2019,61,294,355,7,11,2019
20,11/17/2019,180,328,508,7,11,2019
21,11/17/2019,195,46,241,7,11,2019
22,11/17/2019,241,246,487,7,11,2019
23,11/17/2019,145,553,698,7,11,2019
0,11/18/2019,103,73,176,1,11,2019
1,11/18/2019,37,74,111,1,11,2019
2,11/18/2019,29,8,37,1,11,2019
3,11/18/2019,79,9,88,1,11,2019
4,11/18/2019,133,0,133,1,11,2019
5,11/18/2019,196,0,196,1,11,2019
6,11/18/2019,412,46,458,1,11,2019
7,11/18/2019,350,361,711,1,11,2019
8,11/18/2019,341,324,665,1,11,2019
9,11/18/2019,206,154,360,1,11,2019
10,11/18/2019,159,194,353,1,11,2019
11,11/18/2019,165,95,260,1,11,2019
12,11/18/2019,202,229,431,1,11,2019
13,11/18/2019,245,135,380,1,11,2019
14,11/18/2019,275,59,334,1,11,2019
15,11/18/2019,416,204,620,1,11,2019
16,11/18/2019,345,125,470,1,11,2019
17,11/18/2019,221,146,367,1,11,2019
18,11/18/2019,155,134,289,1,11,2019
19,11/18/2019,84,244,328,1,11,2019
20,11/18/2019,138,51,189,1,11,2019
21,11/18/2019,268,107,375,1,11,2019
22,11/18/2019,233,120,353,1,11,2019
23,11/18/2019,131,209,340,1,11,2019
0,11/19/2019,91,103,194,2,11,2019
1,11/19/2019,53,52,105,2,11,2019
2,11/19/2019,62,0,62,2,11,2019
3,11/19/2019,96,1,97,2,11,2019
4,11/19/2019,121,0,121,2,11,2019
5,11/19/2019,202,0,202,2,11,2019
6,11/19/2019,311,38,349,2,11,2019
7,11/19/2019,306,161,467,2,11,2019
8,11/19/2019,234,228,462,2,11,2019
9,11/19/2019,243,229,472,2,11,2019
10,11/19/2019,160,100,260,2,11,2019
11,11/19/2019,125,191,316,2,11,2019
12,11/19/2019,179,67,246,2,11,2019
13,11/19/2019,185,302,487,2,11,2019
14,11/19/2019,192,237,429,2,11,2019
15,11/19/2019,220,194,414,2,11,2019
16,11/19/2019,192,116,308,2,11,2019
17,11/19/2019,208,186,394,2,11,2019
18,11/19/2019,78,91,169,2,11,2019
19,11/19/2019,44,275,319,2,11,2019
20,11/19/2019,140,139,279,2,11,2019
21,11/19/2019,332,226,558,2,11,2019
22,11/19/2019,283,136,419,2,11,2019
23,11/19/2019,209,275,484,2,11,2019
0,11/20/2019,59,155,214,3,11,2019
1,11/20/2019,36,33,69,3,11,2019
2,11/20/2019,37,26,63,3,11,2019
3,11/20/2019,66,0,66,3,11,2019
4,11/20/2019,132,1,133,3,11,2019
5,11/20/2019,151,0,151,3,11,2019
6,11/20/2019,358,0,358,3,11,2019
7,11/20/2019,263,232,495,3,11,2019
8,11/20/2019,213,170,383,3,11,2019
9,11/20/2019,207,249,456,3,11,2019
10,11/20/2019,170,235,405,3,11,2019
11,11/20/2019,166,183,349,3,11,2019
12,11/20/2019,135,91,226,3,11,2019
13,11/20/2019,167,249,416,3,11,2019
14,11/20/2019,153,53,206,3,11,2019
15,11/20/2019,169,195,364,3,11,2019
16,11/20/2019,156,167,323,3,11,2019
17,11/20/2019,130,231,361,3,11,2019
18,11/20/2019,49,86,135,3,11,2019
19,11/20/2019,49,250,299,3,11,2019
20,11/20/2019,183,73,256,3,11,2019
21,11/20/2019,248,145,393,3,11,2019
22,11/20/2019,246,169,415,3,11,2019
23,11/20/2019,136,156,292,3,11,2019
0,11/21/2019,145,52,197,4,11,2019
1,11/21/2019,41,51,92,4,11,2019
2,11/21/2019,62,0,62,4,11,2019
3,11/21/2019,157,0,157,4,11,2019
4,11/21/2019,268,0,268,4,11,2019
5,11/21/2019,342,0,342,4,11,2019
6,11/21/2019,462,2,464,4,11,2019
7,11/21/2019,357,206,563,4,11,2019
8,11/21/2019,285,291,576,4,11,2019
9,11/21/2019,244,275,519,4,11,2019
10,11/21/2019,230,86,316,4,11,2019
11,11/21/2019,237,159,396,4,11,2019
12,11/21/2019,190,282,472,4,11,2019
13,11/21/2019,229,144,373,4,11,2019
14,11/21/2019,217,172,389,4,11,2019
15,11/21/2019,193,171,364,4,11,2019
16,11/21/2019,219,67,286,4,11,2019
17,11/21/2019,195,211,406,4,11,2019
18,11/21/2019,123,95,218,4,11,2019
19,11/21/2019,82,312,394,4,11,2019
20,11/21/2019,246,117,363,4,11,2019
21,11/21/2019,432,168,600,4,11,2019
22,11/21/2019,370,166,536,4,11,2019
23,11/21/2019,247,272,519,4,11,2019
0,11/22/2019,224,160,384,5,11,2019
1,11/22/2019,73,18,91,5,11,2019
2,11/22/2019,83,0,83,5,11,2019
3,11/22/2019,280,0,280,5,11,2019
4,11/22/2019,260,0,260,5,11,2019
5,11/22/2019,268,0,268,5,11,2019
6,11/22/2019,398,50,448,5,11,2019
7,11/22/2019,382,198,580,5,11,2019
8,11/22/2019,309,165,474,5,11,2019
9,11/22/2019,288,254,542,5,11,2019
10,11/22/2019,270,370,640,5,11,2019
11,11/22/2019,284,171,455,5,11,2019
12,11/22/2019,261,32,293,5,11,2019
13,11/22/2019,279,189,468,5,11,2019
14,11/22/2019,251,108,359,5,11,2019
15,11/22/2019,221,419,640,5,11,2019
16,11/22/2019,212,137,349,5,11,2019
17,11/22/2019,168,215,383,5,11,2019
18,11/22/2019,95,82,177,5,11,2019
19,11/22/2019,98,94,192,5,11,2019
20,11/22/2019,279,155,434,5,11,2019
21,11/22/2019,432,255,687,5,11,2019
22,11/22/2019,438,216,654,5,11,2019
23,11/22/2019,457,300,757,5,11,2019
0,11/23/2019,208,128,336,6,11,2019
1,11/23/2019,81,114,195,6,11,2019
2,11/23/2019,133,52,185,6,11,2019
3,11/23/2019,262,1,263,6,11,2019
4,11/23/2019,204,0,204,6,11,2019
5,11/23/2019,276,1,277,6,11,2019
6,11/23/2019,522,0,522,6,11,2019
7,11/23/2019,646,302,948,6,11,2019
8,11/23/2019,541,394,935,6,11,2019
9,11/23/2019,382,234,616,6,11,2019
10,11/23/2019,363,303,666,6,11,2019
11,11/23/2019,304,213,517,6,11,2019
12,11/23/2019,256,23,279,6,11,2019
13,11/23/2019,283,335,618,6,11,2019
14,11/23/2019,211,383,594,6,11,2019
15,11/23/2019,264,266,530,6,11,2019
16,11/23/2019,294,158,452,6,11,2019
17,11/23/2019,208,117,325,6,11,2019
18,11/23/2019,124,269,393,6,11,2019
19,11/23/2019,83,351,434,6,11,2019
20,11/23/2019,178,338,516,6,11,2019
21,11/23/2019,410,146,556,6,11,2019
22,11/23/2019,410,78,488,6,11,2019
23,11/23/2019,292,292,584,6,11,2019
0,11/24/2019,98,50,148,7,11,2019
1,11/24/2019,52,22,74,7,11,2019
2,11/24/2019,67,93,160,7,11,2019
3,11/24/2019,162,0,162,7,11,2019
4,11/24/2019,240,0,240,7,11,2019
5,11/24/2019,317,0,317,7,11,2019
6,11/24/2019,459,76,535,7,11,2019
7,11/24/2019,386,352,738,7,11,2019
8,11/24/2019,365,368,733,7,11,2019
9,11/24/2019,208,330,538,7,11,2019
10,11/24/2019,226,150,376,7,11,2019
11,11/24/2019,331,277,608,7,11,2019
12,11/24/2019,201,144,345,7,11,2019
13,11/24/2019,174,362,536,7,11,2019
14,11/24/2019,198,88,286,7,11,2019
15,11/24/2019,209,330,539,7,11,2019
16,11/24/2019,202,137,339,7,11,2019
17,11/24/2019,142,144,286,7,11,2019
18,11/24/2019,77,335,412,7,11,2019
19,11/24/2019,91,337,428,7,11,2019
20,11/24/2019,18,12,30,7,11,2019
21,11/24/2019,4,22,26,7,11,2019
22,11/24/2019,398,131,529,7,11,2019
23,11/24/2019,157,498,655,7,11,2019
0,11/25/2019,155,147,302,1,11,2019
1,11/25/2019,50,47,97,1,11,2019
2,11/25/2019,31,0,31,1,11,2019
3,11/25/2019,85,0,85,1,11,2019
4,11/25/2019,140,0,140,1,11,2019
5,11/25/2019,263,0,263,1,11,2019
6,11/25/2019,344,72,416,1,11,2019
7,11/25/2019,341,280,621,1,11,2019
8,11/25/2019,235,377,612,1,11,2019
9,11/25/2019,197,292,489,1,11,2019
10,11/25/2019,177,253,430,1,11,2019
11,11/25/2019,238,192,430,1,11,2019
12,11/25/2019,230,83,313,1,11,2019
13,11/25/2019,130,311,441,1,11,2019
14,11/25/2019,163,91,254,1,11,2019
15,11/25/2019,158,420,578,1,11,2019
16,11/25/2019,143,148,291,1,11,2019
17,11/25/2019,128,176,304,1,11,2019
18,11/25/2019,69,119,188,1,11,2019
19,11/25/2019,38,361,399,1,11,2019
20,11/25/2019,147,233,380,1,11,2019
21,11/25/2019,346,73,419,1,11,2019
22,11/25/2019,231,288,519,1,11,2019
23,11/25/2019,175,220,395,1,11,2019
0,11/26/2019,52,264,316,2,11,2019
1,11/26/2019,61,59,120,2,11,2019
2,11/26/2019,44,0,44,2,11,2019
3,11/26/2019,79,0,79,2,11,2019
4,11/26/2019,192,16,208,2,11,2019
5,11/26/2019,237,0,237,2,11,2019
6,11/26/2019,401,6,407,2,11,2019
7,11/26/2019,298,358,656,2,11,2019
8,11/26/2019,294,352,646,2,11,2019
9,11/26/2019,145,192,337,2,11,2019
10,11/26/2019,120,116,236,2,11,2019
11,11/26/2019,126,372,498,2,11,2019
12,11/26/2019,142,316,458,2,11,2019
13,11/26/2019,192,180,372,2,11,2019
14,11/26/2019,121,196,317,2,11,2019
15,11/26/2019,153,379,532,2,11,2019
16,11/26/2019,215,89,304,2,11,2019
17,11/26/2019,145,290,435,2,11,2019
18,11/26/2019,57,346,403,2,11,2019
19,11/26/2019,127,201,328,2,11,2019
20,11/26/2019,237,65,302,2,11,2019
21,11/26/2019,357,281,638,2,11,2019
22,11/26/2019,364,261,625,2,11,2019
23,11/26/2019,218,360,578,2,11,2019
0,11/27/2019,190,207,397,3,11,2019
1,11/27/2019,36,42,78,3,11,2019
2,11/27/2019,67,0,67,3,11,2019
3,11/27/2019,107,0,107,3,11,2019
4,11/27/2019,165,0,165,3,11,2019
5,11/27/2019,297,0,297,3,11,2019
6,11/27/2019,487,0,487,3,11,2019
7,11/27/2019,377,379,756,3,11,2019
8,11/27/2019,314,380,694,3,11,2019
9,11/27/2019,228,342,570,3,11,2019
10,11/27/2019,200,172,372,3,11,2019
11,11/27/2019,225,447,672,3,11,2019
12,11/27/2019,183,195,378,3,11,2019
13,11/27/2019,163,272,435,3,11,2019
14,11/27/2019,177,398,575,3,11,2019
15,11/27/2019,165,194,359,3,11,2019
16,11/27/2019,191,194,385,3,11,2019
17,11/27/2019,226,245,471,3,11,2019
18,11/27/2019,162,285,447,3,11,2019
19,11/27/2019,111,429,540,3,11,2019
20,11/27/2019,254,374,628,3,11,2019
21,11/27/2019,358,116,474,3,11,2019
22,11/27/2019,394,351,745,3,11,2019
23,11/27/2019,193,304,497,3,11,2019
0,11/28/2019,131,346,477,4,11,2019
1,11/28/2019,99,68,167,4,11,2019
2,11/28/2019,89,21,110,4,11,2019
3,11/28/2019,237,0,237,4,11,2019
4,11/28/2019,241,67,308,4,11,2019
5,11/28/2019,369,3,372,4,11,2019
6,11/28/2019,535,0,535,4,11,2019
7,11/28/2019,473,342,815,4,11,2019
8,11/28/2019,359,437,796,4,11,2019
9,11/28/2019,245,423,668,4,11,2019
10,11/28/2019,171,157,328,4,11,2019
11,11/28/2019,191,294,485,4,11,2019
12,11/28/2019,128,215,343,4,11,2019
13,11/28/2019,140,168,308,4,11,2019
14,11/28/2019,202,247,449,4,11,2019
15,11/28/2019,156,341,497,4,11,2019
16,11/28/2019,152,193,345,4,11,2019
17,11/28/2019,131,231,362,4,11,2019
18,11/28/2019,34,200,234,4,11,2019
19,11/28/2019,43,358,401,4,11,2019
20,11/28/2019,110,119,229,4,11,2019
21,11/28/2019,227,294,521,4,11,2019
22,11/28/2019,272,438,710,4,11,2019
23,11/28/2019,191,425,616,4,11,2019
0,11/29/2019,99,264,363,5,11,2019
1,11/29/2019,59,61,120,5,11,2019
2,11/29/2019,41,52,93,5,11,2019
3,11/29/2019,92,0,92,5,11,2019
4,11/29/2019,168,0,168,5,11,2019
5,11/29/2019,196,0,196,5,11,2019
6,11/29/2019,285,82,367,5,11,2019
7,11/29/2019,410,278,688,5,11,2019
8,11/29/2019,251,487,738,5,11,2019
9,11/29/2019,198,163,361,5,11,2019
10,11/29/2019,168,450,618,5,11,2019
11,11/29/2019,195,282,477,5,11,2019
12,11/29/2019,104,157,261,5,11,2019
13,11/29/2019,134,195,329,5,11,2019
14,11/29/2019,164,304,468,5,11,2019
15,11/29/2019,157,337,494,5,11,2019
16,11/29/2019,121,209,330,5,11,2019
17,11/29/2019,122,341,463,5,11,2019
18,11/29/2019,89,209,298,5,11,2019
19,11/29/2019,74,460,534,5,11,2019
20,11/29/2019,174,214,388,5,11,2019
21,11/29/2019,188,221,409,5,11,2019
22,11/29/2019,246,421,667,5,11,2019
23,11/29/2019,183,384,567,5,11,2019
0,11/30/2019,100,230,330,6,11,2019
1,11/30/2019,60,137,197,6,11,2019
2,11/30/2019,44,140,184,6,11,2019
3,11/30/2019,79,7,86,6,11,2019
4,11/30/2019,49,40,89,6,11,2019
5,11/30/2019,146,0,146,6,11,2019
6,11/30/2019,304,0,304,6,11,2019
7,11/30/2019,345,297,642,6,11,2019
8,11/30/2019,329,561,890,6,11,2019
9,11/30/2019,177,414,591,6,11,2019
10,11/30/2019,129,444,573,6,11,2019
11,11/30/2019,159,344,503,6,11,2019
12,11/30/2019,179,127,306,6,11,2019
13,11/30/2019,218,346,564,6,11,2019
14,11/30/2019,146,224,370,6,11,2019
15,11/30/2019,195,456,651,6,11,2019
16,11/30/2019,227,491,718,6,11,2019
17,11/30/2019,201,388,589,6,11,2019
18,11/30/2019,90,399,489,6,11,2019
19,11/30/2019,106,680,786,6,11,2019
20,11/30/2019,184,291,475,6,11,2019
21,11/30/2019,274,320,594,6,11,2019
22,11/30/2019,252,727,979,6,11,2019
23,11/30/2019,209,502,711,6,11,2019
0,12/1/2019,140,407,547,7,12,2019
1,12/1/2019,75,76,151,7,12,2019
2,12/1/2019,94,0,94,7,12,2019
3,12/1/2019,149,0,149,7,12,2019
4,12/1/2019,173,1,174,7,12,2019
5,12/1/2019,260,1,261,7,12,2019
6,12/1/2019,336,127,463,7,12,2019
7,12/1/2019,324,456,780,7,12,2019
8,12/1/2019,286,656,942,7,12,2019
9,12/1/2019,157,483,640,7,12,2019
10,12/1/2019,192,147,339,7,12,2019
11,12/1/2019,239,359,598,7,12,2019
12,12/1/2019,172,376,548,7,12,2019
13,12/1/2019,227,398,625,7,12,2019
14,12/1/2019,260,449,709,7,12,2019
15,12/1/2019,209,414,623,7,12,2019
16,12/1/2019,247,353,600,7,12,2019
17,12/1/2019,188,309,497,7,12,2019
18,12/1/2019,92,527,619,7,12,2019
19,12/1/2019,119,431,550,7,12,2019
20,12/1/2019,216,515,731,7,12,2019
21,12/1/2019,344,194,538,7,12,2019
22,12/1/2019,263,600,863,7,12,2019
23,12/1/2019,168,771,939,7,12,2019
0,12/2/2019,102,700,802,1,12,2019
1,12/2/2019,63,63,126,1,12,2019
2,12/2/2019,61,0,61,1,12,2019
3,12/2/2019,86,0,86,1,12,2019
4,12/2/2019,122,0,122,1,12,2019
5,12/2/2019,221,0,221,1,12,2019
6,12/2/2019,326,96,422,1,12,2019
7,12/2/2019,304,553,857,1,12,2019
8,12/2/2019,214,668,882,1,12,2019
9,12/2/2019,220,370,590,1,12,2019
10,12/2/2019,202,347,549,1,12,2019
11,12/2/2019,148,328,476,1,12,2019
12,12/2/2019,200,274,474,1,12,2019
13,12/2/2019,162,202,364,1,12,2019
14,12/2/2019,225,291,516,1,12,2019
15,12/2/2019,214,550,764,1,12,2019
16,12/2/2019,200,248,448,1,12,2019
17,12/2/2019,143,279,422,1,12,2019
18,12/2/2019,130,285,415,1,12,2019
19,12/2/2019,117,499,616,1,12,2019
20,12/2/2019,149,341,490,1,12,2019
21,12/2/2019,261,275,536,1,12,2019
22,12/2/2019,269,502,771,1,12,2019
23,12/2/2019,113,457,570,1,12,2019
0,12/3/2019,97,437,534,2,12,2019
1,12/3/2019,84,162,246,2,12,2019
2,12/3/2019,49,0,49,2,12,2019
3,12/3/2019,91,1,92,2,12,2019
4,12/3/2019,134,0,134,2,12,2019
5,12/3/2019,179,3,182,2,12,2019
6,12/3/2019,322,66,388,2,12,2019
7,12/3/2019,253,416,669,2,12,2019
8,12/3/2019,174,335,509,2,12,2019
9,12/3/2019,176,366,542,2,12,2019
10,12/3/2019,141,203,344,2,12,2019
11,12/3/2019,121,235,356,2,12,2019
12,12/3/2019,129,298,427,2,12,2019
13,12/3/2019,155,90,245,2,12,2019
14,12/3/2019,168,311,479,2,12,2019
15,12/3/2019,147,323,470,2,12,2019
16,12/3/2019,186,160,346,2,12,2019
17,12/3/2019,83,277,360,2,12,2019
18,12/3/2019,26,229,255,2,12,2019
19,12/3/2019,43,178,221,2,12,2019
20,12/3/2019,159,136,295,2,12,2019
21,12/3/2019,238,349,587,2,12,2019
22,12/3/2019,214,293,507,2,12,2019
23,12/3/2019,199,295,494,2,12,2019
0,12/4/2019,100,166,266,3,12,2019
1,12/4/2019,21,66,87,3,12,2019
2,12/4/2019,60,0,60,3,12,2019
3,12/4/2019,73,0,73,3,12,2019
4,12/4/2019,132,0,132,3,12,2019
5,12/4/2019,143,0,143,3,12,2019
6,12/4/2019,327,0,327,3,12,2019
7,12/4/2019,247,132,379,3,12,2019
8,12/4/2019,172,123,295,3,12,2019
9,12/4/2019,266,232,498,3,12,2019
10,12/4/2019,182,346,528,3,12,2019
11,12/4/2019,148,292,440,3,12,2019
12,12/4/2019,161,294,455,3,12,2019
13,12/4/2019,121,277,398,3,12,2019
14,12/4/2019,96,139,235,3,12,2019
15,12/4/2019,128,286,414,3,12,2019
16,12/4/2019,163,45,208,3,12,2019
17,12/4/2019,151,280,431,3,12,2019
18,12/4/2019,56,131,187,3,12,2019
19,12/4/2019,64,439,503,3,12,2019
20,12/4/2019,124,165,289,3,12,2019
21,12/4/2019,281,38,319,3,12,2019
22,12/4/2019,228,209,437,3,12,2019
23,12/4/2019,219,204,423,3,12,2019
0,12/5/2019,96,88,184,4,12,2019
1,12/5/2019,35,2,37,4,12,2019
2,12/5/2019,51,11,62,4,12,2019
3,12/5/2019,103,0,103,4,12,2019
4,12/5/2019,227,0,227,4,12,2019
5,12/5/2019,289,1,290,4,12,2019
6,12/5/2019,386,53,439,4,12,2019
7,12/5/2019,318,220,538,4,12,2019
8,12/5/2019,215,224,439,4,12,2019
9,12/5/2019,186,301,487,4,12,2019
10,12/5/2019,236,155,391,4,12,2019
11,12/5/2019,172,257,429,4,12,2019
12,12/5/2019,152,25,177,4,12,2019
13,12/5/2019,171,202,373,4,12,2019
14,12/5/2019,181,113,294,4,12,2019
15,12/5/2019,120,250,370,4,12,2019
16,12/5/2019,167,142,309,4,12,2019
17,12/5/2019,148,130,278,4,12,2019
18,12/5/2019,61,278,339,4,12,2019
19,12/5/2019,74,107,181,4,12,2019
20,12/5/2019,245,117,362,4,12,2019
21,12/5/2019,355,134,489,4,12,2019
22,12/5/2019,360,228,588,4,12,2019
23,12/5/2019,211,184,395,4,12,2019
0,12/6/2019,174,169,343,5,12,2019
1,12/6/2019,78,47,125,5,12,2019
2,12/6/2019,71,0,71,5,12,2019
3,12/6/2019,159,0,159,5,12,2019
4,12/6/2019,182,0,182,5,12,2019
5,12/6/2019,271,0,271,5,12,2019
6,12/6/2019,394,70,464,5,12,2019
7,12/6/2019,350,187,537,5,12,2019
8,12/6/2019,180,208,388,5,12,2019
9,12/6/2019,208,262,470,5,12,2019
10,12/6/2019,153,129,282,5,12,2019
11,12/6/2019,140,220,360,5,12,2019
12,12/6/2019,137,128,265,5,12,2019
13,12/6/2019,204,138,342,5,12,2019
14,12/6/2019,202,131,333,5,12,2019
15,12/6/2019,118,276,394,5,12,2019
16,12/6/2019,96,215,311,5,12,2019
17,12/6/2019,123,139,262,5,12,2019
18,12/6/2019,90,178,268,5,12,2019
19,12/6/2019,104,248,352,5,12,2019
20,12/6/2019,214,66,280,5,12,2019
21,12/6/2019,382,130,512,5,12,2019
22,12/6/2019,347,183,530,5,12,2019
23,12/6/2019,186,205,391,5,12,2019
0,12/7/2019,122,120,242,6,12,2019
1,12/7/2019,51,44,95,6,12,2019
2,12/7/2019,64,10,74,6,12,2019
3,12/7/2019,86,0,86,6,12,2019
4,12/7/2019,140,1,141,6,12,2019
5,12/7/2019,222,0,222,6,12,2019
6,12/7/2019,343,1,344,6,12,2019
7,12/7/2019,354,344,698,6,12,2019
8,12/7/2019,289,317,606,6,12,2019
9,12/7/2019,196,313,509,6,12,2019
10,12/7/2019,206,191,397,6,12,2019
11,12/7/2019,151,197,348,6,12,2019
12,12/7/2019,182,205,387,6,12,2019
13,12/7/2019,155,131,286,6,12,2019
14,12/7/2019,148,249,397,6,12,2019
15,12/7/2019,133,144,277,6,12,2019
16,12/7/2019,184,190,374,6,12,2019
17,12/7/2019,147,200,347,6,12,2019
18,12/7/2019,73,240,313,6,12,2019
19,12/7/2019,109,344,453,6,12,2019
20,12/7/2019,209,130,339,6,12,2019
21,12/7/2019,289,95,384,6,12,2019
22,12/7/2019,217,193,410,6,12,2019
23,12/7/2019,193,152,345,6,12,2019
0,12/8/2019,116,225,341,7,12,2019
1,12/8/2019,81,0,81,7,12,2019
2,12/8/2019,97,17,114,7,12,2019
3,12/8/2019,132,0,132,7,12,2019
4,12/8/2019,148,0,148,7,12,2019
5,12/8/2019,217,0,217,7,12,2019
6,12/8/2019,292,58,350,7,12,2019
7,12/8/2019,306,103,409,7,12,2019
8,12/8/2019,199,395,594,7,12,2019
9,12/8/2019,156,188,344,7,12,2019
10,12/8/2019,269,143,412,7,12,2019
11,12/8/2019,159,170,329,7,12,2019
12,12/8/2019,170,251,421,7,12,2019
13,12/8/2019,185,267,452,7,12,2019
14,12/8/2019,221,219,440,7,12,2019
15,12/8/2019,223,352,575,7,12,2019
16,12/8/2019,235,107,342,7,12,2019
17,12/8/2019,143,337,480,7,12,2019
18,12/8/2019,84,192,276,7,12,2019
19,12/8/2019,106,238,344,7,12,2019
20,12/8/2019,178,214,392,7,12,2019
21,12/8/2019,346,79,425,7,12,2019
22,12/8/2019,251,300,551,7,12,2019
23,12/8/2019,133,330,463,7,12,2019
0,12/9/2019,90,198,288,1,12,2019
1,12/9/2019,45,6,51,1,12,2019
2,12/9/2019,54,0,54,1,12,2019
3,12/9/2019,73,0,73,1,12,2019
4,12/9/2019,145,0,145,1,12,2019
5,12/9/2019,200,0,200,1,12,2019
6,12/9/2019,255,62,317,1,12,2019
7,12/9/2019,262,246,508,1,12,2019
8,12/9/2019,206,221,427,1,12,2019
9,12/9/2019,136,222,358,1,12,2019
10,12/9/2019,143,207,350,1,12,2019
11,12/9/2019,147,206,353,1,12,2019
12,12/9/2019,193,175,368,1,12,2019
13,12/9/2019,168,126,294,1,12,2019
14,12/9/2019,229,132,361,1,12,2019
15,12/9/2019,192,256,448,1,12,2019
16,12/9/2019,167,382,549,1,12,2019
17,12/9/2019,129,122,251,1,12,2019
18,12/9/2019,78,184,262,1,12,2019
19,12/9/2019,123,400,523,1,12,2019
20,12/9/2019,206,95,301,1,12,2019
21,12/9/2019,243,143,386,1,12,2019
22,12/9/2019,243,277,520,1,12,2019
23,12/9/2019,137,268,405,1,12,2019
0,12/10/2019,66,222,288,2,12,2019
1,12/10/2019,44,65,109,2,12,2019
2,12/10/2019,83,33,116,2,12,2019
3,12/10/2019,128,10,138,2,12,2019
4,12/10/2019,111,0,111,2,12,2019
5,12/10/2019,193,1,194,2,12,2019
6,12/10/2019,299,63,362,2,12,2019
7,12/10/2019,236,132,368,2,12,2019
8,12/10/2019,179,227,406,2,12,2019
9,12/10/2019,167,281,448,2,12,2019
10,12/10/2019,151,138,289,2,12,2019
11,12/10/2019,156,144,300,2,12,2019
12,12/10/2019,132,219,351,2,12,2019
13,12/10/2019,167,102,269,2,12,2019
14,12/10/2019,130,200,330,2,12,2019
15,12/10/2019,139,238,377,2,12,2019
16,12/10/2019,164,49,213,2,12,2019
17,12/10/2019,123,248,371,2,12,2019
18,12/10/2019,34,157,191,2,12,2019
19,12/10/2019,57,124,181,2,12,2019
20,12/10/2019,181,42,223,2,12,2019
21,12/10/2019,299,171,470,2,12,2019
22,12/10/2019,332,145,477,2,12,2019
23,12/10/2019,202,153,355,2,12,2019
0,12/11/2019,114,59,173,3,12,2019
1,12/11/2019,71,34,105,3,12,2019
2,12/11/2019,48,0,48,3,12,2019
3,12/11/2019,109,0,109,3,12,2019
4,12/11/2019,134,6,140,3,12,2019
5,12/11/2019,208,2,210,3,12,2019
6,12/11/2019,368,0,368,3,12,2019
7,12/11/2019,219,138,357,3,12,2019
8,12/11/2019,162,194,356,3,12,2019
9,12/11/2019,180,216,396,3,12,2019
10,12/11/2019,174,234,408,3,12,2019
11,12/11/2019,189,238,427,3,12,2019
12,12/11/2019,181,134,315,3,12,2019
13,12/11/2019,123,193,316,3,12,2019
14,12/11/2019,135,109,244,3,12,2019
15,12/11/2019,149,200,349,3,12,2019
16,12/11/2019,135,87,222,3,12,2019
17,12/11/2019,147,139,286,3,12,2019
18,12/11/2019,44,168,212,3,12,2019
19,12/11/2019,51,242,293,3,12,2019
20,12/11/2019,184,72,256,3,12,2019
21,12/11/2019,219,53,272,3,12,2019
22,12/11/2019,215,147,362,3,12,2019
23,12/11/2019,219,142,361,3,12,2019
0,12/12/2019,94,84,178,4,12,2019
1,12/12/2019,39,30,69,4,12,2019
2,12/12/2019,60,2,62,4,12,2019
3,12/12/2019,122,0,122,4,12,2019
4,12/12/2019,209,0,209,4,12,2019
5,12/12/2019,242,0,242,4,12,2019
6,12/12/2019,314,35,349,4,12,2019
7,12/12/2019,289,233,522,4,12,2019
8,12/12/2019,247,272,519,4,12,2019
9,12/12/2019,194,270,464,4,12,2019
10,12/12/2019,230,153,383,4,12,2019
11,12/12/2019,156,180,336,4,12,2019
12,12/12/2019,144,172,316,4,12,2019
13,12/12/2019,155,102,257,4,12,2019
14,12/12/2019,175,43,218,4,12,2019
15,12/12/2019,168,166,334,4,12,2019
16,12/12/2019,162,162,324,4,12,2019
17,12/12/2019,197,124,321,4,12,2019
18,12/12/2019,104,217,321,4,12,2019
19,12/12/2019,65,193,258,4,12,2019
20,12/12/2019,204,46,250,4,12,2019
21,12/12/2019,337,137,474,4,12,2019
22,12/12/2019,242,191,433,4,12,2019
23,12/12/2019,282,90,372,4,12,2019
0,12/13/2019,228,104,332,5,12,2019
1,12/13/2019,155,10,165,5,12,2019
2,12/13/2019,114,6,120,5,12,2019
3,12/13/2019,183,0,183,5,12,2019
4,12/13/2019,267,0,267,5,12,2019
5,12/13/2019,227,0,227,5,12,2019
6,12/13/2019,349,64,413,5,12,2019
7,12/13/2019,279,235,514,5,12,2019
8,12/13/2019,234,221,455,5,12,2019
9,12/13/2019,202,204,406,5,12,2019
10,12/13/2019,152,180,332,5,12,2019
11,12/13/2019,173,151,324,5,12,2019
12,12/13/2019,212,167,379,5,12,2019
13,12/13/2019,167,123,290,5,12,2019
14,12/13/2019,194,97,291,5,12,2019
15,12/13/2019,192,228,420,5,12,2019
16,12/13/2019,113,131,244,5,12,2019
17,12/13/2019,141,130,271,5,12,2019
18,12/13/2019,114,21,135,5,12,2019
19,12/13/2019,123,156,279,5,12,2019
20,12/13/2019,272,73,345,5,12,2019
21,12/13/2019,378,227,605,5,12,2019
22,12/13/2019,327,216,543,5,12,2019
23,12/13/2019,335,194,529,5,12,2019
0,12/14/2019,248,245,493,6,12,2019
1,12/14/2019,81,20,101,6,12,2019
2,12/14/2019,116,0,116,6,12,2019
3,12/14/2019,170,0,170,6,12,2019
4,12/14/2019,203,0,203,6,12,2019
5,12/14/2019,222,0,222,6,12,2019
6,12/14/2019,340,32,372,6,12,2019
7,12/14/2019,357,275,632,6,12,2019
8,12/14/2019,312,498,810,6,12,2019
9,12/14/2019,315,437,752,6,12,2019
10,12/14/2019,214,367,581,6,12,2019
11,12/14/2019,203,277,480,6,12,2019
12,12/14/2019,160,159,319,6,12,2019
13,12/14/2019,132,137,269,6,12,2019
14,12/14/2019,184,120,304,6,12,2019
15,12/14/2019,186,316,502,6,12,2019
16,12/14/2019,150,319,469,6,12,2019
17,12/14/2019,121,146,267,6,12,2019
18,12/14/2019,110,169,279,6,12,2019
19,12/14/2019,107,509,616,6,12,2019
20,12/14/2019,211,268,479,6,12,2019
21,12/14/2019,345,241,586,6,12,2019
22,12/14/2019,326,77,403,6,12,2019
23,12/14/2019,166,203,369,6,12,2019
0,12/15/2019,111,186,297,7,12,2019
1,12/15/2019,66,78,144,7,12,2019
2,12/15/2019,78,67,145,7,12,2019
3,12/15/2019,181,0,181,7,12,2019
4,12/15/2019,180,7,187,7,12,2019
5,12/15/2019,248,0,248,7,12,2019
6,12/15/2019,344,70,414,7,12,2019
7,12/15/2019,232,260,492,7,12,2019
8,12/15/2019,108,421,529,7,12,2019
9,12/15/2019,199,319,518,7,12,2019
10,12/15/2019,282,190,472,7,12,2019
11,12/15/2019,229,324,553,7,12,2019
12,12/15/2019,163,375,538,7,12,2019
13,12/15/2019,227,224,451,7,12,2019
14,12/15/2019,215,233,448,7,12,2019
15,12/15/2019,244,215,459,7,12,2019
16,12/15/2019,250,77,327,7,12,2019
17,12/15/2019,171,315,486,7,12,2019
18,12/15/2019,131,250,381,7,12,2019
19,12/15/2019,136,517,653,7,12,2019
20,12/15/2019,252,124,376,7,12,2019
21,12/15/2019,280,199,479,7,12,2019
22,12/15/2019,293,348,641,7,12,2019
23,12/15/2019,181,424,605,7,12,2019
0,12/16/2019,100,237,337,1,12,2019
1,12/16/2019,46,34,80,1,12,2019
2,12/16/2019,54,19,73,1,12,2019
3,12/16/2019,155,1,156,1,12,2019
4,12/16/2019,231,14,245,1,12,2019
5,12/16/2019,239,2,241,1,12,2019
6,12/16/2019,335,56,391,1,12,2019
7,12/16/2019,270,247,517,1,12,2019
8,12/16/2019,244,470,714,1,12,2019
9,12/16/2019,204,298,502,1,12,2019
10,12/16/2019,243,299,542,1,12,2019
11,12/16/2019,174,258,432,1,12,2019
12,12/16/2019,168,89,257,1,12,2019
13,12/16/2019,173,138,311,1,12,2019
14,12/16/2019,224,99,323,1,12,2019
15,12/16/2019,218,211,429,1,12,2019
16,12/16/2019,258,331,589,1,12,2019
17,12/16/2019,159,280,439,1,12,2019
18,12/16/2019,76,327,403,1,12,2019
19,12/16/2019,83,459,542,1,12,2019
20,12/16/2019,193,114,307,1,12,2019
21,12/16/2019,307,45,352,1,12,2019
22,12/16/2019,318,251,569,1,12,2019
23,12/16/2019,223,307,530,1,12,2019
0,12/17/2019,108,263,371,2,12,2019
1,12/17/2019,113,93,206,2,12,2019
2,12/17/2019,95,2,97,2,12,2019
3,12/17/2019,191,1,192,2,12,2019
4,12/17/2019,247,0,247,2,12,2019
5,12/17/2019,321,0,321,2,12,2019
6,12/17/2019,311,43,354,2,12,2019
7,12/17/2019,319,242,561,2,12,2019
8,12/17/2019,189,248,437,2,12,2019
9,12/17/2019,162,322,484,2,12,2019
10,12/17/2019,141,282,423,2,12,2019
11,12/17/2019,206,131,337,2,12,2019
12,12/17/2019,179,159,338,2,12,2019
13,12/17/2019,141,224,365,2,12,2019
14,12/17/2019,159,301,460,2,12,2019
15,12/17/2019,183,210,393,2,12,2019
16,12/17/2019,130,133,263,2,12,2019
17,12/17/2019,115,227,342,2,12,2019
18,12/17/2019,63,163,226,2,12,2019
19,12/17/2019,156,341,497,2,12,2019
20,12/17/2019,232,84,316,2,12,2019
21,12/17/2019,360,127,487,2,12,2019
22,12/17/2019,356,271,627,2,12,2019
23,12/17/2019,238,91,329,2,12,2019
0,12/18/2019,156,266,422,3,12,2019
1,12/18/2019,74,119,193,3,12,2019
2,12/18/2019,102,5,107,3,12,2019
3,12/18/2019,158,0,158,3,12,2019
4,12/18/2019,244,0,244,3,12,2019
5,12/18/2019,266,8,274,3,12,2019
6,12/18/2019,358,0,358,3,12,2019
7,12/18/2019,234,181,415,3,12,2019
8,12/18/2019,315,458,773,3,12,2019
9,12/18/2019,289,309,598,3,12,2019
10,12/18/2019,306,303,609,3,12,2019
11,12/18/2019,256,303,559,3,12,2019
12,12/18/2019,273,282,555,3,12,2019
13,12/18/2019,177,230,407,3,12,2019
14,12/18/2019,197,138,335,3,12,2019
15,12/18/2019,214,313,527,3,12,2019
16,12/18/2019,156,117,273,3,12,2019
17,12/18/2019,192,243,435,3,12,2019
18,12/18/2019,158,162,320,3,12,2019
19,12/18/2019,124,335,459,3,12,2019
20,12/18/2019,274,156,430,3,12,2019
21,12/18/2019,437,134,571,3,12,2019
22,12/18/2019,370,300,670,3,12,2019
23,12/18/2019,319,132,451,3,12,2019
0,12/19/2019,163,325,488,4,12,2019
1,12/19/2019,88,123,211,4,12,2019
2,12/19/2019,114,7,121,4,12,2019
3,12/19/2019,187,0,187,4,12,2019
4,12/19/2019,329,0,329,4,12,2019
5,12/19/2019,344,2,346,4,12,2019
6,12/19/2019,412,145,557,4,12,2019
7,12/19/2019,411,173,584,4,12,2019
8,12/19/2019,225,552,777,4,12,2019
9,12/19/2019,189,415,604,4,12,2019
10,12/19/2019,230,258,488,4,12,2019
11,12/19/2019,189,262,451,4,12,2019
12,12/19/2019,222,215,437,4,12,2019
13,12/19/2019,194,197,391,4,12,2019
14,12/19/2019,218,286,504,4,12,2019
15,12/19/2019,218,222,440,4,12,2019
16,12/19/2019,199,133,332,4,12,2019
17,12/19/2019,173,266,439,4,12,2019
18,12/19/2019,168,232,400,4,12,2019
19,12/19/2019,147,335,482,4,12,2019
20,12/19/2019,372,197,569,4,12,2019
21,12/19/2019,486,147,633,4,12,2019
22,12/19/2019,568,327,895,4,12,2019
23,12/19/2019,575,244,819,4,12,2019
0,12/20/2019,226,215,441,5,12,2019
1,12/20/2019,144,330,474,5,12,2019
2,12/20/2019,179,19,198,5,12,2019
3,12/20/2019,274,27,301,5,12,2019
4,12/20/2019,304,8,312,5,12,2019
5,12/20/2019,339,0,339,5,12,2019
6,12/20/2019,386,99,485,5,12,2019
7,12/20/2019,343,140,483,5,12,2019
8,12/20/2019,298,505,803,5,12,2019
9,12/20/2019,223,468,691,5,12,2019
10,12/20/2019,310,382,692,5,12,2019
11,12/20/2019,255,103,358,5,12,2019
12,12/20/2019,273,278,551,5,12,2019
13,12/20/2019,250,216,466,5,12,2019
14,12/20/2019,277,206,483,5,12,2019
15,12/20/2019,265,367,632,5,12,2019
16,12/20/2019,202,221,423,5,12,2019
17,12/20/2019,221,430,651,5,12,2019
18,12/20/2019,172,193,365,5,12,2019
19,12/20/2019,218,338,556,5,12,2019
20,12/20/2019,481,217,698,5,12,2019
21,12/20/2019,606,159,765,5,12,2019
22,12/20/2019,649,400,1049,5,12,2019
23,12/20/2019,477,406,883,5,12,2019
0,12/21/2019,246,366,612,6,12,2019
1,12/21/2019,247,227,474,6,12,2019
2,12/21/2019,195,70,265,6,12,2019
3,12/21/2019,205,46,251,6,12,2019
4,12/21/2019,298,1,299,6,12,2019
5,12/21/2019,357,0,357,6,12,2019
6,12/21/2019,454,0,454,6,12,2019
7,12/21/2019,516,346,862,6,12,2019
8,12/21/2019,556,607,1163,6,12,2019
9,12/21/2019,333,670,1003,6,12,2019
10,12/21/2019,350,450,800,6,12,2019
11,12/21/2019,350,305,655,6,12,2019
12,12/21/2019,312,573,885,6,12,2019
13,12/21/2019,245,134,379,6,12,2019
14,12/21/2019,275,498,773,6,12,2019
15,12/21/2019,260,207,467,6,12,2019
16,12/21/2019,419,383,802,6,12,2019
17,12/21/2019,206,497,703,6,12,2019
18,12/21/2019,259,356,615,6,12,2019
19,12/21/2019,176,333,509,6,12,2019
20,12/21/2019,380,228,608,6,12,2019
21,12/21/2019,368,308,676,6,12,2019
22,12/21/2019,539,313,852,6,12,2019
23,12/21/2019,318,180,498,6,12,2019
0,12/22/2019,116,332,448,7,12,2019
1,12/22/2019,118,160,278,7,12,2019
2,12/22/2019,180,47,227,7,12,2019
3,12/22/2019,201,23,224,7,12,2019
4,12/22/2019,281,73,354,7,12,2019
5,12/22/2019,364,97,461,7,12,2019
6,12/22/2019,429,91,520,7,12,2019
7,12/22/2019,303,347,650,7,12,2019
8,12/22/2019,268,671,939,7,12,2019
9,12/22/2019,291,317,608,7,12,2019
10,12/22/2019,398,372,770,7,12,2019
11,12/22/2019,335,401,736,7,12,2019
12,12/22/2019,288,372,660,7,12,2019
13,12/22/2019,251,296,547,7,12,2019
14,12/22/2019,289,344,633,7,12,2019
15,12/22/2019,216,327,543,7,12,2019
16,12/22/2019,289,141,430,7,12,2019
17,12/22/2019,181,330,511,7,12,2019
18,12/22/2019,183,288,471,7,12,2019
19,12/22/2019,234,485,719,7,12,2019
20,12/22/2019,293,94,387,7,12,2019
21,12/22/2019,503,234,737,7,12,2019
22,12/22/2019,311,330,641,7,12,2019
23,12/22/2019,216,423,639,7,12,2019
0,12/23/2019,102,324,426,1,12,2019
1,12/23/2019,75,257,332,1,12,2019
2,12/23/2019,117,3,120,1,12,2019
3,12/23/2019,202,1,203,1,12,2019
4,12/23/2019,177,0,177,1,12,2019
5,12/23/2019,292,65,357,1,12,2019
6,12/23/2019,436,63,499,1,12,2019
7,12/23/2019,365,208,573,1,12,2019
8,12/23/2019,336,611,947,1,12,2019
9,12/23/2019,338,431,769,1,12,2019
10,12/23/2019,257,341,598,1,12,2019
11,12/23/2019,271,325,596,1,12,2019
12,12/23/2019,223,361,584,1,12,2019
13,12/23/2019,269,137,406,1,12,2019
14,12/23/2019,232,170,402,1,12,2019
15,12/23/2019,252,350,602,1,12,2019
16,12/23/2019,223,106,329,1,12,2019
17,12/23/2019,170,437,607,1,12,2019
18,12/23/2019,144,237,381,1,12,2019
19,12/23/2019,175,368,543,1,12,2019
20,12/23/2019,292,275,567,1,12,2019
21,12/23/2019,437,254,691,1,12,2019
22,12/23/2019,334,274,608,1,12,2019
23,12/23/2019,199,395,594,1,12,2019
0,12/24/2019,86,375,461,2,12,2019
1,12/24/2019,118,198,316,2,12,2019
2,12/24/2019,108,30,138,2,12,2019
3,12/24/2019,184,37,221,2,12,2019
4,12/24/2019,261,1,262,2,12,2019
5,12/24/2019,311,0,311,2,12,2019
6,12/24/2019,416,80,496,2,12,2019
7,12/24/2019,355,351,706,2,12,2019
8,12/24/2019,286,586,872,2,12,2019
9,12/24/2019,213,415,628,2,12,2019
10,12/24/2019,239,310,549,2,12,2019
11,12/24/2019,203,241,444,2,12,2019
12,12/24/2019,269,132,401,2,12,2019
13,12/24/2019,195,334,529,2,12,2019
14,12/24/2019,159,296,455,2,12,2019
15,12/24/2019,110,273,383,2,12,2019
16,12/24/2019,95,50,145,2,12,2019
17,12/24/2019,78,325,403,2,12,2019
18,12/24/2019,92,172,264,2,12,2019
19,12/24/2019,105,127,232,2,12,2019
20,12/24/2019,299,39,338,2,12,2019
21,12/24/2019,243,217,460,2,12,2019
22,12/24/2019,247,276,523,2,12,2019
23,12/24/2019,220,193,413,2,12,2019
0,12/25/2019,121,123,244,3,12,2019
1,12/25/2019,42,83,125,3,12,2019
2,12/25/2019,121,0,121,3,12,2019
3,12/25/2019,154,0,154,3,12,2019
4,12/25/2019,302,0,302,3,12,2019
5,12/25/2019,333,0,333,3,12,2019
6,12/25/2019,393,0,393,3,12,2019
7,12/25/2019,418,171,589,3,12,2019
8,12/25/2019,251,547,798,3,12,2019
9,12/25/2019,236,539,775,3,12,2019
10,12/25/2019,268,494,762,3,12,2019
11,12/25/2019,366,333,699,3,12,2019
12,12/25/2019,324,378,702,3,12,2019
13,12/25/2019,304,260,564,3,12,2019
14,12/25/2019,245,254,499,3,12,2019
15,12/25/2019,245,292,537,3,12,2019
16,12/25/2019,262,359,621,3,12,2019
17,12/25/2019,186,75,261,3,12,2019
18,12/25/2019,111,590,701,3,12,2019
19,12/25/2019,160,516,676,3,12,2019
20,12/25/2019,248,143,391,3,12,2019
21,12/25/2019,396,284,680,3,12,2019
22,12/25/2019,434,326,760,3,12,2019
23,12/25/2019,299,426,725,3,12,2019
0,12/26/2019,121,433,554,4,12,2019
1,12/26/2019,62,261,323,4,12,2019
2,12/26/2019,67,38,105,4,12,2019
3,12/26/2019,194,7,201,4,12,2019
4,12/26/2019,347,61,408,4,12,2019
5,12/26/2019,362,4,366,4,12,2019
6,12/26/2019,480,85,565,4,12,2019
7,12/26/2019,597,218,815,4,12,2019
8,12/26/2019,570,548,1118,4,12,2019
9,12/26/2019,370,679,1049,4,12,2019
10,12/26/2019,351,606,957,4,12,2019
11,12/26/2019,226,307,533,4,12,2019
12,12/26/2019,294,404,698,4,12,2019
13,12/26/2019,281,352,633,4,12,2019
14,12/26/2019,270,222,492,4,12,2019
15,12/26/2019,347,339,686,4,12,2019
16,12/26/2019,317,240,557,4,12,2019
17,12/26/2019,267,432,699,4,12,2019
18,12/26/2019,175,518,693,4,12,2019
19,12/26/2019,144,448,592,4,12,2019
20,12/26/2019,318,170,488,4,12,2019
21,12/26/2019,424,192,616,4,12,2019
22,12/26/2019,442,474,916,4,12,2019
23,12/26/2019,313,358,671,4,12,2019
0,12/27/2019,176,574,750,5,12,2019
1,12/27/2019,150,445,595,5,12,2019
2,12/27/2019,138,22,160,5,12,2019
3,12/27/2019,185,0,185,5,12,2019
4,12/27/2019,361,35,396,5,12,2019
5,12/27/2019,316,13,329,5,12,2019
6,12/27/2019,459,65,524,5,12,2019
7,12/27/2019,432,275,707,5,12,2019
8,12/27/2019,356,478,834,5,12,2019
9,12/27/2019,277,707,984,5,12,2019
10,12/27/2019,261,456,717,5,12,2019
11,12/27/2019,226,386,612,5,12,2019
12,12/27/2019,258,334,592,5,12,2019
13,12/27/2019,310,276,586,5,12,2019
14,12/27/2019,247,366,613,5,12,2019
15,12/27/2019,275,387,662,5,12,2019
16,12/27/2019,270,450,720,5,12,2019
17,12/27/2019,240,511,751,5,12,2019
18,12/27/2019,126,357,483,5,12,2019
19,12/27/2019,198,457,655,5,12,2019
20,12/27/2019,270,408,678,5,12,2019
21,12/27/2019,434,198,632,5,12,2019
22,12/27/2019,512,486,998,5,12,2019
23,12/27/2019,500,475,975,5,12,2019
0,12/28/2019,236,508,744,6,12,2019
1,12/28/2019,99,378,477,6,12,2019
2,12/28/2019,116,0,116,6,12,2019
3,12/28/2019,244,76,320,6,12,2019
4,12/28/2019,290,1,291,6,12,2019
5,12/28/2019,258,0,258,6,12,2019
6,12/28/2019,394,0,394,6,12,2019
7,12/28/2019,474,391,865,6,12,2019
8,12/28/2019,562,786,1348,6,12,2019
9,12/28/2019,376,742,1118,6,12,2019
10,12/28/2019,267,574,841,6,12,2019
11,12/28/2019,259,392,651,6,12,2019
12,12/28/2019,322,470,792,6,12,2019
13,12/28/2019,245,368,613,6,12,2019
14,12/28/2019,252,216,468,6,12,2019
15,12/28/2019,257,502,759,6,12,2019
16,12/28/2019,205,474,679,6,12,2019
17,12/28/2019,201,413,614,6,12,2019
18,12/28/2019,122,438,560,6,12,2019
19,12/28/2019,116,511,627,6,12,2019
20,12/28/2019,285,381,666,6,12,2019
21,12/28/2019,340,260,600,6,12,2019
22,12/28/2019,331,398,729,6,12,2019
23,12/28/2019,223,371,594,6,12,2019
0,12/29/2019,163,534,697,7,12,2019
1,12/29/2019,89,239,328,7,12,2019
2,12/29/2019,109,1,110,7,12,2019
3,12/29/2019,191,0,191,7,12,2019
4,12/29/2019,217,0,217,7,12,2019
5,12/29/2019,309,0,309,7,12,2019
6,12/29/2019,388,103,491,7,12,2019
7,12/29/2019,317,374,691,7,12,2019
8,12/29/2019,244,740,984,7,12,2019
9,12/29/2019,274,490,764,7,12,2019
10,12/29/2019,299,257,556,7,12,2019
11,12/29/2019,301,270,571,7,12,2019
12,12/29/2019,246,563,809,7,12,2019
13,12/29/2019,266,510,776,7,12,2019
14,12/29/2019,222,127,349,7,12,2019
15,12/29/2019,262,556,818,7,12,2019
16,12/29/2019,230,219,449,7,12,2019
17,12/29/2019,237,316,553,7,12,2019
18,12/29/2019,145,371,516,7,12,2019
19,12/29/2019,159,626,785,7,12,2019
20,12/29/2019,251,106,357,7,12,2019
21,12/29/2019,359,242,601,7,12,2019
22,12/29/2019,385,532,917,7,12,2019
23,12/29/2019,255,504,759,7,12,2019
0,12/30/2019,97,568,665,1,12,2019
1,12/30/2019,69,298,367,1,12,2019
2,12/30/2019,65,64,129,1,12,2019
3,12/30/2019,131,0,131,1,12,2019
4,12/30/2019,155,0,155,1,12,2019
5,12/30/2019,251,0,251,1,12,2019
6,12/30/2019,440,79,519,1,12,2019
7,12/30/2019,394,394,788,1,12,2019
8,12/30/2019,311,581,892,1,12,2019
9,12/30/2019,245,728,973,1,12,2019
10,12/30/2019,160,434,594,1,12,2019
11,12/30/2019,230,512,742,1,12,2019
12,12/30/2019,228,318,546,1,12,2019
13,12/30/2019,216,176,392,1,12,2019
14,12/30/2019,242,218,460,1,12,2019
15,12/30/2019,313,345,658,1,12,2019
16,12/30/2019,376,420,796,1,12,2019
17,12/30/2019,181,329,510,1,12,2019
18,12/30/2019,164,334,498,1,12,2019
19,12/30/2019,126,769,895,1,12,2019
20,12/30/2019,222,351,573,1,12,2019
21,12/30/2019,415,291,706,1,12,2019
22,12/30/2019,330,227,557,1,12,2019
23,12/30/2019,206,374,580,1,12,2019
0,12/31/2019,153,522,675,2,12,2019
1,12/31/2019,87,704,791,2,12,2019
2,12/31/2019,64,50,114,2,12,2019
3,12/31/2019,131,38,169,2,12,2019
4,12/31/2019,161,43,204,2,12,2019
5,12/31/2019,337,0,337,2,12,2019
6,12/31/2019,412,90,502,2,12,2019
7,12/31/2019,407,349,756,2,12,2019
8,12/31/2019,329,733,1062,2,12,2019
9,12/31/2019,217,416,633,2,12,2019
10,12/31/2019,205,286,491,2,12,2019
11,12/31/2019,169,304,473,2,12,2019
12,12/31/2019,192,303,495,2,12,2019
13,12/31/2019,251,245,496,2,12,2019
14,12/31/2019,162,372,534,2,12,2019
15,12/31/2019,134,420,554,2,12,2019
16,12/31/2019,178,226,404,2,12,2019
17,12/31/2019,51,214,265,2,12,2019
18,12/31/2019,74,396,470,2,12,2019
19,12/31/2019,132,162,294,2,12,2019
20,12/31/2019,230,181,411,2,12,2019
21,12/31/2019,267,352,619,2,12,2019
22,12/31/2019,170,218,388,2,12,2019
23,12/31/2019,84,460,544,2,12,2019
0,1/1/2020,46,183,229,3,1,2020
1,1/1/2020,56,3,59,3,1,2020
2,1/1/2020,51,0,51,3,1,2020
3,1/1/2020,105,1,106,3,1,2020
4,1/1/2020,173,1,174,3,1,2020
5,1/1/2020,211,0,211,3,1,2020
6,1/1/2020,375,0,375,3,1,2020
7,1/1/2020,348,310,658,3,1,2020
8,1/1/2020,259,651,910,3,1,2020
9,1/1/2020,250,475,725,3,1,2020
10,1/1/2020,310,368,678,3,1,2020
11,1/1/2020,302,460,762,3,1,2020
12,1/1/2020,297,344,641,3,1,2020
13,1/1/2020,219,316,535,3,1,2020
14,1/1/2020,207,287,494,3,1,2020
15,1/1/2020,265,409,674,3,1,2020
16,1/1/2020,306,260,566,3,1,2020
17,1/1/2020,241,239,480,3,1,2020
18,1/1/2020,109,311,420,3,1,2020
19,1/1/2020,145,570,715,3,1,2020
20,1/1/2020,218,224,442,3,1,2020
21,1/1/2020,357,277,634,3,1,2020
22,1/1/2020,339,227,566,3,1,2020
23,1/1/2020,178,639,817,3,1,2020
0,1/2/2020,89,379,468,4,1,2020
1,1/2/2020,59,358,417,4,1,2020
2,1/2/2020,62,13,75,4,1,2020
3,1/2/2020,122,0,122,4,1,2020
4,1/2/2020,240,0,240,4,1,2020
5,1/2/2020,259,0,259,4,1,2020
6,1/2/2020,497,28,525,4,1,2020
7,1/2/2020,420,289,709,4,1,2020
8,1/2/2020,304,561,865,4,1,2020
9,1/2/2020,303,525,828,4,1,2020
10,1/2/2020,271,208,479,4,1,2020
11,1/2/2020,253,310,563,4,1,2020
12,1/2/2020,256,250,506,4,1,2020
13,1/2/2020,347,494,841,4,1,2020
14,1/2/2020,282,262,544,4,1,2020
15,1/2/2020,305,408,713,4,1,2020
16,1/2/2020,355,145,500,4,1,2020
17,1/2/2020,305,469,774,4,1,2020
18,1/2/2020,178,561,739,4,1,2020
19,1/2/2020,167,225,392,4,1,2020
20,1/2/2020,263,507,770,4,1,2020
21,1/2/2020,430,96,526,4,1,2020
22,1/2/2020,489,470,959,4,1,2020
23,1/2/2020,299,421,720,4,1,2020
0,1/3/2020,145,449,594,5,1,2020
1,1/3/2020,49,466,515,5,1,2020
2,1/3/2020,41,160,201,5,1,2020
3,1/3/2020,132,0,132,5,1,2020
4,1/3/2020,225,1,226,5,1,2020
5,1/3/2020,291,17,308,5,1,2020
6,1/3/2020,478,102,580,5,1,2020
7,1/3/2020,459,269,728,5,1,2020
8,1/3/2020,238,458,696,5,1,2020
9,1/3/2020,263,701,964,5,1,2020
10,1/3/2020,210,439,649,5,1,2020
11,1/3/2020,242,486,728,5,1,2020
12,1/3/2020,311,185,496,5,1,2020
13,1/3/2020,336,298,634,5,1,2020
14,1/3/2020,329,271,600,5,1,2020
15,1/3/2020,553,277,830,5,1,2020
16,1/3/2020,353,476,829,5,1,2020
17,1/3/2020,260,312,572,5,1,2020
18,1/3/2020,190,557,747,5,1,2020
19,1/3/2020,203,544,747,5,1,2020
20,1/3/2020,350,284,634,5,1,2020
21,1/3/2020,397,340,737,5,1,2020
22,1/3/2020,554,462,1016,5,1,2020
23,1/3/2020,360,612,972,5,1,2020
0,1/4/2020,117,601,718,6,1,2020
1,1/4/2020,58,414,472,6,1,2020
2,1/4/2020,55,140,195,6,1,2020
3,1/4/2020,164,73,237,6,1,2020
4,1/4/2020,199,26,225,6,1,2020
5,1/4/2020,265,0,265,6,1,2020
6,1/4/2020,553,3,556,6,1,2020
7,1/4/2020,397,472,869,6,1,2020
8,1/4/2020,374,737,1111,6,1,2020
9,1/4/2020,329,764,1093,6,1,2020
10,1/4/2020,296,394,690,6,1,2020
11,1/4/2020,311,420,731,6,1,2020
12,1/4/2020,327,405,732,6,1,2020
13,1/4/2020,348,276,624,6,1,2020
14,1/4/2020,336,607,943,6,1,2020
15,1/4/2020,434,401,835,6,1,2020
16,1/4/2020,427,394,821,6,1,2020
17,1/4/2020,376,499,875,6,1,2020
18,1/4/2020,199,464,663,6,1,2020
19,1/4/2020,175,691,866,6,1,2020
20,1/4/2020,342,358,700,6,1,2020
21,1/4/2020,557,314,871,6,1,2020
22,1/4/2020,490,707,1197,6,1,2020
23,1/4/2020,298,506,804,6,1,2020
0,1/5/2020,171,504,675,7,1,2020
1,1/5/2020,80,311,391,7,1,2020
2,1/5/2020,162,3,165,7,1,2020
3,1/5/2020,194,15,209,7,1,2020
4,1/5/2020,231,89,320,7,1,2020
5,1/5/2020,330,163,493,7,1,2020
6,1/5/2020,433,278,711,7,1,2020
7,1/5/2020,333,318,651,7,1,2020
8,1/5/2020,251,441,692,7,1,2020
9,1/5/2020,188,331,519,7,1,2020
10,1/5/2020,230,394,624,7,1,2020
11,1/5/2020,282,342,624,7,1,2020
12,1/5/2020,270,530,800,7,1,2020
13,1/5/2020,239,219,458,7,1,2020
14,1/5/2020,250,403,653,7,1,2020
15,1/5/2020,396,503,899,7,1,2020
16,1/5/2020,388,417,805,7,1,2020
17,1/5/2020,315,131,446,7,1,2020
18,1/5/2020,170,232,402,7,1,2020
19,1/5/2020,204,586,790,7,1,2020
20,1/5/2020,256,359,615,7,1,2020
21,1/5/2020,359,757,1116,7,1,2020
22,1/5/2020,333,476,809,7,1,2020
23,1/5/2020,207,448,655,7,1,2020
0,1/6/2020,113,506,619,1,1,2020
1,1/6/2020,52,725,777,1,1,2020
2,1/6/2020,44,238,282,1,1,2020
3,1/6/2020,96,211,307,1,1,2020
4,1/6/2020,113,212,325,1,1,2020
5,1/6/2020,226,116,342,1,1,2020
6,1/6/2020,344,3,347,1,1,2020
7,1/6/2020,390,325,715,1,1,2020
8,1/6/2020,260,547,807,1,1,2020
9,1/6/2020,238,730,968,1,1,2020
10,1/6/2020,206,567,773,1,1,2020
11,1/6/2020,177,344,521,1,1,2020
12,1/6/2020,207,250,457,1,1,2020
13,1/6/2020,303,228,531,1,1,2020
14,1/6/2020,256,139,395,1,1,2020
15,1/6/2020,335,519,854,1,1,2020
16,1/6/2020,323,397,720,1,1,2020
17,1/6/2020,254,341,595,1,1,2020
18,1/6/2020,99,370,469,1,1,2020
19,1/6/2020,90,530,620,1,1,2020
20,1/6/2020,211,369,580,1,1,2020
21,1/6/2020,325,183,508,1,1,2020
22,1/6/2020,302,438,740,1,1,2020
23,1/6/2020,167,469,636,1,1,2020
0,1/7/2020,79,461,540,2,1,2020
1,1/7/2020,55,488,543,2,1,2020
2,1/7/2020,56,71,127,2,1,2020
3,1/7/2020,101,2,103,2,1,2020
4,1/7/2020,134,0,134,2,1,2020
5,1/7/2020,244,90,334,2,1,2020
6,1/7/2020,318,77,395,2,1,2020
7,1/7/2020,349,288,637,2,1,2020
8,1/7/2020,253,584,837,2,1,2020
9,1/7/2020,226,467,693,2,1,2020
10,1/7/2020,267,271,538,2,1,2020
11,1/7/2020,171,277,448,2,1,2020
12,1/7/2020,199,327,526,2,1,2020
13,1/7/2020,301,457,758,2,1,2020
14,1/7/2020,223,218,441,2,1,2020
15,1/7/2020,197,325,522,2,1,2020
16,1/7/2020,201,169,370,2,1,2020
17,1/7/2020,85,308,393,2,1,2020
18,1/7/2020,50,277,327,2,1,2020
19,1/7/2020,75,285,360,2,1,2020
20,1/7/2020,214,190,404,2,1,2020
21,1/7/2020,326,335,661,2,1,2020
22,1/7/2020,205,391,596,2,1,2020
23,1/7/2020,228,514,742,2,1,2020
0,1/8/2020,75,396,471,3,1,2020
1,1/8/2020,41,225,266,3,1,2020
2,1/8/2020,53,0,53,3,1,2020
3,1/8/2020,75,0,75,3,1,2020
4,1/8/2020,124,0,124,3,1,2020
5,1/8/2020,185,0,185,3,1,2020
6,1/8/2020,316,0,316,3,1,2020
7,1/8/2020,192,134,326,3,1,2020
8,1/8/2020,157,573,730,3,1,2020
9,1/8/2020,205,386,591,3,1,2020
10,1/8/2020,210,398,608,3,1,2020
11,1/8/2020,206,357,563,3,1,2020
12,1/8/2020,210,207,417,3,1,2020
13,1/8/2020,126,451,577,3,1,2020
14,1/8/2020,140,225,365,3,1,2020
15,1/8/2020,144,463,607,3,1,2020
16,1/8/2020,156,204,360,3,1,2020
17,1/8/2020,113,238,351,3,1,2020
18,1/8/2020,59,125,184,3,1,2020
19,1/8/2020,39,349,388,3,1,2020
20,1/8/2020,161,336,497,3,1,2020
21,1/8/2020,293,133,426,3,1,2020
22,1/8/2020,230,256,486,3,1,2020
23,1/8/2020,155,395,550,3,1,2020
0,1/9/2020,102,264,366,4,1,2020
1,1/9/2020,63,117,180,4,1,2020
2,1/9/2020,39,0,39,4,1,2020
3,1/9/2020,133,0,133,4,1,2020
4,1/9/2020,247,0,247,4,1,2020
5,1/9/2020,259,1,260,4,1,2020
6,1/9/2020,364,58,422,4,1,2020
7,1/9/2020,363,123,486,4,1,2020
8,1/9/2020,214,537,751,4,1,2020
9,1/9/2020,134,273,407,4,1,2020
10,1/9/2020,157,308,465,4,1,2020
11,1/9/2020,191,275,466,4,1,2020
12,1/9/2020,136,100,236,4,1,2020
13,1/9/2020,140,348,488,4,1,2020
14,1/9/2020,176,155,331,4,1,2020
15,1/9/2020,147,413,560,4,1,2020
16,1/9/2020,117,215,332,4,1,2020
17,1/9/2020,122,105,227,4,1,2020
18,1/9/2020,90,172,262,4,1,2020
19,1/9/2020,66,411,477,4,1,2020
20,1/9/2020,190,301,491,4,1,2020
21,1/9/2020,255,135,390,4,1,2020
22,1/9/2020,305,194,499,4,1,2020
23,1/9/2020,206,300,506,4,1,2020
0,1/10/2020,106,464,570,5,1,2020
1,1/10/2020,51,211,262,5,1,2020
2,1/10/2020,44,112,156,5,1,2020
3,1/10/2020,109,0,109,5,1,2020
4,1/10/2020,205,0,205,5,1,2020
5,1/10/2020,229,0,229,5,1,2020
6,1/10/2020,332,26,358,5,1,2020
7,1/10/2020,298,119,417,5,1,2020
8,1/10/2020,202,558,760,5,1,2020
9,1/10/2020,150,419,569,5,1,2020
10,1/10/2020,152,244,396,5,1,2020
11,1/10/2020,178,344,522,5,1,2020
12,1/10/2020,138,201,339,5,1,2020
13,1/10/2020,187,271,458,5,1,2020
14,1/10/2020,190,91,281,5,1,2020
15,1/10/2020,96,415,511,5,1,2020
16,1/10/2020,120,338,458,5,1,2020
17,1/10/2020,82,256,338,5,1,2020
18,1/10/2020,94,104,198,5,1,2020
19,1/10/2020,93,362,455,5,1,2020
20,1/10/2020,133,290,423,5,1,2020
21,1/10/2020,239,194,433,5,1,2020
22,1/10/2020,390,373,763,5,1,2020
23,1/10/2020,262,355,617,5,1,2020
0,1/11/2020,126,517,643,6,1,2020
1,1/11/2020,47,117,164,6,1,2020
2,1/11/2020,60,54,114,6,1,2020
3,1/11/2020,97,1,98,6,1,2020
4,1/11/2020,95,0,95,6,1,2020
5,1/11/2020,157,0,157,6,1,2020
6,1/11/2020,335,1,336,6,1,2020
7,1/11/2020,249,283,532,6,1,2020
8,1/11/2020,216,544,760,6,1,2020
9,1/11/2020,166,444,610,6,1,2020
10,1/11/2020,210,392,602,6,1,2020
11,1/11/2020,132,265,397,6,1,2020
12,1/11/2020,143,307,450,6,1,2020
13,1/11/2020,175,170,345,6,1,2020
14,1/11/2020,212,206,418,6,1,2020
15,1/11/2020,124,404,528,6,1,2020
16,1/11/2020,114,472,586,6,1,2020
17,1/11/2020,90,336,426,6,1,2020
18,1/11/2020,66,347,413,6,1,2020
19,1/11/2020,52,430,482,6,1,2020
20,1/11/2020,143,468,611,6,1,2020
21,1/11/2020,213,127,340,6,1,2020
22,1/11/2020,210,383,593,6,1,2020
23,1/11/2020,131,409,540,6,1,2020
0,1/12/2020,97,433,530,7,1,2020
1,1/12/2020,38,10,48,7,1,2020
2,1/12/2020,54,0,54,7,1,2020
3,1/12/2020,91,0,91,7,1,2020
4,1/12/2020,104,0,104,7,1,2020
5,1/12/2020,217,2,219,7,1,2020
6,1/12/2020,277,87,364,7,1,2020
7,1/12/2020,210,231,441,7,1,2020
8,1/12/2020,132,670,802,7,1,2020
9,1/12/2020,123,536,659,7,1,2020
10,1/12/2020,143,262,405,7,1,2020
11,1/12/2020,133,377,510,7,1,2020
12,1/12/2020,147,360,507,7,1,2020
13,1/12/2020,175,265,440,7,1,2020
14,1/12/2020,193,214,407,7,1,2020
15,1/12/2020,201,450,651,7,1,2020
16,1/12/2020,209,245,454,7,1,2020
17,1/12/2020,135,246,381,7,1,2020
18,1/12/2020,70,394,464,7,1,2020
19,1/12/2020,48,605,653,7,1,2020
20,1/12/2020,147,309,456,7,1,2020
21,1/12/2020,196,131,327,7,1,2020
22,1/12/2020,167,367,534,7,1,2020
23,1/12/2020,106,504,610,7,1,2020
0,1/13/2020,73,458,531,1,1,2020
1,1/13/2020,43,165,208,1,1,2020
2,1/13/2020,21,68,89,1,1,2020
3,1/13/2020,46,0,46,1,1,2020
4,1/13/2020,84,0,84,1,1,2020
5,1/13/2020,126,0,126,1,1,2020
6,1/13/2020,250,104,354,1,1,2020
7,1/13/2020,163,283,446,1,1,2020
8,1/13/2020,118,698,816,1,1,2020
9,1/13/2020,99,309,408,1,1,2020
10,1/13/2020,102,269,371,1,1,2020
11,1/13/2020,87,221,308,1,1,2020
12,1/13/2020,58,201,259,1,1,2020
13,1/13/2020,123,275,398,1,1,2020
14,1/13/2020,136,96,232,1,1,2020
15,1/13/2020,106,465,571,1,1,2020
16,1/13/2020,82,410,492,1,1,2020
17,1/13/2020,86,112,198,1,1,2020
18,1/13/2020,32,341,373,1,1,2020
19,1/13/2020,47,491,538,1,1,2020
20,1/13/2020,72,73,145,1,1,2020
21,1/13/2020,199,218,417,1,1,2020
22,1/13/2020,153,338,491,1,1,2020
23,1/13/2020,60,391,451,1,1,2020
0,1/14/2020,44,474,518,2,1,2020
1,1/14/2020,29,108,137,2,1,2020
2,1/14/2020,27,18,45,2,1,2020
3,1/14/2020,56,1,57,2,1,2020
4,1/14/2020,64,0,64,2,1,2020
5,1/14/2020,117,0,117,2,1,2020
6,1/14/2020,231,60,291,2,1,2020
7,1/14/2020,235,298,533,2,1,2020
8,1/14/2020,149,546,695,2,1,2020
9,1/14/2020,78,397,475,2,1,2020
10,1/14/2020,72,272,344,2,1,2020
11,1/14/2020,90,293,383,2,1,2020
12,1/14/2020,75,152,227,2,1,2020
13,1/14/2020,111,251,362,2,1,2020
14,1/14/2020,87,201,288,2,1,2020
15,1/14/2020,74,380,454,2,1,2020
16,1/14/2020,80,182,262,2,1,2020
17,1/14/2020,31,234,265,2,1,2020
18,1/14/2020,32,232,264,2,1,2020
19,1/14/2020,49,248,297,2,1,2020
20,1/14/2020,124,57,181,2,1,2020
21,1/14/2020,224,147,371,2,1,2020
22,1/14/2020,239,324,563,2,1,2020
23,1/14/2020,190,293,483,2,1,2020
0,1/15/2020,113,436,549,3,1,2020
1,1/15/2020,31,94,125,3,1,2020
2,1/15/2020,40,0,40,3,1,2020
3,1/15/2020,48,0,48,3,1,2020
4,1/15/2020,69,0,69,3,1,2020
5,1/15/2020,135,0,135,3,1,2020
6,1/15/2020,265,0,265,3,1,2020
7,1/15/2020,258,322,580,3,1,2020
8,1/15/2020,153,438,591,3,1,2020
9,1/15/2020,155,305,460,3,1,2020
10,1/15/2020,103,292,395,3,1,2020
11,1/15/2020,185,274,459,3,1,2020
12,1/15/2020,124,258,382,3,1,2020
13,1/15/2020,127,135,262,3,1,2020
14,1/15/2020,101,55,156,3,1,2020
15,1/15/2020,150,424,574,3,1,2020
16,1/15/2020,93,159,252,3,1,2020
17,1/15/2020,91,238,329,3,1,2020
18,1/15/2020,14,45,59,3,1,2020
19,1/15/2020,24,428,452,3,1,2020
20,1/15/2020,99,102,201,3,1,2020
21,1/15/2020,279,158,437,3,1,2020
22,1/15/2020,219,214,433,3,1,2020
23,1/15/2020,159,316,475,3,1,2020
0,1/16/2020,131,153,284,4,1,2020
1,1/16/2020,41,26,67,4,1,2020
2,1/16/2020,56,0,56,4,1,2020
3,1/16/2020,72,0,72,4,1,2020
4,1/16/2020,307,0,307,4,1,2020
5,1/16/2020,288,0,288,4,1,2020
6,1/16/2020,379,102,481,4,1,2020
7,1/16/2020,348,164,512,4,1,2020
8,1/16/2020,239,535,774,4,1,2020
9,1/16/2020,209,263,472,4,1,2020
10,1/16/2020,206,256,462,4,1,2020
11,1/16/2020,179,194,373,4,1,2020
12,1/16/2020,150,183,333,4,1,2020
13,1/16/2020,179,126,305,4,1,2020
14,1/16/2020,113,191,304,4,1,2020
15,1/16/2020,138,285,423,4,1,2020
16,1/16/2020,188,91,279,4,1,2020
17,1/16/2020,127,256,383,4,1,2020
18,1/16/2020,48,158,206,4,1,2020
19,1/16/2020,55,314,369,4,1,2020
20,1/16/2020,161,187,348,4,1,2020
21,1/16/2020,367,228,595,4,1,2020
22,1/16/2020,352,180,532,4,1,2020
23,1/16/2020,282,140,422,4,1,2020
0,1/17/2020,156,292,448,5,1,2020
1,1/17/2020,60,44,104,5,1,2020
2,1/17/2020,45,0,45,5,1,2020
3,1/17/2020,161,0,161,5,1,2020
4,1/17/2020,202,0,202,5,1,2020
5,1/17/2020,262,0,262,5,1,2020
6,1/17/2020,432,99,531,5,1,2020
7,1/17/2020,380,203,583,5,1,2020
8,1/17/2020,292,498,790,5,1,2020
9,1/17/2020,210,297,507,5,1,2020
10,1/17/2020,200,247,447,5,1,2020
11,1/17/2020,192,179,371,5,1,2020
12,1/17/2020,160,246,406,5,1,2020
13,1/17/2020,185,295,480,5,1,2020
14,1/17/2020,200,164,364,5,1,2020
15,1/17/2020,149,371,520,5,1,2020
16,1/17/2020,135,212,347,5,1,2020
17,1/17/2020,162,157,319,5,1,2020
18,1/17/2020,107,218,325,5,1,2020
19,1/17/2020,56,333,389,5,1,2020
20,1/17/2020,169,113,282,5,1,2020
21,1/17/2020,339,235,574,5,1,2020
22,1/17/2020,368,165,533,5,1,2020
23,1/17/2020,275,304,579,5,1,2020
0,1/18/2020,172,211,383,6,1,2020
1,1/18/2020,101,14,115,6,1,2020
2,1/18/2020,59,0,59,6,1,2020
3,1/18/2020,139,1,140,6,1,2020
4,1/18/2020,159,0,159,6,1,2020
5,1/18/2020,145,0,145,6,1,2020
6,1/18/2020,397,0,397,6,1,2020
7,1/18/2020,362,259,621,6,1,2020
8,1/18/2020,290,461,751,6,1,2020
9,1/18/2020,212,374,586,6,1,2020
10,1/18/2020,173,320,493,6,1,2020
11,1/18/2020,103,374,477,6,1,2020
12,1/18/2020,110,149,259,6,1,2020
13,1/18/2020,160,247,407,6,1,2020
14,1/18/2020,150,157,307,6,1,2020
15,1/18/2020,109,323,432,6,1,2020
16,1/18/2020,116,204,320,6,1,2020
17,1/18/2020,80,274,354,6,1,2020
18,1/18/2020,38,147,185,6,1,2020
19,1/18/2020,34,528,562,6,1,2020
20,1/18/2020,132,121,253,6,1,2020
21,1/18/2020,257,161,418,6,1,2020
22,1/18/2020,162,288,450,6,1,2020
23,1/18/2020,129,341,470,6,1,2020
0,1/19/2020,91,141,232,7,1,2020
1,1/19/2020,22,0,22,7,1,2020
2,1/19/2020,75,16,91,7,1,2020
3,1/19/2020,119,8,127,7,1,2020
4,1/19/2020,89,0,89,7,1,2020
5,1/19/2020,156,1,157,7,1,2020
6,1/19/2020,270,71,341,7,1,2020
7,1/19/2020,206,312,518,7,1,2020
8,1/19/2020,154,542,696,7,1,2020
9,1/19/2020,152,332,484,7,1,2020
10,1/19/2020,111,280,391,7,1,2020
11,1/19/2020,142,250,392,7,1,2020
12,1/19/2020,114,250,364,7,1,2020
13,1/19/2020,143,202,345,7,1,2020
14,1/19/2020,200,290,490,7,1,2020
15,1/19/2020,180,260,440,7,1,2020
16,1/19/2020,162,224,386,7,1,2020
17,1/19/2020,165,213,378,7,1,2020
18,1/19/2020,62,439,501,7,1,2020
19,1/19/2020,59,619,678,7,1,2020
20,1/19/2020,145,43,188,7,1,2020
21,1/19/2020,191,147,338,7,1,2020
22,1/19/2020,150,242,392,7,1,2020
23,1/19/2020,101,526,627,7,1,2020
0,1/20/2020,72,279,351,1,1,2020
1,1/20/2020,34,219,253,1,1,2020
2,1/20/2020,25,0,25,1,1,2020
3,1/20/2020,49,0,49,1,1,2020
4,1/20/2020,54,0,54,1,1,2020
5,1/20/2020,139,0,139,1,1,2020
6,1/20/2020,219,116,335,1,1,2020
7,1/20/2020,141,418,559,1,1,2020
8,1/20/2020,122,497,619,1,1,2020
9,1/20/2020,82,359,441,1,1,2020
10,1/20/2020,92,193,285,1,1,2020
11,1/20/2020,122,213,335,1,1,2020
12,1/20/2020,84,203,287,1,1,2020
13,1/20/2020,107,161,268,1,1,2020
14,1/20/2020,147,193,340,1,1,2020
15,1/20/2020,158,595,753,1,1,2020
16,1/20/2020,122,364,486,1,1,2020
17,1/20/2020,128,326,454,1,1,2020
18,1/20/2020,55,326,381,1,1,2020
19,1/20/2020,36,370,406,1,1,2020
20,1/20/2020,95,414,509,1,1,2020
21,1/20/2020,134,136,270,1,1,2020
22,1/20/2020,108,456,564,1,1,2020
23,1/20/2020,44,330,374,1,1,2020
0,1/21/2020,50,583,633,2,1,2020
1,1/21/2020,37,119,156,2,1,2020
2,1/21/2020,47,0,47,2,1,2020
3,1/21/2020,56,1,57,2,1,2020
4,1/21/2020,59,0,59,2,1,2020
5,1/21/2020,114,0,114,2,1,2020
6,1/21/2020,188,55,243,2,1,2020
7,1/21/2020,203,296,499,2,1,2020
8,1/21/2020,133,431,564,2,1,2020
9,1/21/2020,87,320,407,2,1,2020
10,1/21/2020,85,223,308,2,1,2020
11,1/21/2020,83,226,309,2,1,2020
12,1/21/2020,91,181,272,2,1,2020
13,1/21/2020,114,173,287,2,1,2020
14,1/21/2020,88,218,306,2,1,2020
15,1/21/2020,65,373,438,2,1,2020
16,1/21/2020,74,204,278,2,1,2020
17,1/21/2020,37,318,355,2,1,2020
18,1/21/2020,20,176,196,2,1,2020
19,1/21/2020,41,190,231,2,1,2020
20,1/21/2020,135,93,228,2,1,2020
21,1/21/2020,208,238,446,2,1,2020
22,1/21/2020,210,370,580,2,1,2020
23,1/21/2020,222,265,487,2,1,2020
0,1/22/2020,84,165,249,3,1,2020
1,1/22/2020,30,69,99,3,1,2020
2,1/22/2020,28,0,28,3,1,2020
3,1/22/2020,57,20,77,3,1,2020
4,1/22/2020,74,0,74,3,1,2020
5,1/22/2020,123,0,123,3,1,2020
6,1/22/2020,269,0,269,3,1,2020
7,1/22/2020,165,266,431,3,1,2020
8,1/22/2020,126,343,469,3,1,2020
9,1/22/2020,125,245,370,3,1,2020
10,1/22/2020,108,213,321,3,1,2020
11,1/22/2020,148,200,348,3,1,2020
12,1/22/2020,100,297,397,3,1,2020
13,1/22/2020,82,128,210,3,1,2020
14,1/22/2020,126,52,178,3,1,2020
15,1/22/2020,86,356,442,3,1,2020
16,1/22/2020,97,163,260,3,1,2020
17,1/22/2020,112,226,338,3,1,2020
18,1/22/2020,16,65,81,3,1,2020
19,1/22/2020,43,363,406,3,1,2020
20,1/22/2020,149,134,283,3,1,2020
21,1/22/2020,254,195,449,3,1,2020
22,1/22/2020,200,136,336,3,1,2020
23,1/22/2020,211,237,448,3,1,2020
0,1/23/2020,123,186,309,4,1,2020
1,1/23/2020,45,26,71,4,1,2020
2,1/23/2020,79,0,79,4,1,2020
3,1/23/2020,79,0,79,4,1,2020
4,1/23/2020,230,0,230,4,1,2020
5,1/23/2020,199,1,200,4,1,2020
6,1/23/2020,282,74,356,4,1,2020
7,1/23/2020,256,322,578,4,1,2020
8,1/23/2020,206,241,447,4,1,2020
9,1/23/2020,169,231,400,4,1,2020
10,1/23/2020,134,316,450,4,1,2020
11,1/23/2020,171,222,393,4,1,2020
12,1/23/2020,100,36,136,4,1,2020
13,1/23/2020,105,230,335,4,1,2020
14,1/23/2020,103,133,236,4,1,2020
15,1/23/2020,129,337,466,4,1,2020
16,1/23/2020,131,44,175,4,1,2020
17,1/23/2020,145,203,348,4,1,2020
18,1/23/2020,67,150,217,4,1,2020
19,1/23/2020,66,442,508,4,1,2020
20,1/23/2020,125,146,271,4,1,2020
21,1/23/2020,350,230,580,4,1,2020
22,1/23/2020,294,179,473,4,1,2020
23,1/23/2020,253,140,393,4,1,2020
0,1/24/2020,113,211,324,5,1,2020
1,1/24/2020,67,63,130,5,1,2020
2,1/24/2020,78,21,99,5,1,2020
3,1/24/2020,125,0,125,5,1,2020
4,1/24/2020,137,0,137,5,1,2020
5,1/24/2020,240,2,242,5,1,2020
6,1/24/2020,428,89,517,5,1,2020
7,1/24/2020,296,186,482,5,1,2020
8,1/24/2020,230,377,607,5,1,2020
9,1/24/2020,192,254,446,5,1,2020
10,1/24/2020,123,215,338,5,1,2020
11,1/24/2020,195,144,339,5,1,2020
12,1/24/2020,116,150,266,5,1,2020
13,1/24/2020,95,71,166,5,1,2020
14,1/24/2020,142,240,382,5,1,2020
15,1/24/2020,149,256,405,5,1,2020
16,1/24/2020,87,223,310,5,1,2020
17,1/24/2020,126,199,325,5,1,2020
18,1/24/2020,102,53,155,5,1,2020
19,1/24/2020,74,315,389,5,1,2020
20,1/24/2020,141,13,154,5,1,2020
21,1/24/2020,217,0,217,5,1,2020
22,1/24/2020,142,3,145,5,1,2020
23,1/24/2020,115,9,124,5,1,2020
0,1/25/2020,35,5,40,6,1,2020
1,1/25/2020,16,0,16,6,1,2020
2,1/25/2020,45,9,54,6,1,2020
3,1/25/2020,116,2,118,6,1,2020
4,1/25/2020,101,0,101,6,1,2020
5,1/25/2020,159,1,160,6,1,2020
6,1/25/2020,311,5,316,6,1,2020
7,1/25/2020,273,0,273,6,1,2020
8,1/25/2020,242,9,251,6,1,2020
9,1/25/2020,206,4,210,6,1,2020
10,1/25/2020,241,36,277,6,1,2020
11,1/25/2020,107,147,254,6,1,2020
12,1/25/2020,115,368,483,6,1,2020
13,1/25/2020,104,315,419,6,1,2020
14,1/25/2020,118,352,470,6,1,2020
15,1/25/2020,145,505,650,6,1,2020
16,1/25/2020,123,227,350,6,1,2020
17,1/25/2020,91,104,195,6,1,2020
18,1/25/2020,73,194,267,6,1,2020
19,1/25/2020,87,268,355,6,1,2020
20,1/25/2020,151,244,395,6,1,2020
21,1/25/2020,231,323,554,6,1,2020
22,1/25/2020,174,542,716,6,1,2020
23,1/25/2020,166,22,188,6,1,2020
0,1/26/2020,68,124,192,7,1,2020
1,1/26/2020,29,14,43,7,1,2020
2,1/26/2020,47,52,99,7,1,2020
3,1/26/2020,73,57,130,7,1,2020
4,1/26/2020,87,22,109,7,1,2020
5,1/26/2020,135,5,140,7,1,2020
6,1/26/2020,301,0,301,7,1,2020
7,1/26/2020,218,32,250,7,1,2020
8,1/26/2020,159,303,462,7,1,2020
9,1/26/2020,200,325,525,7,1,2020
10,1/26/2020,153,328,481,7,1,2020
11,1/26/2020,135,506,641,7,1,2020
12,1/26/2020,111,394,505,7,1,2020
13,1/26/2020,182,75,257,7,1,2020
14,1/26/2020,169,335,504,7,1,2020
15,1/26/2020,138,301,439,7,1,2020
16,1/26/2020,212,101,313,7,1,2020
17,1/26/2020,161,289,450,7,1,2020
18,1/26/2020,67,335,402,7,1,2020
19,1/26/2020,53,430,483,7,1,2020
20,1/26/2020,125,179,304,7,1,2020
21,1/26/2020,207,186,393,7,1,2020
22,1/26/2020,117,163,280,7,1,2020
23,1/26/2020,133,292,425,7,1,2020
0,1/27/2020,43,380,423,1,1,2020
1,1/27/2020,34,430,464,1,1,2020
2,1/27/2020,4,45,49,1,1,2020
3,1/27/2020,28,52,80,1,1,2020
4,1/27/2020,70,0,70,1,1,2020
5,1/27/2020,86,49,135,1,1,2020
6,1/27/2020,218,53,271,1,1,2020
7,1/27/2020,175,296,471,1,1,2020
8,1/27/2020,151,430,581,1,1,2020
9,1/27/2020,114,314,428,1,1,2020
10,1/27/2020,102,194,296,1,1,2020
11,1/27/2020,112,176,288,1,1,2020
12,1/27/2020,95,78,173,1,1,2020
13,1/27/2020,116,281,397,1,1,2020
14,1/27/2020,170,90,260,1,1,2020
15,1/27/2020,139,335,474,1,1,2020
16,1/27/2020,72,336,408,1,1,2020
17,1/27/2020,92,175,267,1,1,2020
18,1/27/2020,38,146,184,1,1,2020
19,1/27/2020,16,461,477,1,1,2020
20,1/27/2020,87,246,333,1,1,2020
21,1/27/2020,161,158,319,1,1,2020
22,1/27/2020,185,194,379,1,1,2020
23,1/27/2020,73,297,370,1,1,2020
0,1/28/2020,42,316,358,2,1,2020
1,1/28/2020,45,106,151,2,1,2020
2,1/28/2020,33,5,38,2,1,2020
3,1/28/2020,33,1,34,2,1,2020
4,1/28/2020,60,0,60,2,1,2020
5,1/28/2020,102,0,102,2,1,2020
6,1/28/2020,252,66,318,2,1,2020
7,1/28/2020,209,251,460,2,1,2020
8,1/28/2020,121,336,457,2,1,2020
9,1/28/2020,95,257,352,2,1,2020
10,1/28/2020,75,106,181,2,1,2020
11,1/28/2020,68,138,206,2,1,2020
12,1/28/2020,120,118,238,2,1,2020
13,1/28/2020,121,291,412,2,1,2020
14,1/28/2020,85,199,284,2,1,2020
15,1/28/2020,91,317,408,2,1,2020
16,1/28/2020,101,233,334,2,1,2020
17,1/28/2020,39,241,280,2,1,2020
18,1/28/2020,20,46,66,2,1,2020
19,1/28/2020,40,285,325,2,1,2020
20,1/28/2020,141,23,164,2,1,2020
21,1/28/2020,214,149,363,2,1,2020
22,1/28/2020,219,282,501,2,1,2020
23,1/28/2020,169,281,450,2,1,2020
0,1/29/2020,112,139,251,3,1,2020
1,1/29/2020,18,76,94,3,1,2020
2,1/29/2020,23,0,23,3,1,2020
3,1/29/2020,42,0,42,3,1,2020
4,1/29/2020,85,0,85,3,1,2020
5,1/29/2020,115,0,115,3,1,2020
6,1/29/2020,253,0,253,3,1,2020
7,1/29/2020,185,145,330,3,1,2020
8,1/29/2020,132,370,502,3,1,2020
9,1/29/2020,94,367,461,3,1,2020
10,1/29/2020,137,295,432,3,1,2020
11,1/29/2020,122,225,347,3,1,2020
12,1/29/2020,96,213,309,3,1,2020
13,1/29/2020,127,187,314,3,1,2020
14,1/29/2020,103,89,192,3,1,2020
15,1/29/2020,107,385,492,3,1,2020
16,1/29/2020,101,211,312,3,1,2020
17,1/29/2020,104,181,285,3,1,2020
18,1/29/2020,71,98,169,3,1,2020
19,1/29/2020,56,357,413,3,1,2020
20,1/29/2020,92,155,247,3,1,2020
21,1/29/2020,263,204,467,3,1,2020
22,1/29/2020,242,131,373,3,1,2020
23,1/29/2020,172,103,275,3,1,2020
0,1/30/2020,50,197,247,4,1,2020
1,1/30/2020,33,8,41,4,1,2020
2,1/30/2020,50,0,50,4,1,2020
3,1/30/2020,119,41,160,4,1,2020
4,1/30/2020,174,0,174,4,1,2020
5,1/30/2020,257,0,257,4,1,2020
6,1/30/2020,260,101,361,4,1,2020
7,1/30/2020,248,316,564,4,1,2020
8,1/30/2020,269,383,652,4,1,2020
9,1/30/2020,169,448,617,4,1,2020
10,1/30/2020,148,115,263,4,1,2020
11,1/30/2020,163,330,493,4,1,2020
12,1/30/2020,102,275,377,4,1,2020
13,1/30/2020,124,300,424,4,1,2020
14,1/30/2020,171,155,326,4,1,2020
15,1/30/2020,140,144,284,4,1,2020
16,1/30/2020,156,41,197,4,1,2020
17,1/30/2020,123,474,597,4,1,2020
18,1/30/2020,70,402,472,4,1,2020
19,1/30/2020,59,469,528,4,1,2020
20,1/30/2020,152,171,323,4,1,2020
21,1/30/2020,301,299,600,4,1,2020
22,1/30/2020,300,253,553,4,1,2020
23,1/30/2020,243,369,612,4,1,2020
0,1/31/2020,128,352,480,5,1,2020
1,1/31/2020,58,67,125,5,1,2020
2,1/31/2020,56,34,90,5,1,2020
3,1/31/2020,117,0,117,5,1,2020
4,1/31/2020,124,0,124,5,1,2020
5,1/31/2020,233,1,234,5,1,2020
6,1/31/2020,352,100,452,5,1,2020
7,1/31/2020,185,348,533,5,1,2020
8,1/31/2020,166,463,629,5,1,2020
9,1/31/2020,239,339,578,5,1,2020
10,1/31/2020,97,338,435,5,1,2020
11,1/31/2020,96,257,353,5,1,2020
12,1/31/2020,80,261,341,5,1,2020
13,1/31/2020,135,198,333,5,1,2020
14,1/31/2020,125,220,345,5,1,2020
15,1/31/2020,77,370,447,5,1,2020
16,1/31/2020,93,137,230,5,1,2020
17,1/31/2020,111,322,433,5,1,2020
18,1/31/2020,72,172,244,5,1,2020
19,1/31/2020,44,438,482,5,1,2020
20,1/31/2020,148,164,312,5,1,2020
21,1/31/2020,271,235,506,5,1,2020
22,1/31/2020,274,339,613,5,1,2020
23,1/31/2020,245,301,546,5,1,2020
0,2/1/2020,79,175,254,6,2,2020
1,2/1/2020,21,183,204,6,2,2020
2,2/1/2020,6,20,26,6,2,2020
3,2/1/2020,58,1,59,6,2,2020
4,2/1/2020,113,2,115,6,2,2020
5,2/1/2020,164,6,170,6,2,2020
6,2/1/2020,318,1,319,6,2,2020
7,2/1/2020,303,317,620,6,2,2020
8,2/1/2020,140,447,587,6,2,2020
9,2/1/2020,165,268,433,6,2,2020
10,2/1/2020,140,271,411,6,2,2020
11,2/1/2020,84,257,341,6,2,2020
12,2/1/2020,95,137,232,6,2,2020
13,2/1/2020,118,261,379,6,2,2020
14,2/1/2020,138,350,488,6,2,2020
15,2/1/2020,132,256,388,6,2,2020
16,2/1/2020,56,170,226,6,2,2020
17,2/1/2020,43,340,383,6,2,2020
18,2/1/2020,48,182,230,6,2,2020
19,2/1/2020,56,399,455,6,2,2020
20,2/1/2020,96,297,393,6,2,2020
21,2/1/2020,193,53,246,6,2,2020
22,2/1/2020,186,394,580,6,2,2020
23,2/1/2020,134,227,361,6,2,2020
0,2/2/2020,70,86,156,7,2,2020
1,2/2/2020,22,62,84,7,2,2020
2,2/2/2020,55,0,55,7,2,2020
3,2/2/2020,69,0,69,7,2,2020
4,2/2/2020,82,0,82,7,2,2020
5,2/2/2020,126,0,126,7,2,2020
6,2/2/2020,253,64,317,7,2,2020
7,2/2/2020,232,320,552,7,2,2020
8,2/2/2020,88,498,586,7,2,2020
9,2/2/2020,100,296,396,7,2,2020
10,2/2/2020,118,250,368,7,2,2020
11,2/2/2020,98,199,297,7,2,2020
12,2/2/2020,110,346,456,7,2,2020
13,2/2/2020,105,8,113,7,2,2020
14,2/2/2020,157,196,353,7,2,2020
15,2/2/2020,159,335,494,7,2,2020
16,2/2/2020,153,212,365,7,2,2020
17,2/2/2020,82,323,405,7,2,2020
18,2/2/2020,46,420,466,7,2,2020
19,2/2/2020,70,403,473,7,2,2020
20,2/2/2020,107,154,261,7,2,2020
21,2/2/2020,143,99,242,7,2,2020
22,2/2/2020,186,212,398,7,2,2020
23,2/2/2020,138,424,562,7,2,2020
0,2/3/2020,56,178,234,1,2,2020
1,2/3/2020,45,99,144,1,2,2020
2,2/3/2020,21,0,21,1,2,2020
3,2/3/2020,38,0,38,1,2,2020
4,2/3/2020,89,0,89,1,2,2020
5,2/3/2020,150,0,150,1,2,2020
6,2/3/2020,323,80,403,1,2,2020
7,2/3/2020,342,400,742,1,2,2020
8,2/3/2020,204,368,572,1,2,2020
9,2/3/2020,261,87,348,1,2,2020
10,2/3/2020,167,160,327,1,2,2020
11,2/3/2020,209,277,486,1,2,2020
12,2/3/2020,156,64,220,1,2,2020
13,2/3/2020,300,193,493,1,2,2020
14,2/3/2020,288,221,509,1,2,2020
15,2/3/2020,300,182,482,1,2,2020
16,2/3/2020,353,116,469,1,2,2020
17,2/3/2020,284,181,465,1,2,2020
18,2/3/2020,102,274,376,1,2,2020
19,2/3/2020,76,339,415,1,2,2020
20,2/3/2020,191,105,296,1,2,2020
21,2/3/2020,267,97,364,1,2,2020
22,2/3/2020,264,138,402,1,2,2020
23,2/3/2020,114,208,322,1,2,2020
0,2/4/2020,74,186,260,2,2,2020
1,2/4/2020,17,77,94,2,2,2020
2,2/4/2020,13,80,93,2,2,2020
3,2/4/2020,59,0,59,2,2,2020
4,2/4/2020,87,0,87,2,2,2020
5,2/4/2020,182,0,182,2,2,2020
6,2/4/2020,375,61,436,2,2,2020
7,2/4/2020,314,330,644,2,2,2020
8,2/4/2020,244,184,428,2,2,2020
9,2/4/2020,215,201,416,2,2,2020
10,2/4/2020,134,123,257,2,2,2020
11,2/4/2020,111,226,337,2,2,2020
12,2/4/2020,146,185,331,2,2,2020
13,2/4/2020,237,112,349,2,2,2020
14,2/4/2020,198,191,389,2,2,2020
15,2/4/2020,191,240,431,2,2,2020
16,2/4/2020,249,180,429,2,2,2020
17,2/4/2020,100,223,323,2,2,2020
18,2/4/2020,54,102,156,2,2,2020
19,2/4/2020,34,212,246,2,2,2020
20,2/4/2020,167,97,264,2,2,2020
21,2/4/2020,198,118,316,2,2,2020
22,2/4/2020,178,233,411,2,2,2020
23,2/4/2020,163,232,395,2,2,2020
0,2/5/2020,76,208,284,3,2,2020
1,2/5/2020,16,77,93,3,2,2020
2,2/5/2020,28,12,40,3,2,2020
3,2/5/2020,61,0,61,3,2,2020
4,2/5/2020,85,0,85,3,2,2020
5,2/5/2020,88,0,88,3,2,2020
6,2/5/2020,297,1,298,3,2,2020
7,2/5/2020,201,248,449,3,2,2020
8,2/5/2020,165,196,361,3,2,2020
9,2/5/2020,145,363,508,3,2,2020
10,2/5/2020,145,235,380,3,2,2020
11,2/5/2020,137,217,354,3,2,2020
12,2/5/2020,158,167,325,3,2,2020
13,2/5/2020,122,147,269,3,2,2020
14,2/5/2020,109,56,165,3,2,2020
15,2/5/2020,152,240,392,3,2,2020
16,2/5/2020,141,159,300,3,2,2020
17,2/5/2020,169,97,266,3,2,2020
18,2/5/2020,47,54,101,3,2,2020
19,2/5/2020,26,229,255,3,2,2020
20,2/5/2020,112,146,258,3,2,2020
21,2/5/2020,223,140,363,3,2,2020
22,2/5/2020,251,146,397,3,2,2020
23,2/5/2020,121,126,247,3,2,2020
0,2/6/2020,77,126,203,4,2,2020
1,2/6/2020,27,49,76,4,2,2020
2,2/6/2020,45,0,45,4,2,2020
3,2/6/2020,111,32,143,4,2,2020
4,2/6/2020,224,4,228,4,2,2020
5,2/6/2020,275,0,275,4,2,2020
6,2/6/2020,275,55,330,4,2,2020
7,2/6/2020,341,127,468,4,2,2020
8,2/6/2020,219,430,649,4,2,2020
9,2/6/2020,184,235,419,4,2,2020
10,2/6/2020,103,56,159,4,2,2020
11,2/6/2020,199,242,441,4,2,2020
12,2/6/2020,91,177,268,4,2,2020
13,2/6/2020,113,189,302,4,2,2020
14,2/6/2020,152,103,255,4,2,2020
15,2/6/2020,144,229,373,4,2,2020
16,2/6/2020,178,107,285,4,2,2020
17,2/6/2020,123,153,276,4,2,2020
18,2/6/2020,77,144,221,4,2,2020
19,2/6/2020,39,376,415,4,2,2020
20,2/6/2020,131,183,314,4,2,2020
21,2/6/2020,317,116,433,4,2,2020
22,2/6/2020,363,90,453,4,2,2020
23,2/6/2020,209,197,406,4,2,2020
0,2/7/2020,132,162,294,5,2,2020
1,2/7/2020,52,40,92,5,2,2020
2,2/7/2020,60,0,60,5,2,2020
3,2/7/2020,110,0,110,5,2,2020
4,2/7/2020,117,1,118,5,2,2020
5,2/7/2020,224,0,224,5,2,2020
6,2/7/2020,346,71,417,5,2,2020
7,2/7/2020,350,264,614,5,2,2020
8,2/7/2020,191,341,532,5,2,2020
9,2/7/2020,162,236,398,5,2,2020
10,2/7/2020,162,158,320,5,2,2020
11,2/7/2020,125,154,279,5,2,2020
12,2/7/2020,144,171,315,5,2,2020
13,2/7/2020,158,200,358,5,2,2020
14,2/7/2020,173,113,286,5,2,2020
15,2/7/2020,84,259,343,5,2,2020
16,2/7/2020,99,254,353,5,2,2020
17,2/7/2020,129,154,283,5,2,2020
18,2/7/2020,78,57,135,5,2,2020
19,2/7/2020,70,325,395,5,2,2020
20,2/7/2020,124,208,332,5,2,2020
21,2/7/2020,291,178,469,5,2,2020
22,2/7/2020,328,169,497,5,2,2020
23,2/7/2020,250,179,429,5,2,2020
0,2/8/2020,130,164,294,6,2,2020
1,2/8/2020,63,15,78,6,2,2020
2,2/8/2020,41,1,42,6,2,2020
3,2/8/2020,92,0,92,6,2,2020
4,2/8/2020,91,0,91,6,2,2020
5,2/8/2020,187,1,188,6,2,2020
6,2/8/2020,356,0,356,6,2,2020
7,2/8/2020,362,317,679,6,2,2020
8,2/8/2020,319,455,774,6,2,2020
9,2/8/2020,219,474,693,6,2,2020
10,2/8/2020,160,175,335,6,2,2020
11,2/8/2020,94,173,267,6,2,2020
12,2/8/2020,87,279,366,6,2,2020
13,2/8/2020,161,111,272,6,2,2020
14,2/8/2020,173,368,541,6,2,2020
15,2/8/2020,149,282,431,6,2,2020
16,2/8/2020,159,216,375,6,2,2020
17,2/8/2020,119,121,240,6,2,2020
18,2/8/2020,64,173,237,6,2,2020
19,2/8/2020,57,360,417,6,2,2020
20,2/8/2020,111,183,294,6,2,2020
21,2/8/2020,181,160,341,6,2,2020
22,2/8/2020,177,269,446,6,2,2020
23,2/8/2020,131,258,389,6,2,2020
0,2/9/2020,60,66,126,7,2,2020
1,2/9/2020,43,0,43,7,2,2020
2,2/9/2020,24,0,24,7,2,2020
3,2/9/2020,87,0,87,7,2,2020
4,2/9/2020,100,0,100,7,2,2020
5,2/9/2020,170,0,170,7,2,2020
6,2/9/2020,329,79,408,7,2,2020
7,2/9/2020,253,361,614,7,2,2020
8,2/9/2020,200,467,667,7,2,2020
9,2/9/2020,149,213,362,7,2,2020
10,2/9/2020,161,205,366,7,2,2020
11,2/9/2020,141,258,399,7,2,2020
12,2/9/2020,139,269,408,7,2,2020
13,2/9/2020,184,210,394,7,2,2020
14,2/9/2020,230,185,415,7,2,2020
15,2/9/2020,165,224,389,7,2,2020
16,2/9/2020,215,313,528,7,2,2020
17,2/9/2020,145,188,333,7,2,2020
18,2/9/2020,50,341,391,7,2,2020
19,2/9/2020,47,543,590,7,2,2020
20,2/9/2020,134,101,235,7,2,2020
21,2/9/2020,174,62,236,7,2,2020
22,2/9/2020,200,299,499,7,2,2020
23,2/9/2020,88,381,469,7,2,2020
0,2/10/2020,79,173,252,1,2,2020
1,2/10/2020,29,109,138,1,2,2020
2,2/10/2020,5,0,5,1,2,2020
3,2/10/2020,36,0,36,1,2,2020
4,2/10/2020,73,0,73,1,2,2020
5,2/10/2020,110,1,111,1,2,2020
6,2/10/2020,233,74,307,1,2,2020
7,2/10/2020,188,345,533,1,2,2020
8,2/10/2020,141,353,494,1,2,2020
9,2/10/2020,101,301,402,1,2,2020
10,2/10/2020,90,163,253,1,2,2020
11,2/10/2020,81,168,249,1,2,2020
12,2/10/2020,92,209,301,1,2,2020
13,2/10/2020,148,128,276,1,2,2020
14,2/10/2020,176,159,335,1,2,2020
15,2/10/2020,102,420,522,1,2,2020
16,2/10/2020,144,160,304,1,2,2020
17,2/10/2020,124,209,333,1,2,2020
18,2/10/2020,32,218,250,1,2,2020
19,2/10/2020,40,391,431,1,2,2020
20,2/10/2020,85,146,231,1,2,2020
21,2/10/2020,124,185,309,1,2,2020
22,2/10/2020,118,232,350,1,2,2020
23,2/10/2020,69,218,287,1,2,2020
0,2/11/2020,16,278,294,2,2,2020
1,2/11/2020,17,30,47,2,2,2020
2,2/11/2020,50,0,50,2,2,2020
3,2/11/2020,53,0,53,2,2,2020
4,2/11/2020,74,1,75,2,2,2020
5,2/11/2020,128,0,128,2,2,2020
6,2/11/2020,240,62,302,2,2,2020
7,2/11/2020,217,334,551,2,2,2020
8,2/11/2020,153,163,316,2,2,2020
9,2/11/2020,65,188,253,2,2,2020
10,2/11/2020,70,58,128,2,2,2020
11,2/11/2020,71,168,239,2,2,2020
12,2/11/2020,135,234,369,2,2,2020
13,2/11/2020,107,85,192,2,2,2020
14,2/11/2020,101,237,338,2,2,2020
15,2/11/2020,81,291,372,2,2,2020
16,2/11/2020,63,121,184,2,2,2020
17,2/11/2020,98,174,272,2,2,2020
18,2/11/2020,23,109,132,2,2,2020
19,2/11/2020,41,174,215,2,2,2020
20,2/11/2020,132,45,177,2,2,2020
21,2/11/2020,261,193,454,2,2,2020
22,2/11/2020,251,226,477,2,2,2020
23,2/11/2020,239,200,439,2,2,2020
0,2/12/2020,113,96,209,3,2,2020
1,2/12/2020,57,32,89,3,2,2020
2,2/12/2020,7,0,7,3,2,2020
3,2/12/2020,0,0,0,3,2,2020
4,2/12/2020,57,2,59,3,2,2020
5,2/12/2020,169,0,169,3,2,2020
6,2/12/2020,570,0,570,3,2,2020
7,2/12/2020,257,224,481,3,2,2020
8,2/12/2020,165,189,354,3,2,2020
9,2/12/2020,145,227,372,3,2,2020
10,2/12/2020,150,286,436,3,2,2020
11,2/12/2020,217,191,408,3,2,2020
12,2/12/2020,143,148,291,3,2,2020
13,2/12/2020,97,177,274,3,2,2020
14,2/12/2020,143,129,272,3,2,2020
15,2/12/2020,122,174,296,3,2,2020
16,2/12/2020,127,289,416,3,2,2020
17,2/12/2020,102,102,204,3,2,2020
18,2/12/2020,63,106,169,3,2,2020
19,2/12/2020,41,258,299,3,2,2020
20,2/12/2020,160,80,240,3,2,2020
21,2/12/2020,327,142,469,3,2,2020
22,2/12/2020,289,119,408,3,2,2020
23,2/12/2020,200,181,381,3,2,2020
0,2/13/2020,161,62,223,4,2,2020
1,2/13/2020,54,0,54,4,2,2020
2,2/13/2020,64,0,64,4,2,2020
3,2/13/2020,187,0,187,4,2,2020
4,2/13/2020,314,1,315,4,2,2020
5,2/13/2020,367,0,367,4,2,2020
6,2/13/2020,492,74,566,4,2,2020
7,2/13/2020,388,345,733,4,2,2020
8,2/13/2020,273,236,509,4,2,2020
9,2/13/2020,197,187,384,4,2,2020
10,2/13/2020,205,145,350,4,2,2020
11,2/13/2020,252,226,478,4,2,2020
12,2/13/2020,203,142,345,4,2,2020
13,2/13/2020,170,162,332,4,2,2020
14,2/13/2020,171,264,435,4,2,2020
15,2/13/2020,249,143,392,4,2,2020
16,2/13/2020,247,109,356,4,2,2020
17,2/13/2020,201,116,317,4,2,2020
18,2/13/2020,124,202,326,4,2,2020
19,2/13/2020,52,454,506,4,2,2020
20,2/13/2020,179,90,269,4,2,2020
21,2/13/2020,436,81,517,4,2,2020
22,2/13/2020,451,65,516,4,2,2020
23,2/13/2020,345,260,605,4,2,2020
0,2/14/2020,261,124,385,5,2,2020
1,2/14/2020,104,22,126,5,2,2020
2,2/14/2020,63,1,64,5,2,2020
3,2/14/2020,208,0,208,5,2,2020
4,2/14/2020,293,0,293,5,2,2020
5,2/14/2020,284,0,284,5,2,2020
6,2/14/2020,471,69,540,5,2,2020
7,2/14/2020,567,189,756,5,2,2020
8,2/14/2020,261,319,580,5,2,2020
9,2/14/2020,338,281,619,5,2,2020
10,2/14/2020,244,146,390,5,2,2020
11,2/14/2020,215,132,347,5,2,2020
12,2/14/2020,165,132,297,5,2,2020
13,2/14/2020,236,188,424,5,2,2020
14,2/14/2020,251,136,387,5,2,2020
15,2/14/2020,154,200,354,5,2,2020
16,2/14/2020,168,146,314,5,2,2020
17,2/14/2020,186,90,276,5,2,2020
18,2/14/2020,139,202,341,5,2,2020
19,2/14/2020,39,222,261,5,2,2020
20,2/14/2020,175,174,349,5,2,2020
21,2/14/2020,306,178,484,5,2,2020
22,2/14/2020,465,164,629,5,2,2020
23,2/14/2020,365,119,484,5,2,2020
0,2/15/2020,272,206,478,6,2,2020
1,2/15/2020,101,39,140,6,2,2020
2,2/15/2020,35,46,81,6,2,2020
3,2/15/2020,158,0,158,6,2,2020
4,2/15/2020,222,0,222,6,2,2020
5,2/15/2020,216,0,216,6,2,2020
6,2/15/2020,465,1,466,6,2,2020
7,2/15/2020,554,250,804,6,2,2020
8,2/15/2020,407,459,866,6,2,2020
9,2/15/2020,330,321,651,6,2,2020
10,2/15/2020,233,225,458,6,2,2020
11,2/15/2020,227,255,482,6,2,2020
12,2/15/2020,164,190,354,6,2,2020
13,2/15/2020,192,186,378,6,2,2020
14,2/15/2020,212,251,463,6,2,2020
15,2/15/2020,224,169,393,6,2,2020
16,2/15/2020,158,325,483,6,2,2020
17,2/15/2020,123,202,325,6,2,2020
18,2/15/2020,79,194,273,6,2,2020
19,2/15/2020,51,356,407,6,2,2020
20,2/15/2020,167,184,351,6,2,2020
21,2/15/2020,285,56,341,6,2,2020
22,2/15/2020,290,392,682,6,2,2020
23,2/15/2020,179,282,461,6,2,2020
0,2/16/2020,159,102,261,7,2,2020
1,2/16/2020,46,0,46,7,2,2020
2,2/16/2020,63,0,63,7,2,2020
3,2/16/2020,136,0,136,7,2,2020
4,2/16/2020,116,0,116,7,2,2020
5,2/16/2020,165,0,165,7,2,2020
6,2/16/2020,368,76,444,7,2,2020
7,2/16/2020,287,297,584,7,2,2020
8,2/16/2020,244,412,656,7,2,2020
9,2/16/2020,120,254,374,7,2,2020
10,2/16/2020,155,215,370,7,2,2020
11,2/16/2020,215,209,424,7,2,2020
12,2/16/2020,159,326,485,7,2,2020
13,2/16/2020,217,170,387,7,2,2020
14,2/16/2020,193,192,385,7,2,2020
15,2/16/2020,151,404,555,7,2,2020
16,2/16/2020,185,121,306,7,2,2020
17,2/16/2020,176,268,444,7,2,2020
18,2/16/2020,54,391,445,7,2,2020
19,2/16/2020,53,391,444,7,2,2020
20,2/16/2020,140,165,305,7,2,2020
21,2/16/2020,162,110,272,7,2,2020
22,2/16/2020,222,125,347,7,2,2020
23,2/16/2020,160,362,522,7,2,2020
0,2/17/2020,93,6,99,1,2,2020
1,2/17/2020,64,4,68,1,2,2020
2,2/17/2020,20,0,20,1,2,2020
3,2/17/2020,40,0,40,1,2,2020
4,2/17/2020,77,0,77,1,2,2020
5,2/17/2020,132,0,132,1,2,2020
6,2/17/2020,247,0,247,1,2,2020
7,2/17/2020,235,0,235,1,2,2020
8,2/17/2020,193,208,401,1,2,2020
9,2/17/2020,165,634,799,1,2,2020
10,2/17/2020,142,443,585,1,2,2020
11,2/17/2020,155,395,550,1,2,2020
12,2/17/2020,66,351,417,1,2,2020
13,2/17/2020,157,191,348,1,2,2020
14,2/17/2020,152,114,266,1,2,2020
15,2/17/2020,151,269,420,1,2,2020
16,2/17/2020,168,498,666,1,2,2020
17,2/17/2020,111,170,281,1,2,2020
18,2/17/2020,37,472,509,1,2,2020
19,2/17/2020,24,708,732,1,2,2020
20,2/17/2020,78,302,380,1,2,2020
21,2/17/2020,174,46,220,1,2,2020
22,2/17/2020,152,305,457,1,2,2020
23,2/17/2020,104,311,415,1,2,2020
0,2/18/2020,65,864,929,2,2,2020
1,2/18/2020,10,430,440,2,2,2020
2,2/18/2020,25,234,259,2,2,2020
3,2/18/2020,67,1,68,2,2,2020
4,2/18/2020,89,0,89,2,2,2020
5,2/18/2020,159,0,159,2,2,2020
6,2/18/2020,227,84,311,2,2,2020
7,2/18/2020,250,198,448,2,2,2020
8,2/18/2020,148,518,666,2,2,2020
9,2/18/2020,137,439,576,2,2,2020
10,2/18/2020,117,179,296,2,2,2020
11,2/18/2020,70,144,214,2,2,2020
12,2/18/2020,79,131,210,2,2,2020
13,2/18/2020,136,340,476,2,2,2020
14,2/18/2020,75,259,334,2,2,2020
15,2/18/2020,120,165,285,2,2,2020
16,2/18/2020,97,479,576,2,2,2020
17,2/18/2020,78,162,240,2,2,2020
18,2/18/2020,25,196,221,2,2,2020
19,2/18/2020,32,358,390,2,2,2020
20,2/18/2020,147,96,243,2,2,2020
21,2/18/2020,251,211,462,2,2,2020
22,2/18/2020,244,441,685,2,2,2020
23,2/18/2020,208,305,513,2,2,2020
0,2/19/2020,101,263,364,3,2,2020
1,2/19/2020,39,55,94,3,2,2020
2,2/19/2020,61,0,61,3,2,2020
3,2/19/2020,138,0,138,3,2,2020
4,2/19/2020,103,0,103,3,2,2020
5,2/19/2020,162,0,162,3,2,2020
6,2/19/2020,403,0,403,3,2,2020
7,2/19/2020,248,225,473,3,2,2020
8,2/19/2020,185,438,623,3,2,2020
9,2/19/2020,216,241,457,3,2,2020
10,2/19/2020,193,334,527,3,2,2020
11,2/19/2020,161,195,356,3,2,2020
12,2/19/2020,100,211,311,3,2,2020
13,2/19/2020,122,144,266,3,2,2020
14,2/19/2020,124,175,299,3,2,2020
15,2/19/2020,118,179,297,3,2,2020
16,2/19/2020,80,438,518,3,2,2020
17,2/19/2020,103,164,267,3,2,2020
18,2/19/2020,49,198,247,3,2,2020
19,2/19/2020,26,378,404,3,2,2020
20,2/19/2020,116,80,196,3,2,2020
21,2/19/2020,234,52,286,3,2,2020
22,2/19/2020,364,212,576,3,2,2020
23,2/19/2020,184,250,434,3,2,2020
0,2/20/2020,123,99,222,4,2,2020
1,2/20/2020,60,58,118,4,2,2020
2,2/20/2020,43,4,47,4,2,2020
3,2/20/2020,152,0,152,4,2,2020
4,2/20/2020,285,3,288,4,2,2020
5,2/20/2020,406,0,406,4,2,2020
6,2/20/2020,399,65,464,4,2,2020
7,2/20/2020,334,392,726,4,2,2020
8,2/20/2020,216,250,466,4,2,2020
9,2/20/2020,118,245,363,4,2,2020
10,2/20/2020,208,67,275,4,2,2020
11,2/20/2020,238,227,465,4,2,2020
12,2/20/2020,136,167,303,4,2,2020
13,2/20/2020,164,119,283,4,2,2020
14,2/20/2020,184,281,465,4,2,2020
15,2/20/2020,154,276,430,4,2,2020
16,2/20/2020,150,117,267,4,2,2020
17,2/20/2020,194,135,329,4,2,2020
18,2/20/2020,108,178,286,4,2,2020
19,2/20/2020,41,389,430,4,2,2020
20,2/20/2020,139,156,295,4,2,2020
21,2/20/2020,360,181,541,4,2,2020
22,2/20/2020,370,147,517,4,2,2020
23,2/20/2020,268,188,456,4,2,2020
0,2/21/2020,214,148,362,5,2,2020
1,2/21/2020,105,0,105,5,2,2020
2,2/21/2020,83,0,83,5,2,2020
3,2/21/2020,173,0,173,5,2,2020
4,2/21/2020,178,0,178,5,2,2020
5,2/21/2020,254,0,254,5,2,2020
6,2/21/2020,406,76,482,5,2,2020
7,2/21/2020,350,218,568,5,2,2020
8,2/21/2020,226,372,598,5,2,2020
9,2/21/2020,190,158,348,5,2,2020
10,2/21/2020,187,241,428,5,2,2020
11,2/21/2020,235,200,435,5,2,2020
12,2/21/2020,105,211,316,5,2,2020
13,2/21/2020,210,96,306,5,2,2020
14,2/21/2020,152,102,254,5,2,2020
15,2/21/2020,107,307,414,5,2,2020
16,2/21/2020,120,238,358,5,2,2020
17,2/21/2020,166,295,461,5,2,2020
18,2/21/2020,89,127,216,5,2,2020
19,2/21/2020,64,333,397,5,2,2020
20,2/21/2020,128,37,165,5,2,2020
21,2/21/2020,380,249,629,5,2,2020
22,2/21/2020,352,172,524,5,2,2020
23,2/21/2020,194,215,409,5,2,2020
0,2/22/2020,180,334,514,6,2,2020
1,2/22/2020,61,73,134,6,2,2020
2,2/22/2020,57,0,57,6,2,2020
3,2/22/2020,96,0,96,6,2,2020
4,2/22/2020,125,0,125,6,2,2020
5,2/22/2020,195,0,195,6,2,2020
6,2/22/2020,423,1,424,6,2,2020
7,2/22/2020,404,297,701,6,2,2020
8,2/22/2020,269,524,793,6,2,2020
9,2/22/2020,228,384,612,6,2,2020
10,2/22/2020,156,225,381,6,2,2020
11,2/22/2020,122,212,334,6,2,2020
12,2/22/2020,109,279,388,6,2,2020
13,2/22/2020,138,135,273,6,2,2020
14,2/22/2020,178,438,616,6,2,2020
15,2/22/2020,162,348,510,6,2,2020
16,2/22/2020,107,249,356,6,2,2020
17,2/22/2020,70,359,429,6,2,2020
18,2/22/2020,56,177,233,6,2,2020
19,2/22/2020,63,363,426,6,2,2020
20,2/22/2020,100,369,469,6,2,2020
21,2/22/2020,157,109,266,6,2,2020
22,2/22/2020,174,336,510,6,2,2020
23,2/22/2020,118,318,436,6,2,2020
0,2/23/2020,66,162,228,7,2,2020
1,2/23/2020,27,4,31,7,2,2020
2,2/23/2020,35,0,35,7,2,2020
3,2/23/2020,97,0,97,7,2,2020
4,2/23/2020,105,0,105,7,2,2020
5,2/23/2020,163,1,164,7,2,2020
6,2/23/2020,280,79,359,7,2,2020
7,2/23/2020,251,231,482,7,2,2020
8,2/23/2020,98,575,673,7,2,2020
9,2/23/2020,113,263,376,7,2,2020
10,2/23/2020,137,186,323,7,2,2020
11,2/23/2020,139,185,324,7,2,2020
12,2/23/2020,102,310,412,7,2,2020
13,2/23/2020,177,238,415,7,2,2020
14,2/23/2020,227,131,358,7,2,2020
15,2/23/2020,143,387,530,7,2,2020
16,2/23/2020,217,360,577,7,2,2020
17,2/23/2020,169,250,419,7,2,2020
18,2/23/2020,52,379,431,7,2,2020
19,2/23/2020,32,493,525,7,2,2020
20,2/23/2020,103,165,268,7,2,2020
21,2/23/2020,160,216,376,7,2,2020
22,2/23/2020,198,110,308,7,2,2020
23,2/23/2020,87,485,572,7,2,2020
0,2/24/2020,60,431,491,1,2,2020
1,2/24/2020,14,183,197,1,2,2020
2,2/24/2020,12,32,44,1,2,2020
3,2/24/2020,26,1,27,1,2,2020
4,2/24/2020,62,0,62,1,2,2020
5,2/24/2020,92,0,92,1,2,2020
6,2/24/2020,223,63,286,1,2,2020
7,2/24/2020,189,405,594,1,2,2020
8,2/24/2020,91,405,496,1,2,2020
9,2/24/2020,131,187,318,1,2,2020
10,2/24/2020,83,318,401,1,2,2020
11,2/24/2020,121,204,325,1,2,2020
12,2/24/2020,109,157,266,1,2,2020
13,2/24/2020,73,159,232,1,2,2020
14,2/24/2020,169,223,392,1,2,2020
15,2/24/2020,123,351,474,1,2,2020
16,2/24/2020,95,258,353,1,2,2020
17,2/24/2020,112,205,317,1,2,2020
18,2/24/2020,42,266,308,1,2,2020
19,2/24/2020,39,521,560,1,2,2020
20,2/24/2020,79,99,178,1,2,2020
21,2/24/2020,104,165,269,1,2,2020
22,2/24/2020,112,122,234,1,2,2020
23,2/24/2020,72,386,458,1,2,2020
0,2/25/2020,36,339,375,2,2,2020
1,2/25/2020,24,53,77,2,2,2020
2,2/25/2020,42,5,47,2,2,2020
3,2/25/2020,59,0,59,2,2,2020
4,2/25/2020,34,0,34,2,2,2020
5,2/25/2020,78,0,78,2,2,2020
6,2/25/2020,234,60,294,2,2,2020
7,2/25/2020,241,329,570,2,2,2020
8,2/25/2020,173,285,458,2,2,2020
9,2/25/2020,75,275,350,2,2,2020
10,2/25/2020,83,116,199,2,2,2020
11,2/25/2020,84,140,224,2,2,2020
12,2/25/2020,84,228,312,2,2,2020
13,2/25/2020,112,118,230,2,2,2020
14,2/25/2020,114,253,367,2,2,2020
15,2/25/2020,80,211,291,2,2,2020
16,2/25/2020,83,175,258,2,2,2020
17,2/25/2020,59,161,220,2,2,2020
18,2/25/2020,42,186,228,2,2,2020
19,2/25/2020,24,238,262,2,2,2020
20,2/25/2020,99,133,232,2,2,2020
21,2/25/2020,265,156,421,2,2,2020
22,2/25/2020,235,256,491,2,2,2020
23,2/25/2020,141,123,264,2,2,2020
0,2/26/2020,71,289,360,3,2,2020
1,2/26/2020,11,40,51,3,2,2020
2,2/26/2020,31,0,31,3,2,2020
3,2/26/2020,24,0,24,3,2,2020
4,2/26/2020,53,0,53,3,2,2020
5,2/26/2020,122,1,123,3,2,2020
6,2/26/2020,266,0,266,3,2,2020
7,2/26/2020,170,181,351,3,2,2020
8,2/26/2020,125,327,452,3,2,2020
9,2/26/2020,155,276,431,3,2,2020
10,2/26/2020,157,239,396,3,2,2020
11,2/26/2020,167,259,426,3,2,2020
12,2/26/2020,127,123,250,3,2,2020
13,2/26/2020,128,279,407,3,2,2020
14,2/26/2020,112,62,174,3,2,2020
15,2/26/2020,66,231,297,3,2,2020
16,2/26/2020,68,294,362,3,2,2020
17,2/26/2020,73,241,314,3,2,2020
18,2/26/2020,29,112,141,3,2,2020
19,2/26/2020,27,399,426,3,2,2020
20,2/26/2020,118,149,267,3,2,2020
21,2/26/2020,247,121,368,3,2,2020
22,2/26/2020,220,209,429,3,2,2020
23,2/26/2020,173,225,398,3,2,2020
0,2/27/2020,108,255,363,4,2,2020
1,2/27/2020,54,0,54,4,2,2020
2,2/27/2020,46,54,100,4,2,2020
3,2/27/2020,96,3,99,4,2,2020
4,2/27/2020,251,0,251,4,2,2020
5,2/27/2020,267,0,267,4,2,2020
6,2/27/2020,354,61,415,4,2,2020
7,2/27/2020,242,198,440,4,2,2020
8,2/27/2020,170,437,607,4,2,2020
9,2/27/2020,179,284,463,4,2,2020
10,2/27/2020,263,157,420,4,2,2020
11,2/27/2020,190,275,465,4,2,2020
12,2/27/2020,94,58,152,4,2,2020
13,2/27/2020,147,253,400,4,2,2020
14,2/27/2020,161,177,338,4,2,2020
15,2/27/2020,124,191,315,4,2,2020
16,2/27/2020,150,127,277,4,2,2020
17,2/27/2020,116,185,301,4,2,2020
18,2/27/2020,86,102,188,4,2,2020
19,2/27/2020,43,285,328,4,2,2020
20,2/27/2020,130,216,346,4,2,2020
21,2/27/2020,283,182,465,4,2,2020
22,2/27/2020,315,70,385,4,2,2020
23,2/27/2020,262,262,524,4,2,2020
0,2/28/2020,121,167,288,5,2,2020
1,2/28/2020,71,63,134,5,2,2020
2,2/28/2020,72,0,72,5,2,2020
3,2/28/2020,129,0,129,5,2,2020
4,2/28/2020,147,0,147,5,2,2020
5,2/28/2020,199,0,199,5,2,2020
6,2/28/2020,378,87,465,5,2,2020
7,2/28/2020,305,241,546,5,2,2020
8,2/28/2020,229,262,491,5,2,2020
9,2/28/2020,227,306,533,5,2,2020
10,2/28/2020,161,191,352,5,2,2020
11,2/28/2020,173,275,448,5,2,2020
12,2/28/2020,123,167,290,5,2,2020
13,2/28/2020,113,223,336,5,2,2020
14,2/28/2020,157,133,290,5,2,2020
15,2/28/2020,89,209,298,5,2,2020
16,2/28/2020,87,160,247,5,2,2020
17,2/28/2020,96,111,207,5,2,2020
18,2/28/2020,92,182,274,5,2,2020
19,2/28/2020,50,360,410,5,2,2020
20,2/28/2020,140,65,205,5,2,2020
21,2/28/2020,324,178,502,5,2,2020
22,2/28/2020,254,209,463,5,2,2020
23,2/28/2020,180,231,411,5,2,2020
0,2/29/2020,157,107,264,6,2,2020
1,2/29/2020,25,10,35,6,2,2020
2,2/29/2020,62,0,62,6,2,2020
3,2/29/2020,87,0,87,6,2,2020
4,2/29/2020,76,0,76,6,2,2020
5,2/29/2020,161,0,161,6,2,2020
6,2/29/2020,342,0,342,6,2,2020
7,2/29/2020,423,185,608,6,2,2020
8,2/29/2020,286,526,812,6,2,2020
9,2/29/2020,211,270,481,6,2,2020
10,2/29/2020,143,261,404,6,2,2020
11,2/29/2020,94,223,317,6,2,2020
12,2/29/2020,92,151,243,6,2,2020
13,2/29/2020,134,221,355,6,2,2020
14,2/29/2020,175,265,440,6,2,2020
15,2/29/2020,117,320,437,6,2,2020
16,2/29/2020,105,109,214,6,2,2020
17,2/29/2020,69,252,321,6,2,2020
18,2/29/2020,44,273,317,6,2,2020
19,2/29/2020,33,319,352,6,2,2020
20,2/29/2020,100,278,378,6,2,2020
21,2/29/2020,202,220,422,6,2,2020
22,2/29/2020,148,137,285,6,2,2020
23,2/29/2020,128,369,497,6,2,2020
0,3/1/2020,112,224,336,7,3,2020
1,3/1/2020,33,37,70,7,3,2020
2,3/1/2020,47,7,54,7,3,2020
3,3/1/2020,105,0,105,7,3,2020
4,3/1/2020,76,0,76,7,3,2020
5,3/1/2020,143,0,143,7,3,2020
6,3/1/2020,275,74,349,7,3,2020
7,3/1/2020,232,216,448,7,3,2020
8,3/1/2020,98,576,674,7,3,2020
9,3/1/2020,91,295,386,7,3,2020
10,3/1/2020,179,196,375,7,3,2020
11,3/1/2020,168,217,385,7,3,2020
12,3/1/2020,126,349,475,7,3,2020
13,3/1/2020,181,272,453,7,3,2020
14,3/1/2020,205,67,272,7,3,2020
15,3/1/2020,158,261,419,7,3,2020
16,3/1/2020,159,490,649,7,3,2020
17,3/1/2020,139,193,332,7,3,2020
18,3/1/2020,43,241,284,7,3,2020
19,3/1/2020,43,546,589,7,3,2020
20,3/1/2020,60,119,179,7,3,2020
21,3/1/2020,153,198,351,7,3,2020
22,3/1/2020,198,241,439,7,3,2020
23,3/1/2020,125,470,595,7,3,2020
0,3/2/2020,65,309,374,1,3,2020
1,3/2/2020,22,49,71,1,3,2020
2,3/2/2020,22,0,22,1,3,2020
3,3/2/2020,43,38,81,1,3,2020
4,3/2/2020,66,0,66,1,3,2020
5,3/2/2020,117,0,117,1,3,2020
6,3/2/2020,227,76,303,1,3,2020
7,3/2/2020,202,316,518,1,3,2020
8,3/2/2020,109,511,620,1,3,2020
9,3/2/2020,104,119,223,1,3,2020
10,3/2/2020,72,273,345,1,3,2020
11,3/2/2020,82,202,284,1,3,2020
12,3/2/2020,88,212,300,1,3,2020
13,3/2/2020,92,90,182,1,3,2020
14,3/2/2020,191,51,242,1,3,2020
15,3/2/2020,141,499,640,1,3,2020
16,3/2/2020,78,342,420,1,3,2020
17,3/2/2020,76,191,267,1,3,2020
18,3/2/2020,28,278,306,1,3,2020
19,3/2/2020,15,450,465,1,3,2020
20,3/2/2020,56,106,162,1,3,2020
21,3/2/2020,113,134,247,1,3,2020
22,3/2/2020,96,173,269,1,3,2020
23,3/2/2020,69,269,338,1,3,2020
0,3/3/2020,23,314,337,2,3,2020
1,3/3/2020,19,27,46,2,3,2020
2,3/3/2020,26,0,26,2,3,2020
3,3/3/2020,47,0,47,2,3,2020
4,3/3/2020,48,0,48,2,3,2020
5,3/3/2020,95,0,95,2,3,2020
6,3/3/2020,187,69,256,2,3,2020
7,3/3/2020,176,310,486,2,3,2020
8,3/3/2020,151,200,351,2,3,2020
9,3/3/2020,97,170,267,2,3,2020
10,3/3/2020,71,147,218,2,3,2020
11,3/3/2020,58,203,261,2,3,2020
12,3/3/2020,104,116,220,2,3,2020
13,3/3/2020,114,129,243,2,3,2020
14,3/3/2020,83,162,245,2,3,2020
15,3/3/2020,94,284,378,2,3,2020
16,3/3/2020,58,220,278,2,3,2020
17,3/3/2020,48,150,198,2,3,2020
18,3/3/2020,24,106,130,2,3,2020
19,3/3/2020,24,220,244,2,3,2020
20,3/3/2020,81,36,117,2,3,2020
21,3/3/2020,205,158,363,2,3,2020
22,3/3/2020,197,276,473,2,3,2020
23,3/3/2020,126,244,370,2,3,2020
0,3/4/2020,60,105,165,3,3,2020
1,3/4/2020,23,24,47,3,3,2020
2,3/4/2020,36,20,56,3,3,2020
3,3/4/2020,63,64,127,3,3,2020
4,3/4/2020,36,2,38,3,3,2020
5,3/4/2020,92,0,92,3,3,2020
6,3/4/2020,249,0,249,3,3,2020
7,3/4/2020,192,201,393,3,3,2020
8,3/4/2020,136,292,428,3,3,2020
9,3/4/2020,122,144,266,3,3,2020
10,3/4/2020,123,259,382,3,3,2020
11,3/4/2020,139,145,284,3,3,2020
12,3/4/2020,105,198,303,3,3,2020
13,3/4/2020,112,56,168,3,3,2020
14,3/4/2020,134,89,223,3,3,2020
15,3/4/2020,84,299,383,3,3,2020
16,3/4/2020,59,202,261,3,3,2020
17,3/4/2020,72,192,264,3,3,2020
18,3/4/2020,30,152,182,3,3,2020
19,3/4/2020,33,273,306,3,3,2020
20,3/4/2020,96,70,166,3,3,2020
21,3/4/2020,206,145,351,3,3,2020
22,3/4/2020,194,168,362,3,3,2020
23,3/4/2020,185,198,383,3,3,2020
0,3/5/2020,106,10,116,4,3,2020
1,3/5/2020,32,2,34,4,3,2020
2,3/5/2020,60,8,68,4,3,2020
3,3/5/2020,101,11,112,4,3,2020
4,3/5/2020,247,0,247,4,3,2020
5,3/5/2020,234,0,234,4,3,2020
6,3/5/2020,343,0,343,4,3,2020
7,3/5/2020,347,0,347,4,3,2020
8,3/5/2020,211,231,442,4,3,2020
9,3/5/2020,116,341,457,4,3,2020
10,3/5/2020,160,363,523,4,3,2020
11,3/5/2020,178,194,372,4,3,2020
12,3/5/2020,104,167,271,4,3,2020
13,3/5/2020,111,189,300,4,3,2020
14,3/5/2020,103,148,251,4,3,2020
15,3/5/2020,170,114,284,4,3,2020
16,3/5/2020,121,38,159,4,3,2020
17,3/5/2020,123,249,372,4,3,2020
18,3/5/2020,84,252,336,4,3,2020
19,3/5/2020,27,248,275,4,3,2020
20,3/5/2020,130,107,237,4,3,2020
21,3/5/2020,310,100,410,4,3,2020
22,3/5/2020,314,102,416,4,3,2020
23,3/5/2020,231,152,383,4,3,2020
0,3/6/2020,178,184,362,5,3,2020
1,3/6/2020,104,28,132,5,3,2020
2,3/6/2020,47,0,47,5,3,2020
3,3/6/2020,106,0,106,5,3,2020
4,3/6/2020,140,6,146,5,3,2020
5,3/6/2020,191,12,203,5,3,2020
6,3/6/2020,338,19,357,5,3,2020
7,3/6/2020,255,3,258,5,3,2020
8,3/6/2020,205,126,331,5,3,2020
9,3/6/2020,161,206,367,5,3,2020
10,3/6/2020,118,142,260,5,3,2020
11,3/6/2020,188,78,266,5,3,2020
12,3/6/2020,138,60,198,5,3,2020
13,3/6/2020,141,34,175,5,3,2020
14,3/6/2020,128,368,496,5,3,2020
15,3/6/2020,87,160,247,5,3,2020
16,3/6/2020,113,285,398,5,3,2020
17,3/6/2020,112,146,258,5,3,2020
18,3/6/2020,60,154,214,5,3,2020
19,3/6/2020,45,305,350,5,3,2020
20,3/6/2020,147,55,202,5,3,2020
21,3/6/2020,284,100,384,5,3,2020
22,3/6/2020,285,277,562,5,3,2020
23,3/6/2020,229,282,511,5,3,2020
0,3/7/2020,129,153,282,6,3,2020
1,3/7/2020,47,64,111,6,3,2020
2,3/7/2020,31,111,142,6,3,2020
3,3/7/2020,77,0,77,6,3,2020
4,3/7/2020,90,0,90,6,3,2020
5,3/7/2020,153,0,153,6,3,2020
6,3/7/2020,358,3,361,6,3,2020
7,3/7/2020,365,234,599,6,3,2020
8,3/7/2020,162,408,570,6,3,2020
9,3/7/2020,138,229,367,6,3,2020
10,3/7/2020,114,218,332,6,3,2020
11,3/7/2020,106,204,310,6,3,2020
12,3/7/2020,78,168,246,6,3,2020
13,3/7/2020,91,121,212,6,3,2020
14,3/7/2020,134,245,379,6,3,2020
15,3/7/2020,110,241,351,6,3,2020
16,3/7/2020,88,255,343,6,3,2020
17,3/7/2020,76,270,346,6,3,2020
18,3/7/2020,41,108,149,6,3,2020
19,3/7/2020,53,428,481,6,3,2020
20,3/7/2020,135,159,294,6,3,2020
21,3/7/2020,172,37,209,6,3,2020
22,3/7/2020,161,262,423,6,3,2020
23,3/7/2020,74,209,283,6,3,2020
0,3/8/2020,12,97,109,7,3,2020
1,3/8/2020,33,0,33,7,3,2020
2,3/8/2020,0,0,0,7,3,2020
3,3/8/2020,130,0,130,7,3,2020
4,3/8/2020,88,0,88,7,3,2020
5,3/8/2020,132,0,132,7,3,2020
6,3/8/2020,220,0,220,7,3,2020
7,3/8/2020,243,74,317,7,3,2020
8,3/8/2020,224,328,552,7,3,2020
9,3/8/2020,66,296,362,7,3,2020
10,3/8/2020,120,247,367,7,3,2020
11,3/8/2020,193,108,301,7,3,2020
12,3/8/2020,97,323,420,7,3,2020
13,3/8/2020,94,316,410,7,3,2020
14,3/8/2020,141,38,179,7,3,2020
15,3/8/2020,141,260,401,7,3,2020
16,3/8/2020,143,496,639,7,3,2020
17,3/8/2020,144,186,330,7,3,2020
18,3/8/2020,120,228,348,7,3,2020
19,3/8/2020,30,345,375,7,3,2020
20,3/8/2020,62,354,416,7,3,2020
21,3/8/2020,129,127,256,7,3,2020
22,3/8/2020,168,166,334,7,3,2020
23,3/8/2020,183,299,482,7,3,2020
0,3/9/2020,58,334,392,1,3,2020
1,3/9/2020,51,110,161,1,3,2020
2,3/9/2020,25,45,70,1,3,2020
3,3/9/2020,39,29,68,1,3,2020
4,3/9/2020,43,0,43,1,3,2020
5,3/9/2020,77,0,77,1,3,2020
6,3/9/2020,219,0,219,1,3,2020
7,3/9/2020,220,124,344,1,3,2020
8,3/9/2020,179,404,583,1,3,2020
9,3/9/2020,108,384,492,1,3,2020
10,3/9/2020,121,172,293,1,3,2020
11,3/9/2020,130,196,326,1,3,2020
12,3/9/2020,105,196,301,1,3,2020
13,3/9/2020,92,171,263,1,3,2020
14,3/9/2020,201,103,304,1,3,2020
15,3/9/2020,116,263,379,1,3,2020
16,3/9/2020,119,311,430,1,3,2020
17,3/9/2020,75,145,220,1,3,2020
18,3/9/2020,119,187,306,1,3,2020
19,3/9/2020,59,261,320,1,3,2020
20,3/9/2020,42,343,385,1,3,2020
21,3/9/2020,103,113,216,1,3,2020
22,3/9/2020,119,293,412,1,3,2020
23,3/9/2020,102,134,236,1,3,2020
0,3/10/2020,41,237,278,2,3,2020
1,3/10/2020,23,118,141,2,3,2020
2,3/10/2020,25,34,59,2,3,2020
3,3/10/2020,61,8,69,2,3,2020
4,3/10/2020,37,0,37,2,3,2020
5,3/10/2020,97,3,100,2,3,2020
6,3/10/2020,202,0,202,2,3,2020
7,3/10/2020,231,175,406,2,3,2020
8,3/10/2020,194,233,427,2,3,2020
9,3/10/2020,91,212,303,2,3,2020
10,3/10/2020,62,223,285,2,3,2020
11,3/10/2020,103,85,188,2,3,2020
12,3/10/2020,92,134,226,2,3,2020
13,3/10/2020,85,283,368,2,3,2020
14,3/10/2020,113,151,264,2,3,2020
15,3/10/2020,102,211,313,2,3,2020
16,3/10/2020,70,306,376,2,3,2020
17,3/10/2020,53,144,197,2,3,2020
18,3/10/2020,52,61,113,2,3,2020
19,3/10/2020,32,147,179,2,3,2020
20,3/10/2020,52,161,213,2,3,2020
21,3/10/2020,172,153,325,2,3,2020
22,3/10/2020,194,131,325,2,3,2020
23,3/10/2020,180,221,401,2,3,2020
0,3/11/2020,134,143,277,3,3,2020
1,3/11/2020,38,80,118,3,3,2020
2,3/11/2020,19,11,30,3,3,2020
3,3/11/2020,84,0,84,3,3,2020
4,3/11/2020,62,18,80,3,3,2020
5,3/11/2020,89,2,91,3,3,2020
6,3/11/2020,214,0,214,3,3,2020
7,3/11/2020,217,108,325,3,3,2020
8,3/11/2020,199,232,431,3,3,2020
9,3/11/2020,112,357,469,3,3,2020
10,3/11/2020,91,183,274,3,3,2020
11,3/11/2020,158,194,352,3,3,2020
12,3/11/2020,95,133,228,3,3,2020
13,3/11/2020,129,315,444,3,3,2020
14,3/11/2020,112,23,135,3,3,2020
15,3/11/2020,105,326,431,3,3,2020
16,3/11/2020,69,138,207,3,3,2020
17,3/11/2020,106,94,200,3,3,2020
18,3/11/2020,139,155,294,3,3,2020
19,3/11/2020,42,301,343,3,3,2020
20,3/11/2020,93,145,238,3,3,2020
21,3/11/2020,179,168,347,3,3,2020
22,3/11/2020,266,144,410,3,3,2020
23,3/11/2020,203,240,443,3,3,2020
0,3/12/2020,116,139,255,4,3,2020
1,3/12/2020,37,13,50,4,3,2020
2,3/12/2020,61,0,61,4,3,2020
3,3/12/2020,86,0,86,4,3,2020
4,3/12/2020,153,0,153,4,3,2020
5,3/12/2020,218,0,218,4,3,2020
6,3/12/2020,339,0,339,4,3,2020
7,3/12/2020,304,188,492,4,3,2020
8,3/12/2020,254,222,476,4,3,2020
9,3/12/2020,131,242,373,4,3,2020
10,3/12/2020,124,5,129,4,3,2020
11,3/12/2020,190,175,365,4,3,2020
12,3/12/2020,118,187,305,4,3,2020
13,3/12/2020,114,418,532,4,3,2020
14,3/12/2020,133,238,371,4,3,2020
15,3/12/2020,75,116,191,4,3,2020
16,3/12/2020,96,116,212,4,3,2020
17,3/12/2020,204,133,337,4,3,2020
18,3/12/2020,68,230,298,4,3,2020
19,3/12/2020,76,248,324,4,3,2020
20,3/12/2020,100,191,291,4,3,2020
21,3/12/2020,285,174,459,4,3,2020
22,3/12/2020,302,238,540,4,3,2020
23,3/12/2020,245,163,408,4,3,2020
0,3/13/2020,161,254,415,5,3,2020
1,3/13/2020,75,102,177,5,3,2020
2,3/13/2020,84,46,130,5,3,2020
3,3/13/2020,136,0,136,5,3,2020
4,3/13/2020,141,0,141,5,3,2020
5,3/13/2020,145,3,148,5,3,2020
6,3/13/2020,282,1,283,5,3,2020
7,3/13/2020,238,167,405,5,3,2020
8,3/13/2020,255,187,442,5,3,2020
9,3/13/2020,128,366,494,5,3,2020
10,3/13/2020,100,186,286,5,3,2020
11,3/13/2020,204,154,358,5,3,2020
12,3/13/2020,165,87,252,5,3,2020
13,3/13/2020,158,201,359,5,3,2020
14,3/13/2020,140,81,221,5,3,2020
15,3/13/2020,64,375,439,5,3,2020
16,3/13/2020,78,161,239,5,3,2020
17,3/13/2020,126,120,246,5,3,2020
18,3/13/2020,98,111,209,5,3,2020
19,3/13/2020,46,294,340,5,3,2020
20,3/13/2020,104,143,247,5,3,2020
21,3/13/2020,241,161,402,5,3,2020
22,3/13/2020,322,124,446,5,3,2020
23,3/13/2020,211,312,523,5,3,2020
0,3/14/2020,162,135,297,6,3,2020
1,3/14/2020,56,86,142,6,3,2020
2,3/14/2020,73,23,96,6,3,2020
3,3/14/2020,74,1,75,6,3,2020
4,3/14/2020,44,0,44,6,3,2020
5,3/14/2020,112,0,112,6,3,2020
6,3/14/2020,276,0,276,6,3,2020
7,3/14/2020,308,157,465,6,3,2020
8,3/14/2020,311,241,552,6,3,2020
9,3/14/2020,123,442,565,6,3,2020
10,3/14/2020,155,161,316,6,3,2020
11,3/14/2020,182,105,287,6,3,2020
12,3/14/2020,103,140,243,6,3,2020
13,3/14/2020,90,274,364,6,3,2020
14,3/14/2020,137,89,226,6,3,2020
15,3/14/2020,105,379,484,6,3,2020
16,3/14/2020,81,134,215,6,3,2020
17,3/14/2020,101,70,171,6,3,2020
18,3/14/2020,68,153,221,6,3,2020
19,3/14/2020,96,274,370,6,3,2020
20,3/14/2020,130,170,300,6,3,2020
21,3/14/2020,263,159,422,6,3,2020
22,3/14/2020,246,128,374,6,3,2020
23,3/14/2020,151,199,350,6,3,2020
0,3/15/2020,70,210,280,7,3,2020
1,3/15/2020,49,48,97,7,3,2020
2,3/15/2020,59,2,61,7,3,2020
3,3/15/2020,86,0,86,7,3,2020
4,3/15/2020,100,0,100,7,3,2020
5,3/15/2020,148,0,148,7,3,2020
6,3/15/2020,289,0,289,7,3,2020
7,3/15/2020,273,295,568,7,3,2020
8,3/15/2020,222,281,503,7,3,2020
9,3/15/2020,78,333,411,7,3,2020
10,3/15/2020,152,128,280,7,3,2020
11,3/15/2020,211,81,292,7,3,2020
12,3/15/2020,168,61,229,7,3,2020
13,3/15/2020,172,259,431,7,3,2020
14,3/15/2020,180,266,446,7,3,2020
15,3/15/2020,139,167,306,7,3,2020
16,3/15/2020,107,334,441,7,3,2020
17,3/15/2020,176,179,355,7,3,2020
18,3/15/2020,98,207,305,7,3,2020
19,3/15/2020,83,391,474,7,3,2020
20,3/15/2020,85,125,210,7,3,2020
21,3/15/2020,159,163,322,7,3,2020
22,3/15/2020,208,236,444,7,3,2020
23,3/15/2020,151,322,473,7,3,2020
0,3/16/2020,121,330,451,1,3,2020
1,3/16/2020,48,60,108,1,3,2020
2,3/16/2020,26,73,99,1,3,2020
3,3/16/2020,41,18,59,1,3,2020
4,3/16/2020,50,0,50,1,3,2020
5,3/16/2020,86,0,86,1,3,2020
6,3/16/2020,252,0,252,1,3,2020
7,3/16/2020,319,117,436,1,3,2020
8,3/16/2020,245,281,526,1,3,2020
9,3/16/2020,142,333,475,1,3,2020
10,3/16/2020,107,121,228,1,3,2020
11,3/16/2020,164,69,233,1,3,2020
12,3/16/2020,96,177,273,1,3,2020
13,3/16/2020,106,59,165,1,3,2020
14,3/16/2020,215,152,367,1,3,2020
15,3/16/2020,198,273,471,1,3,2020
16,3/16/2020,110,22,132,1,3,2020
17,3/16/2020,139,103,242,1,3,2020
18,3/16/2020,158,88,246,1,3,2020
19,3/16/2020,62,234,296,1,3,2020
20,3/16/2020,60,191,251,1,3,2020
21,3/16/2020,143,59,202,1,3,2020
22,3/16/2020,215,185,400,1,3,2020
23,3/16/2020,106,100,206,1,3,2020
0,3/17/2020,78,116,194,2,3,2020
1,3/17/2020,18,89,107,2,3,2020
2,3/17/2020,54,86,140,2,3,2020
3,3/17/2020,63,1,64,2,3,2020
4,3/17/2020,95,0,95,2,3,2020
5,3/17/2020,81,14,95,2,3,2020
6,3/17/2020,248,0,248,2,3,2020
7,3/17/2020,307,54,361,2,3,2020
8,3/17/2020,204,121,325,2,3,2020
9,3/17/2020,92,171,263,2,3,2020
10,3/17/2020,109,69,178,2,3,2020
11,3/17/2020,123,161,284,2,3,2020
12,3/17/2020,92,157,249,2,3,2020
13,3/17/2020,136,131,267,2,3,2020
14,3/17/2020,164,32,196,2,3,2020
15,3/17/2020,112,262,374,2,3,2020
16,3/17/2020,99,77,176,2,3,2020
17,3/17/2020,97,188,285,2,3,2020
18,3/17/2020,31,101,132,2,3,2020
19,3/17/2020,42,121,163,2,3,2020
20,3/17/2020,140,36,176,2,3,2020
21,3/17/2020,181,29,210,2,3,2020
22,3/17/2020,233,99,332,2,3,2020
23,3/17/2020,223,297,520,2,3,2020
0,3/18/2020,96,127,223,3,3,2020
1,3/18/2020,24,125,149,3,3,2020
2,3/18/2020,18,13,31,3,3,2020
3,3/18/2020,57,0,57,3,3,2020
4,3/18/2020,34,0,34,3,3,2020
5,3/18/2020,81,0,81,3,3,2020
6,3/18/2020,188,0,188,3,3,2020
7,3/18/2020,201,94,295,3,3,2020
8,3/18/2020,180,165,345,3,3,2020
9,3/18/2020,100,198,298,3,3,2020
10,3/18/2020,148,156,304,3,3,2020
11,3/18/2020,128,95,223,3,3,2020
12,3/18/2020,117,103,220,3,3,2020
13,3/18/2020,73,218,291,3,3,2020
14,3/18/2020,90,38,128,3,3,2020
15,3/18/2020,66,175,241,3,3,2020
16,3/18/2020,75,95,170,3,3,2020
17,3/18/2020,86,124,210,3,3,2020
18,3/18/2020,57,48,105,3,3,2020
19,3/18/2020,59,139,198,3,3,2020
20,3/18/2020,67,236,303,3,3,2020
21,3/18/2020,156,84,240,3,3,2020
22,3/18/2020,120,94,214,3,3,2020
23,3/18/2020,81,120,201,3,3,2020
0,3/19/2020,44,123,167,4,3,2020
1,3/19/2020,22,44,66,4,3,2020
2,3/19/2020,21,0,21,4,3,2020
3,3/19/2020,72,0,72,4,3,2020
4,3/19/2020,79,0,79,4,3,2020
5,3/19/2020,51,0,51,4,3,2020
6,3/19/2020,158,0,158,4,3,2020
7,3/19/2020,187,77,264,4,3,2020
8,3/19/2020,119,119,238,4,3,2020
9,3/19/2020,76,132,208,4,3,2020
10,3/19/2020,75,79,154,4,3,2020
11,3/19/2020,51,75,126,4,3,2020
12,3/19/2020,70,75,145,4,3,2020
13,3/19/2020,90,81,171,4,3,2020
14,3/19/2020,78,70,148,4,3,2020
15,3/19/2020,54,185,239,4,3,2020
16,3/19/2020,52,100,152,4,3,2020
17,3/19/2020,65,57,122,4,3,2020
18,3/19/2020,46,96,142,4,3,2020
19,3/19/2020,40,165,205,4,3,2020
20,3/19/2020,69,94,163,4,3,2020
21,3/19/2020,114,36,150,4,3,2020
22,3/19/2020,158,171,329,4,3,2020
23,3/19/2020,114,119,233,4,3,2020
0,3/20/2020,68,115,183,5,3,2020
1,3/20/2020,53,21,74,5,3,2020
2,3/20/2020,26,0,26,5,3,2020
3,3/20/2020,61,0,61,5,3,2020
4,3/20/2020,37,0,37,5,3,2020
5,3/20/2020,57,4,61,5,3,2020
6,3/20/2020,144,0,144,5,3,2020
7,3/20/2020,122,116,238,5,3,2020
8,3/20/2020,72,145,217,5,3,2020
9,3/20/2020,67,190,257,5,3,2020
10,3/20/2020,54,165,219,5,3,2020
11,3/20/2020,80,108,188,5,3,2020
12,3/20/2020,71,33,104,5,3,2020
13,3/20/2020,102,125,227,5,3,2020
14,3/20/2020,89,88,177,5,3,2020
15,3/20/2020,72,174,246,5,3,2020
16,3/20/2020,57,165,222,5,3,2020
17,3/20/2020,62,105,167,5,3,2020
18,3/20/2020,78,64,142,5,3,2020
19,3/20/2020,51,308,359,5,3,2020
20,3/20/2020,124,179,303,5,3,2020
21,3/20/2020,224,153,377,5,3,2020
22,3/20/2020,165,159,324,5,3,2020
23,3/20/2020,109,318,427,5,3,2020
0,3/21/2020,28,215,243,6,3,2020
1,3/21/2020,15,49,64,6,3,2020
2,3/21/2020,11,0,11,6,3,2020
3,3/21/2020,15,0,15,6,3,2020
4,3/21/2020,17,0,17,6,3,2020
5,3/21/2020,35,0,35,6,3,2020
6,3/21/2020,100,0,100,6,3,2020
7,3/21/2020,111,193,304,6,3,2020
8,3/21/2020,75,231,306,6,3,2020
9,3/21/2020,59,321,380,6,3,2020
10,3/21/2020,52,44,96,6,3,2020
11,3/21/2020,57,167,224,6,3,2020
12,3/21/2020,53,183,236,6,3,2020
13,3/21/2020,89,247,336,6,3,2020
14,3/21/2020,76,86,162,6,3,2020
15,3/21/2020,33,187,220,6,3,2020
16,3/21/2020,35,298,333,6,3,2020
17,3/21/2020,27,87,114,6,3,2020
18,3/21/2020,25,57,82,6,3,2020
19,3/21/2020,31,287,318,6,3,2020
20,3/21/2020,81,300,381,6,3,2020
21,3/21/2020,74,83,157,6,3,2020
22,3/21/2020,72,147,219,6,3,2020
23,3/21/2020,26,266,292,6,3,2020
0,3/22/2020,19,150,169,7,3,2020
1,3/22/2020,11,27,38,7,3,2020
2,3/22/2020,20,0,20,7,3,2020
3,3/22/2020,27,0,27,7,3,2020
4,3/22/2020,28,0,28,7,3,2020
5,3/22/2020,58,0,58,7,3,2020
6,3/22/2020,105,0,105,7,3,2020
7,3/22/2020,115,184,299,7,3,2020
8,3/22/2020,49,311,360,7,3,2020
9,3/22/2020,43,345,388,7,3,2020
10,3/22/2020,64,134,198,7,3,2020
11,3/22/2020,74,90,164,7,3,2020
12,3/22/2020,46,146,192,7,3,2020
13,3/22/2020,68,197,265,7,3,2020
14,3/22/2020,61,35,96,7,3,2020
15,3/22/2020,39,149,188,7,3,2020
16,3/22/2020,38,109,147,7,3,2020
17,3/22/2020,48,186,234,7,3,2020
18,3/22/2020,19,156,175,7,3,2020
19,3/22/2020,15,192,207,7,3,2020
20,3/22/2020,18,94,112,7,3,2020
21,3/22/2020,38,74,112,7,3,2020
22,3/22/2020,43,128,171,7,3,2020
23,3/22/2020,15,230,245,7,3,2020
0,3/23/2020,24,84,108,1,3,2020
1,3/23/2020,9,24,33,1,3,2020
2,3/23/2020,7,17,24,1,3,2020
3,3/23/2020,10,0,10,1,3,2020
4,3/23/2020,17,0,17,1,3,2020
5,3/23/2020,28,0,28,1,3,2020
6,3/23/2020,36,0,36,1,3,2020
7,3/23/2020,39,54,93,1,3,2020
8,3/23/2020,49,91,140,1,3,2020
9,3/23/2020,36,173,209,1,3,2020
10,3/23/2020,31,76,107,1,3,2020
11,3/23/2020,24,98,122,1,3,2020
12,3/23/2020,27,37,64,1,3,2020
13,3/23/2020,34,94,128,1,3,2020
14,3/23/2020,41,19,60,1,3,2020
15,3/23/2020,37,160,197,1,3,2020
16,3/23/2020,16,83,99,1,3,2020
17,3/23/2020,24,88,112,1,3,2020
18,3/23/2020,14,53,67,1,3,2020
19,3/23/2020,11,186,197,1,3,2020
20,3/23/2020,24,72,96,1,3,2020
21,3/23/2020,20,70,90,1,3,2020
22,3/23/2020,34,76,110,1,3,2020
23,3/23/2020,15,62,77,1,3,2020
0,3/24/2020,6,107,113,2,3,2020
1,3/24/2020,5,24,29,2,3,2020
2,3/24/2020,16,0,16,2,3,2020
3,3/24/2020,26,0,26,2,3,2020
4,3/24/2020,20,0,20,2,3,2020
5,3/24/2020,27,0,27,2,3,2020
6,3/24/2020,62,0,62,2,3,2020
7,3/24/2020,83,24,107,2,3,2020
8,3/24/2020,54,67,121,2,3,2020
9,3/24/2020,22,153,175,2,3,2020
10,3/24/2020,25,50,75,2,3,2020
11,3/24/2020,25,37,62,2,3,2020
12,3/24/2020,15,123,138,2,3,2020
13,3/24/2020,20,41,61,2,3,2020
14,3/24/2020,25,17,42,2,3,2020
15,3/24/2020,20,161,181,2,3,2020
16,3/24/2020,6,85,91,2,3,2020
17,3/24/2020,4,63,67,2,3,2020
18,3/24/2020,12,26,38,2,3,2020
19,3/24/2020,9,57,66,2,3,2020
20,3/24/2020,28,12,40,2,3,2020
21,3/24/2020,30,84,114,2,3,2020
22,3/24/2020,22,68,90,2,3,2020
23,3/24/2020,20,67,87,2,3,2020
0,3/25/2020,6,39,45,3,3,2020
1,3/25/2020,10,5,15,3,3,2020
2,3/25/2020,8,12,20,3,3,2020
3,3/25/2020,12,0,12,3,3,2020
4,3/25/2020,7,0,7,3,3,2020
5,3/25/2020,22,0,22,3,3,2020
6,3/25/2020,35,0,35,3,3,2020
7,3/25/2020,35,14,49,3,3,2020
8,3/25/2020,32,10,42,3,3,2020
9,3/25/2020,26,152,178,3,3,2020
10,3/25/2020,15,6,21,3,3,2020
11,3/25/2020,18,37,55,3,3,2020
12,3/25/2020,7,46,53,3,3,2020
13,3/25/2020,16,33,49,3,3,2020
14,3/25/2020,23,0,23,3,3,2020
15,3/25/2020,4,93,97,3,3,2020
16,3/25/2020,10,15,25,3,3,2020
17,3/25/2020,5,20,25,3,3,2020
18,3/25/2020,11,72,83,3,3,2020
19,3/25/2020,7,109,116,3,3,2020
20,3/25/2020,25,14,39,3,3,2020
21,3/25/2020,30,77,107,3,3,2020
22,3/25/2020,52,24,76,3,3,2020
23,3/25/2020,27,37,64,3,3,2020
0,3/26/2020,2,17,19,4,3,2020
1,3/26/2020,13,0,13,4,3,2020
2,3/26/2020,5,0,5,4,3,2020
3,3/26/2020,6,8,14,4,3,2020
4,3/26/2020,6,4,10,4,3,2020
5,3/26/2020,16,0,16,4,3,2020
6,3/26/2020,52,0,52,4,3,2020
7,3/26/2020,67,73,140,4,3,2020
8,3/26/2020,58,65,123,4,3,2020
9,3/26/2020,25,69,94,4,3,2020
10,3/26/2020,23,13,36,4,3,2020
11,3/26/2020,14,42,56,4,3,2020
12,3/26/2020,5,36,41,4,3,2020
13,3/26/2020,3,48,51,4,3,2020
14,3/26/2020,9,31,40,4,3,2020
15,3/26/2020,11,58,69,4,3,2020
16,3/26/2020,11,35,46,4,3,2020
17,3/26/2020,16,29,45,4,3,2020
18,3/26/2020,11,25,36,4,3,2020
19,3/26/2020,9,69,78,4,3,2020
20,3/26/2020,11,28,39,4,3,2020
21,3/26/2020,27,79,106,4,3,2020
22,3/26/2020,26,8,34,4,3,2020
23,3/26/2020,21,60,81,4,3,2020
0,3/27/2020,9,30,39,5,3,2020
1,3/27/2020,8,9,17,5,3,2020
2,3/27/2020,10,0,10,5,3,2020
3,3/27/2020,26,0,26,5,3,2020
4,3/27/2020,31,0,31,5,3,2020
5,3/27/2020,8,0,8,5,3,2020
6,3/27/2020,62,0,62,5,3,2020
7,3/27/2020,44,10,54,5,3,2020
8,3/27/2020,32,23,55,5,3,2020
9,3/27/2020,18,5,23,5,3,2020
10,3/27/2020,10,49,59,5,3,2020
11,3/27/2020,25,35,60,5,3,2020
12,3/27/2020,26,50,76,5,3,2020
13,3/27/2020,51,71,122,5,3,2020
14,3/27/2020,18,36,54,5,3,2020
15,3/27/2020,10,67,77,5,3,2020
16,3/27/2020,4,28,32,5,3,2020
17,3/27/2020,5,25,30,5,3,2020
18,3/27/2020,7,24,31,5,3,2020
19,3/27/2020,12,40,52,5,3,2020
20,3/27/2020,17,15,32,5,3,2020
21,3/27/2020,82,64,146,5,3,2020
22,3/27/2020,23,61,84,5,3,2020
23,3/27/2020,24,59,83,5,3,2020
0,3/28/2020,15,36,51,6,3,2020
1,3/28/2020,8,34,42,6,3,2020
2,3/28/2020,9,0,9,6,3,2020
3,3/28/2020,17,0,17,6,3,2020
4,3/28/2020,26,0,26,6,3,2020
5,3/28/2020,20,1,21,6,3,2020
6,3/28/2020,98,0,98,6,3,2020
7,3/28/2020,59,0,59,6,3,2020
8,3/28/2020,42,36,78,6,3,2020
9,3/28/2020,43,91,134,6,3,2020
10,3/28/2020,23,8,31,6,3,2020
11,3/28/2020,21,33,54,6,3,2020
12,3/28/2020,27,92,119,6,3,2020
13,3/28/2020,34,79,113,6,3,2020
14,3/28/2020,43,65,108,6,3,2020
15,3/28/2020,8,106,114,6,3,2020
16,3/28/2020,12,144,156,6,3,2020
17,3/28/2020,17,72,89,6,3,2020
18,3/28/2020,3,0,3,6,3,2020
19,3/28/2020,10,70,80,6,3,2020
20,3/28/2020,23,0,23,6,3,2020
21,3/28/2020,43,80,123,6,3,2020
22,3/28/2020,24,42,66,6,3,2020
23,3/28/2020,18,168,186,6,3,2020
0,3/29/2020,13,51,64,7,3,2020
1,3/29/2020,5,0,5,7,3,2020
2,3/29/2020,27,0,27,7,3,2020
3,3/29/2020,12,0,12,7,3,2020
4,3/29/2020,11,0,11,7,3,2020
5,3/29/2020,15,0,15,7,3,2020
6,3/29/2020,26,0,26,7,3,2020
7,3/29/2020,38,17,55,7,3,2020
8,3/29/2020,32,56,88,7,3,2020
9,3/29/2020,31,119,150,7,3,2020
10,3/29/2020,50,56,106,7,3,2020
11,3/29/2020,32,30,62,7,3,2020
12,3/29/2020,47,142,189,7,3,2020
13,3/29/2020,35,91,126,7,3,2020
14,3/29/2020,34,0,34,7,3,2020
15,3/29/2020,15,44,59,7,3,2020
16,3/29/2020,17,42,59,7,3,2020
17,3/29/2020,20,9,29,7,3,2020
18,3/29/2020,10,29,39,7,3,2020
19,3/29/2020,13,83,96,7,3,2020
20,3/29/2020,8,24,32,7,3,2020
21,3/29/2020,28,49,77,7,3,2020
22,3/29/2020,29,47,76,7,3,2020
23,3/29/2020,24,72,96,7,3,2020
0,3/30/2020,12,35,47,1,3,2020
1,3/30/2020,5,21,26,1,3,2020
2,3/30/2020,0,8,8,1,3,2020
3,3/30/2020,3,0,3,1,3,2020
4,3/30/2020,5,0,5,1,3,2020
5,3/30/2020,11,0,11,1,3,2020
6,3/30/2020,45,0,45,1,3,2020
7,3/30/2020,33,39,72,1,3,2020
8,3/30/2020,13,76,89,1,3,2020
9,3/30/2020,34,66,100,1,3,2020
10,3/30/2020,17,42,59,1,3,2020
11,3/30/2020,13,18,31,1,3,2020
12,3/30/2020,32,35,67,1,3,2020
13,3/30/2020,14,50,64,1,3,2020
14,3/30/2020,8,0,8,1,3,2020
15,3/30/2020,25,65,90,1,3,2020
16,3/30/2020,0,19,19,1,3,2020
17,3/30/2020,24,9,33,1,3,2020
18,3/30/2020,8,42,50,1,3,2020
19,3/30/2020,7,97,104,1,3,2020
20,3/30/2020,13,35,48,1,3,2020
21,3/30/2020,23,69,92,1,3,2020
22,3/30/2020,25,2,27,1,3,2020
23,3/30/2020,18,12,30,1,3,2020
0,3/31/2020,10,105,115,2,3,2020
1,3/31/2020,1,60,61,2,3,2020
2,3/31/2020,2,1,3,2,3,2020
3,3/31/2020,11,0,11,2,3,2020
4,3/31/2020,11,0,11,2,3,2020
5,3/31/2020,23,0,23,2,3,2020
6,3/31/2020,51,0,51,2,3,2020
7,3/31/2020,28,50,78,2,3,2020
8,3/31/2020,31,42,73,2,3,2020
9,3/31/2020,16,16,32,2,3,2020
10,3/31/2020,21,42,63,2,3,2020
11,3/31/2020,10,25,35,2,3,2020
12,3/31/2020,8,48,56,2,3,2020
13,3/31/2020,9,0,9,2,3,2020
14,3/31/2020,20,0,20,2,3,2020
15,3/31/2020,9,36,45,2,3,2020
16,3/31/2020,6,5,11,2,3,2020
17,3/31/2020,15,13,28,2,3,2020
18,3/31/2020,14,14,28,2,3,2020
19,3/31/2020,9,74,83,2,3,2020
20,3/31/2020,18,0,18,2,3,2020
21,3/31/2020,25,37,62,2,3,2020
22,3/31/2020,47,10,57,2,3,2020
23,3/31/2020,33,61,94,2,3,2020
0,4/1/2020,29,21,50,3,4,2020
1,4/1/2020,2,12,14,3,4,2020
2,4/1/2020,9,15,24,3,4,2020
3,4/1/2020,0,0,0,3,4,2020
4,4/1/2020,1,0,1,3,4,2020
5,4/1/2020,18,0,18,3,4,2020
6,4/1/2020,24,0,24,3,4,2020
7,4/1/2020,20,61,81,3,4,2020
8,4/1/2020,15,49,64,3,4,2020
9,4/1/2020,23,31,54,3,4,2020
10,4/1/2020,20,21,41,3,4,2020
11,4/1/2020,14,3,17,3,4,2020
12,4/1/2020,10,14,24,3,4,2020
13,4/1/2020,29,5,34,3,4,2020
14,4/1/2020,24,77,101,3,4,2020
15,4/1/2020,29,72,101,3,4,2020
16,4/1/2020,23,4,27,3,4,2020
17,4/1/2020,34,2,36,3,4,2020
18,4/1/2020,7,21,28,3,4,2020
19,4/1/2020,9,30,39,3,4,2020
20,4/1/2020,12,56,68,3,4,2020
21,4/1/2020,27,17,44,3,4,2020
22,4/1/2020,25,36,61,3,4,2020
23,4/1/2020,29,13,42,3,4,2020
0,4/2/2020,17,7,24,4,4,2020
1,4/2/2020,6,20,26,4,4,2020
2,4/2/2020,4,0,4,4,4,2020
3,4/2/2020,19,0,19,4,4,2020
4,4/2/2020,11,0,11,4,4,2020
5,4/2/2020,17,0,17,4,4,2020
6,4/2/2020,22,0,22,4,4,2020
7,4/2/2020,26,23,49,4,4,2020
8,4/2/2020,9,28,37,4,4,2020
9,4/2/2020,11,40,51,4,4,2020
10,4/2/2020,22,2,24,4,4,2020
11,4/2/2020,15,0,15,4,4,2020
12,4/2/2020,5,12,17,4,4,2020
13,4/2/2020,32,79,111,4,4,2020
14,4/2/2020,17,27,44,4,4,2020
15,4/2/2020,11,13,24,4,4,2020
16,4/2/2020,16,1,17,4,4,2020
17,4/2/2020,13,5,18,4,4,2020
18,4/2/2020,19,40,59,4,4,2020
19,4/2/2020,20,65,85,4,4,2020
20,4/2/2020,29,21,50,4,4,2020
21,4/2/2020,50,2,52,4,4,2020
22,4/2/2020,47,26,73,4,4,2020
23,4/2/2020,33,10,43,4,4,2020
0,4/3/2020,15,33,48,5,4,2020
1,4/3/2020,9,0,9,5,4,2020
2,4/3/2020,9,0,9,5,4,2020
3,4/3/2020,7,0,7,5,4,2020
4,4/3/2020,10,0,10,5,4,2020
5,4/3/2020,40,0,40,5,4,2020
6,4/3/2020,45,0,45,5,4,2020
7,4/3/2020,55,103,158,5,4,2020
8,4/3/2020,28,30,58,5,4,2020
9,4/3/2020,4,64,68,5,4,2020
10,4/3/2020,16,65,81,5,4,2020
11,4/3/2020,10,0,10,5,4,2020
12,4/3/2020,11,6,17,5,4,2020
13,4/3/2020,13,32,45,5,4,2020
14,4/3/2020,22,0,22,5,4,2020
15,4/3/2020,11,74,85,5,4,2020
16,4/3/2020,8,6,14,5,4,2020
17,4/3/2020,1,0,1,5,4,2020
18,4/3/2020,8,8,16,5,4,2020
19,4/3/2020,7,3,10,5,4,2020
20,4/3/2020,19,43,62,5,4,2020
21,4/3/2020,43,18,61,5,4,2020
22,4/3/2020,11,65,76,5,4,2020
23,4/3/2020,32,5,37,5,4,2020
0,4/4/2020,26,60,86,6,4,2020
1,4/4/2020,4,0,4,6,4,2020
2,4/4/2020,19,0,19,6,4,2020
3,4/4/2020,17,0,17,6,4,2020
4,4/4/2020,6,0,6,6,4,2020
5,4/4/2020,17,0,17,6,4,2020
6,4/4/2020,69,0,69,6,4,2020
7,4/4/2020,48,45,93,6,4,2020
8,4/4/2020,21,41,62,6,4,2020
9,4/4/2020,39,76,115,6,4,2020
10,4/4/2020,26,7,33,6,4,2020
11,4/4/2020,4,19,23,6,4,2020
12,4/4/2020,13,47,60,6,4,2020
13,4/4/2020,10,12,22,6,4,2020
14,4/4/2020,26,1,27,6,4,2020
15,4/4/2020,8,16,24,6,4,2020
16,4/4/2020,7,49,56,6,4,2020
17,4/4/2020,7,1,8,6,4,2020
18,4/4/2020,15,6,21,6,4,2020
19,4/4/2020,22,30,52,6,4,2020
20,4/4/2020,20,7,27,6,4,2020
21,4/4/2020,35,14,49,6,4,2020
22,4/4/2020,51,27,78,6,4,2020
23,4/4/2020,51,8,59,6,4,2020
0,4/5/2020,29,16,45,7,4,2020
1,4/5/2020,10,2,12,7,4,2020
2,4/5/2020,4,1,5,7,4,2020
3,4/5/2020,21,0,21,7,4,2020
4,4/5/2020,24,0,24,7,4,2020
5,4/5/2020,45,0,45,7,4,2020
6,4/5/2020,59,57,116,7,4,2020
7,4/5/2020,38,89,127,7,4,2020
8,4/5/2020,18,19,37,7,4,2020
9,4/5/2020,20,94,114,7,4,2020
10,4/5/2020,17,15,32,7,4,2020
11,4/5/2020,10,53,63,7,4,2020
12,4/5/2020,9,18,27,7,4,2020
13,4/5/2020,6,21,27,7,4,2020
14,4/5/2020,8,36,44,7,4,2020
15,4/5/2020,12,29,41,7,4,2020
16,4/5/2020,22,6,28,7,4,2020
17,4/5/2020,17,10,27,7,4,2020
18,4/5/2020,9,51,60,7,4,2020
19,4/5/2020,4,28,32,7,4,2020
20,4/5/2020,23,10,33,7,4,2020
21,4/5/2020,32,0,32,7,4,2020
22,4/5/2020,25,3,28,7,4,2020
23,4/5/2020,18,43,61,7,4,2020
0,4/6/2020,14,22,36,1,4,2020
1,4/6/2020,4,0,4,1,4,2020
2,4/6/2020,3,0,3,1,4,2020
3,4/6/2020,5,0,5,1,4,2020
4,4/6/2020,22,0,22,1,4,2020
5,4/6/2020,23,0,23,1,4,2020
6,4/6/2020,48,18,66,1,4,2020
7,4/6/2020,41,61,102,1,4,2020
8,4/6/2020,9,60,69,1,4,2020
9,4/6/2020,13,31,44,1,4,2020
10,4/6/2020,4,0,4,1,4,2020
11,4/6/2020,10,40,50,1,4,2020
12,4/6/2020,10,0,10,1,4,2020
13,4/6/2020,5,16,21,1,4,2020
14,4/6/2020,4,18,22,1,4,2020
15,4/6/2020,8,10,18,1,4,2020
16,4/6/2020,16,5,21,1,4,2020
17,4/6/2020,23,3,26,1,4,2020
18,4/6/2020,9,36,45,1,4,2020
19,4/6/2020,10,23,33,1,4,2020
20,4/6/2020,24,25,49,1,4,2020
21,4/6/2020,35,18,53,1,4,2020
22,4/6/2020,28,10,38,1,4,2020
23,4/6/2020,14,16,30,1,4,2020
0,4/7/2020,16,8,24,2,4,2020
1,4/7/2020,3,0,3,2,4,2020
2,4/7/2020,14,0,14,2,4,2020
3,4/7/2020,5,0,5,2,4,2020
4,4/7/2020,2,0,2,2,4,2020
5,4/7/2020,20,0,20,2,4,2020
6,4/7/2020,30,12,42,2,4,2020
7,4/7/2020,21,38,59,2,4,2020
8,4/7/2020,11,23,34,2,4,2020
9,4/7/2020,3,36,39,2,4,2020
10,4/7/2020,7,0,7,2,4,2020
11,4/7/2020,4,0,4,2,4,2020
12,4/7/2020,15,15,30,2,4,2020
13,4/7/2020,1,34,35,2,4,2020
14,4/7/2020,14,16,30,2,4,2020
15,4/7/2020,0,0,0,2,4,2020
16,4/7/2020,4,0,4,2,4,2020
17,4/7/2020,8,2,10,2,4,2020
18,4/7/2020,14,39,53,2,4,2020
19,4/7/2020,13,1,14,2,4,2020
20,4/7/2020,11,1,12,2,4,2020
21,4/7/2020,34,5,39,2,4,2020
22,4/7/2020,34,1,35,2,4,2020
23,4/7/2020,18,13,31,2,4,2020
0,4/8/2020,25,1,26,3,4,2020
1,4/8/2020,0,0,0,3,4,2020
2,4/8/2020,1,0,1,3,4,2020
3,4/8/2020,0,0,0,3,4,2020
4,4/8/2020,5,0,5,3,4,2020
5,4/8/2020,17,0,17,3,4,2020
6,4/8/2020,36,40,76,3,4,2020
7,4/8/2020,14,69,83,3,4,2020
8,4/8/2020,26,3,29,3,4,2020
9,4/8/2020,16,4,20,3,4,2020
10,4/8/2020,9,28,37,3,4,2020
11,4/8/2020,5,10,15,3,4,2020
12,4/8/2020,4,0,4,3,4,2020
13,4/8/2020,0,6,6,3,4,2020
14,4/8/2020,2,32,34,3,4,2020
15,4/8/2020,7,42,49,3,4,2020
16,4/8/2020,12,0,12,3,4,2020
17,4/8/2020,15,0,15,3,4,2020
18,4/8/2020,12,44,56,3,4,2020
19,4/8/2020,15,1,16,3,4,2020
20,4/8/2020,19,13,32,3,4,2020
21,4/8/2020,28,22,50,3,4,2020
22,4/8/2020,28,3,31,3,4,2020
23,4/8/2020,20,1,21,3,4,2020
0,4/9/2020,23,13,36,4,4,2020
1,4/9/2020,1,0,1,4,4,2020
2,4/9/2020,8,0,8,4,4,2020
3,4/9/2020,7,0,7,4,4,2020
4,4/9/2020,3,0,3,4,4,2020
5,4/9/2020,8,0,8,4,4,2020
6,4/9/2020,7,2,9,4,4,2020
7,4/9/2020,23,71,94,4,4,2020
8,4/9/2020,15,37,52,4,4,2020
9,4/9/2020,11,1,12,4,4,2020
10,4/9/2020,13,4,17,4,4,2020
11,4/9/2020,10,32,42,4,4,2020
12,4/9/2020,2,3,5,4,4,2020
13,4/9/2020,3,37,40,4,4,2020
14,4/9/2020,1,0,1,4,4,2020
15,4/9/2020,6,0,6,4,4,2020
16,4/9/2020,7,0,7,4,4,2020
17,4/9/2020,7,1,8,4,4,2020
18,4/9/2020,1,69,70,4,4,2020
19,4/9/2020,11,16,27,4,4,2020
20,4/9/2020,28,15,43,4,4,2020
21,4/9/2020,25,16,41,4,4,2020
22,4/9/2020,42,0,42,4,4,2020
23,4/9/2020,25,10,35,4,4,2020
0,4/10/2020,18,8,26,5,4,2020
1,4/10/2020,7,0,7,5,4,2020
2,4/10/2020,3,0,3,5,4,2020
3,4/10/2020,0,0,0,5,4,2020
4,4/10/2020,1,0,1,5,4,2020
5,4/10/2020,21,1,22,5,4,2020
6,4/10/2020,41,50,91,5,4,2020
7,4/10/2020,36,70,106,5,4,2020
8,4/10/2020,18,8,26,5,4,2020
9,4/10/2020,14,0,14,5,4,2020
10,4/10/2020,9,6,15,5,4,2020
11,4/10/2020,2,46,48,5,4,2020
12,4/10/2020,4,0,4,5,4,2020
13,4/10/2020,0,0,0,5,4,2020
14,4/10/2020,0,36,36,5,4,2020
15,4/10/2020,2,6,8,5,4,2020
16,4/10/2020,4,0,4,5,4,2020
17,4/10/2020,11,0,11,5,4,2020
18,4/10/2020,6,28,34,5,4,2020
19,4/10/2020,13,3,16,5,4,2020
20,4/10/2020,29,17,46,5,4,2020
21,4/10/2020,43,0,43,5,4,2020
22,4/10/2020,46,1,47,5,4,2020
23,4/10/2020,31,10,41,5,4,2020
0,4/11/2020,9,12,21,6,4,2020
1,4/11/2020,5,0,5,6,4,2020
2,4/11/2020,0,0,0,6,4,2020
3,4/11/2020,0,0,0,6,4,2020
4,4/11/2020,0,0,0,6,4,2020
5,4/11/2020,0,0,0,6,4,2020
6,4/11/2020,2,30,32,6,4,2020
7,4/11/2020,6,36,42,6,4,2020
8,4/11/2020,12,1,13,6,4,2020
9,4/11/2020,22,80,102,6,4,2020
10,4/11/2020,17,6,23,6,4,2020
11,4/11/2020,20,19,39,6,4,2020
12,4/11/2020,8,0,8,6,4,2020
13,4/11/2020,3,1,4,6,4,2020
14,4/11/2020,5,5,10,6,4,2020
15,4/11/2020,14,0,14,6,4,2020
16,4/11/2020,3,0,3,6,4,2020
17,4/11/2020,8,0,8,6,4,2020
18,4/11/2020,8,99,107,6,4,2020
19,4/11/2020,11,0,11,6,4,2020
20,4/11/2020,6,0,6,6,4,2020
21,4/11/2020,47,0,47,6,4,2020
22,4/11/2020,32,0,32,6,4,2020
23,4/11/2020,50,41,91,6,4,2020
0,4/12/2020,14,8,22,7,4,2020
1,4/12/2020,3,0,3,7,4,2020
2,4/12/2020,4,0,4,7,4,2020
3,4/12/2020,5,0,5,7,4,2020
4,4/12/2020,14,0,14,7,4,2020
5,4/12/2020,14,0,14,7,4,2020
6,4/12/2020,20,14,34,7,4,2020
7,4/12/2020,12,54,66,7,4,2020
8,4/12/2020,16,15,31,7,4,2020
9,4/12/2020,25,65,90,7,4,2020
10,4/12/2020,12,55,67,7,4,2020
11,4/12/2020,14,26,40,7,4,2020
12,4/12/2020,10,6,16,7,4,2020
13,4/12/2020,2,15,17,7,4,2020
14,4/12/2020,4,26,30,7,4,2020
15,4/12/2020,4,15,19,7,4,2020
16,4/12/2020,7,0,7,7,4,2020
17,4/12/2020,7,5,12,7,4,2020
18,4/12/2020,7,82,89,7,4,2020
19,4/12/2020,7,3,10,7,4,2020
20,4/12/2020,21,27,48,7,4,2020
21,4/12/2020,35,1,36,7,4,2020
22,4/12/2020,16,19,35,7,4,2020
23,4/12/2020,6,74,80,7,4,2020
0,4/13/2020,7,12,19,1,4,2020
1,4/13/2020,2,6,8,1,4,2020
2,4/13/2020,4,0,4,1,4,2020
3,4/13/2020,0,0,0,1,4,2020
4,4/13/2020,1,0,1,1,4,2020
5,4/13/2020,9,0,9,1,4,2020
6,4/13/2020,16,0,16,1,4,2020
7,4/13/2020,28,52,80,1,4,2020
8,4/13/2020,5,27,32,1,4,2020
9,4/13/2020,5,63,68,1,4,2020
10,4/13/2020,12,1,13,1,4,2020
11,4/13/2020,3,15,18,1,4,2020
12,4/13/2020,7,8,15,1,4,2020
13,4/13/2020,4,8,12,1,4,2020
14,4/13/2020,2,10,12,1,4,2020
15,4/13/2020,7,0,7,1,4,2020
16,4/13/2020,16,0,16,1,4,2020
17,4/13/2020,20,0,20,1,4,2020
18,4/13/2020,3,58,61,1,4,2020
19,4/13/2020,11,0,11,1,4,2020
20,4/13/2020,19,11,30,1,4,2020
21,4/13/2020,30,0,30,1,4,2020
22,4/13/2020,18,0,18,1,4,2020
23,4/13/2020,15,10,25,1,4,2020
0,4/14/2020,11,22,33,2,4,2020
1,4/14/2020,0,9,9,2,4,2020
2,4/14/2020,0,0,0,2,4,2020
3,4/14/2020,0,0,0,2,4,2020
4,4/14/2020,10,0,10,2,4,2020
5,4/14/2020,19,0,19,2,4,2020
6,4/14/2020,19,64,83,2,4,2020
7,4/14/2020,16,20,36,2,4,2020
8,4/14/2020,7,25,32,2,4,2020
9,4/14/2020,6,41,47,2,4,2020
10,4/14/2020,6,7,13,2,4,2020
11,4/14/2020,6,12,18,2,4,2020
12,4/14/2020,3,21,24,2,4,2020
13,4/14/2020,4,11,15,2,4,2020
14,4/14/2020,1,0,1,2,4,2020
15,4/14/2020,1,0,1,2,4,2020
16,4/14/2020,3,0,3,2,4,2020
17,4/14/2020,0,6,6,2,4,2020
18,4/14/2020,4,14,18,2,4,2020
19,4/14/2020,6,0,6,2,4,2020
20,4/14/2020,33,0,33,2,4,2020
21,4/14/2020,23,10,33,2,4,2020
22,4/14/2020,26,0,26,2,4,2020
23,4/14/2020,24,9,33,2,4,2020
0,4/15/2020,23,0,23,3,4,2020
1,4/15/2020,0,0,0,3,4,2020
2,4/15/2020,0,0,0,3,4,2020
3,4/15/2020,2,0,2,3,4,2020
4,4/15/2020,2,0,2,3,4,2020
5,4/15/2020,17,0,17,3,4,2020
6,4/15/2020,34,14,48,3,4,2020
7,4/15/2020,11,98,109,3,4,2020
8,4/15/2020,9,7,16,3,4,2020
9,4/15/2020,9,38,47,3,4,2020
10,4/15/2020,5,4,9,3,4,2020
11,4/15/2020,1,17,18,3,4,2020
12,4/15/2020,2,23,25,3,4,2020
13,4/15/2020,4,6,10,3,4,2020
14,4/15/2020,1,0,1,3,4,2020
15,4/15/2020,6,5,11,3,4,2020
16,4/15/2020,11,0,11,3,4,2020
17,4/15/2020,8,0,8,3,4,2020
18,4/15/2020,5,32,37,3,4,2020
19,4/15/2020,7,21,28,3,4,2020
20,4/15/2020,24,0,24,3,4,2020
21,4/15/2020,30,0,30,3,4,2020
22,4/15/2020,38,2,40,3,4,2020
23,4/15/2020,20,26,46,3,4,2020
0,4/16/2020,14,2,16,4,4,2020
1,4/16/2020,4,0,4,4,4,2020
2,4/16/2020,2,0,2,4,4,2020
3,4/16/2020,16,0,16,4,4,2020
4,4/16/2020,8,0,8,4,4,2020
5,4/16/2020,2,0,2,4,4,2020
6,4/16/2020,3,43,46,4,4,2020
7,4/16/2020,14,0,14,4,4,2020
8,4/16/2020,12,40,52,4,4,2020
9,4/16/2020,34,0,34,4,4,2020
10,4/16/2020,21,8,29,4,4,2020
11,4/16/2020,6,63,69,4,4,2020
12,4/16/2020,14,5,19,4,4,2020
13,4/16/2020,3,29,32,4,4,2020
14,4/16/2020,2,4,6,4,4,2020
15,4/16/2020,4,0,4,4,4,2020
16,4/16/2020,9,0,9,4,4,2020
17,4/16/2020,12,0,12,4,4,2020
18,4/16/2020,7,19,26,4,4,2020
19,4/16/2020,14,33,47,4,4,2020
20,4/16/2020,20,0,20,4,4,2020
21,4/16/2020,52,0,52,4,4,2020
22,4/16/2020,59,2,61,4,4,2020
23,4/16/2020,41,0,41,4,4,2020
0,4/17/2020,8,19,27,5,4,2020
1,4/17/2020,2,0,2,5,4,2020
2,4/17/2020,2,0,2,5,4,2020
3,4/17/2020,1,0,1,5,4,2020
4,4/17/2020,5,0,5,5,4,2020
5,4/17/2020,20,0,20,5,4,2020
6,4/17/2020,29,0,29,5,4,2020
7,4/17/2020,28,86,114,5,4,2020
8,4/17/2020,21,86,107,5,4,2020
9,4/17/2020,19,9,28,5,4,2020
10,4/17/2020,10,52,62,5,4,2020
11,4/17/2020,1,28,29,5,4,2020
12,4/17/2020,0,4,4,5,4,2020
13,4/17/2020,0,46,46,5,4,2020
14,4/17/2020,10,29,39,5,4,2020
15,4/17/2020,1,9,10,5,4,2020
16,4/17/2020,15,0,15,5,4,2020
17,4/17/2020,21,0,21,5,4,2020
18,4/17/2020,13,25,38,5,4,2020
19,4/17/2020,9,14,23,5,4,2020
20,4/17/2020,28,0,28,5,4,2020
21,4/17/2020,41,0,41,5,4,2020
22,4/17/2020,21,3,24,5,4,2020
23,4/17/2020,22,6,28,5,4,2020
0,4/18/2020,10,27,37,6,4,2020
1,4/18/2020,0,0,0,6,4,2020
2,4/18/2020,0,0,0,6,4,2020
3,4/18/2020,0,0,0,6,4,2020
4,4/18/2020,0,0,0,6,4,2020
5,4/18/2020,0,0,0,6,4,2020
6,4/18/2020,4,41,45,6,4,2020
7,4/18/2020,8,17,25,6,4,2020
8,4/18/2020,28,14,42,6,4,2020
9,4/18/2020,32,91,123,6,4,2020
10,4/18/2020,14,8,22,6,4,2020
11,4/18/2020,3,26,29,6,4,2020
12,4/18/2020,0,0,0,6,4,2020
13,4/18/2020,8,0,8,6,4,2020
14,4/18/2020,14,0,14,6,4,2020
15,4/18/2020,13,0,13,6,4,2020
16,4/18/2020,5,0,5,6,4,2020
17,4/18/2020,3,7,10,6,4,2020
18,4/18/2020,12,36,48,6,4,2020
19,4/18/2020,13,47,60,6,4,2020
20,4/18/2020,31,0,31,6,4,2020
21,4/18/2020,29,0,29,6,4,2020
22,4/18/2020,15,0,15,6,4,2020
23,4/18/2020,11,53,64,6,4,2020
0,4/19/2020,5,19,24,7,4,2020
1,4/19/2020,9,1,10,7,4,2020
2,4/19/2020,5,0,5,7,4,2020
3,4/19/2020,18,0,18,7,4,2020
4,4/19/2020,19,0,19,7,4,2020
5,4/19/2020,56,0,56,7,4,2020
6,4/19/2020,22,11,33,7,4,2020
7,4/19/2020,37,57,94,7,4,2020
8,4/19/2020,16,30,46,7,4,2020
9,4/19/2020,34,16,50,7,4,2020
10,4/19/2020,21,29,50,7,4,2020
11,4/19/2020,9,43,52,7,4,2020
12,4/19/2020,11,11,22,7,4,2020
13,4/19/2020,1,54,55,7,4,2020
14,4/19/2020,3,39,42,7,4,2020
15,4/19/2020,3,24,27,7,4,2020
16,4/19/2020,20,0,20,7,4,2020
17,4/19/2020,6,2,8,7,4,2020
18,4/19/2020,8,27,35,7,4,2020
19,4/19/2020,9,12,21,7,4,2020
20,4/19/2020,20,1,21,7,4,2020
21,4/19/2020,37,6,43,7,4,2020
22,4/19/2020,49,75,124,7,4,2020
23,4/19/2020,25,15,40,7,4,2020
0,4/20/2020,5,20,25,1,4,2020
1,4/20/2020,0,0,0,1,4,2020
2,4/20/2020,0,0,0,1,4,2020
3,4/20/2020,0,0,0,1,4,2020
4,4/20/2020,1,0,1,1,4,2020
5,4/20/2020,16,0,16,1,4,2020
6,4/20/2020,19,39,58,1,4,2020
7,4/20/2020,34,2,36,1,4,2020
8,4/20/2020,12,33,45,1,4,2020
9,4/20/2020,15,13,28,1,4,2020
10,4/20/2020,23,10,33,1,4,2020
11,4/20/2020,10,0,10,1,4,2020
12,4/20/2020,2,42,44,1,4,2020
13,4/20/2020,0,31,31,1,4,2020
14,4/20/2020,2,5,7,1,4,2020
15,4/20/2020,10,0,10,1,4,2020
16,4/20/2020,9,0,9,1,4,2020
17,4/20/2020,9,0,9,1,4,2020
18,4/20/2020,9,66,75,1,4,2020
19,4/20/2020,16,9,25,1,4,2020
20,4/20/2020,6,0,6,1,4,2020
21,4/20/2020,9,0,9,1,4,2020
22,4/20/2020,14,1,15,1,4,2020
23,4/20/2020,5,31,36,1,4,2020
0,4/21/2020,14,17,31,2,4,2020
1,4/21/2020,1,0,1,2,4,2020
2,4/21/2020,0,0,0,2,4,2020
3,4/21/2020,0,0,0,2,4,2020
4,4/21/2020,1,0,1,2,4,2020
5,4/21/2020,2,0,2,2,4,2020
6,4/21/2020,15,0,15,2,4,2020
7,4/21/2020,33,0,33,2,4,2020
8,4/21/2020,14,7,21,2,4,2020
9,4/21/2020,8,35,43,2,4,2020
10,4/21/2020,11,13,24,2,4,2020
11,4/21/2020,2,1,3,2,4,2020
12,4/21/2020,16,49,65,2,4,2020
13,4/21/2020,11,16,27,2,4,2020
14,4/21/2020,1,0,1,2,4,2020
15,4/21/2020,3,0,3,2,4,2020
16,4/21/2020,6,0,6,2,4,2020
17,4/21/2020,4,1,5,2,4,2020
18,4/21/2020,1,25,26,2,4,2020
19,4/21/2020,3,0,3,2,4,2020
20,4/21/2020,21,0,21,2,4,2020
21,4/21/2020,22,52,74,2,4,2020
22,4/21/2020,29,0,29,2,4,2020
23,4/21/2020,20,9,29,2,4,2020
0,4/22/2020,7,34,41,3,4,2020
1,4/22/2020,4,0,4,3,4,2020
2,4/22/2020,0,0,0,3,4,2020
3,4/22/2020,1,0,1,3,4,2020
4,4/22/2020,6,0,6,3,4,2020
5,4/22/2020,2,0,2,3,4,2020
6,4/22/2020,8,0,8,3,4,2020
7,4/22/2020,0,58,58,3,4,2020
8,4/22/2020,8,3,11,3,4,2020
9,4/22/2020,11,35,46,3,4,2020
10,4/22/2020,9,41,50,3,4,2020
11,4/22/2020,5,0,5,3,4,2020
12,4/22/2020,0,15,15,3,4,2020
13,4/22/2020,0,9,9,3,4,2020
14,4/22/2020,0,0,0,3,4,2020
15,4/22/2020,0,8,8,3,4,2020
16,4/22/2020,1,0,1,3,4,2020
17,4/22/2020,0,0,0,3,4,2020
18,4/22/2020,3,0,3,3,4,2020
19,4/22/2020,8,8,16,3,4,2020
20,4/22/2020,31,7,38,3,4,2020
21,4/22/2020,28,0,28,3,4,2020
22,4/22/2020,34,0,34,3,4,2020
23,4/22/2020,18,0,18,3,4,2020
0,4/23/2020,13,0,13,4,4,2020
1,4/23/2020,5,0,5,4,4,2020
2,4/23/2020,10,0,10,4,4,2020
3,4/23/2020,3,0,3,4,4,2020
4,4/23/2020,9,0,9,4,4,2020
5,4/23/2020,0,0,0,4,4,2020
6,4/23/2020,17,48,65,4,4,2020
7,4/23/2020,38,2,40,4,4,2020
8,4/23/2020,12,16,28,4,4,2020
9,4/23/2020,19,74,93,4,4,2020
10,4/23/2020,13,14,27,4,4,2020
11,4/23/2020,5,19,24,4,4,2020
12,4/23/2020,5,24,29,4,4,2020
13,4/23/2020,3,38,41,4,4,2020
14,4/23/2020,5,0,5,4,4,2020
15,4/23/2020,20,0,20,4,4,2020
16,4/23/2020,3,0,3,4,4,2020
17,4/23/2020,19,0,19,4,4,2020
18,4/23/2020,6,12,18,4,4,2020
19,4/23/2020,10,17,27,4,4,2020
20,4/23/2020,25,1,26,4,4,2020
21,4/23/2020,83,0,83,4,4,2020
22,4/23/2020,50,0,50,4,4,2020
23,4/23/2020,45,22,67,4,4,2020
0,4/24/2020,7,27,34,5,4,2020
1,4/24/2020,3,0,3,5,4,2020
2,4/24/2020,0,0,0,5,4,2020
3,4/24/2020,2,0,2,5,4,2020
4,4/24/2020,0,0,0,5,4,2020
5,4/24/2020,24,0,24,5,4,2020
6,4/24/2020,18,33,51,5,4,2020
7,4/24/2020,22,32,54,5,4,2020
8,4/24/2020,25,0,25,5,4,2020
9,4/24/2020,32,39,71,5,4,2020
10,4/24/2020,25,69,94,5,4,2020
11,4/24/2020,10,10,20,5,4,2020
12,4/24/2020,3,26,29,5,4,2020
13,4/24/2020,1,16,17,5,4,2020
14,4/24/2020,3,51,54,5,4,2020
15,4/24/2020,3,10,13,5,4,2020
16,4/24/2020,8,1,9,5,4,2020
17,4/24/2020,27,13,40,5,4,2020
18,4/24/2020,10,86,96,5,4,2020
19,4/24/2020,7,5,12,5,4,2020
20,4/24/2020,23,27,50,5,4,2020
21,4/24/2020,31,0,31,5,4,2020
22,4/24/2020,51,0,51,5,4,2020
23,4/24/2020,31,14,45,5,4,2020
0,4/25/2020,13,28,41,6,4,2020
1,4/25/2020,0,1,1,6,4,2020
2,4/25/2020,0,0,0,6,4,2020
3,4/25/2020,0,0,0,6,4,2020
4,4/25/2020,0,0,0,6,4,2020
5,4/25/2020,6,0,6,6,4,2020
6,4/25/2020,20,0,20,6,4,2020
7,4/25/2020,47,0,47,6,4,2020
8,4/25/2020,7,23,30,6,4,2020
9,4/25/2020,15,87,102,6,4,2020
10,4/25/2020,6,19,25,6,4,2020
11,4/25/2020,7,0,7,6,4,2020
12,4/25/2020,0,23,23,6,4,2020
13,4/25/2020,0,20,20,6,4,2020
14,4/25/2020,4,0,4,6,4,2020
15,4/25/2020,3,0,3,6,4,2020
16,4/25/2020,2,0,2,6,4,2020
17,4/25/2020,14,8,22,6,4,2020
18,4/25/2020,2,42,44,6,4,2020
19,4/25/2020,6,3,9,6,4,2020
20,4/25/2020,8,0,8,6,4,2020
21,4/25/2020,20,0,20,6,4,2020
22,4/25/2020,27,4,31,6,4,2020
23,4/25/2020,23,22,45,6,4,2020
0,4/26/2020,4,0,4,7,4,2020
1,4/26/2020,0,0,0,7,4,2020
2,4/26/2020,3,0,3,7,4,2020
3,4/26/2020,7,0,7,7,4,2020
4,4/26/2020,5,0,5,7,4,2020
5,4/26/2020,13,0,13,7,4,2020
6,4/26/2020,33,0,33,7,4,2020
7,4/26/2020,37,0,37,7,4,2020
8,4/26/2020,26,58,84,7,4,2020
9,4/26/2020,48,17,65,7,4,2020
10,4/26/2020,32,11,43,7,4,2020
11,4/26/2020,12,9,21,7,4,2020
12,4/26/2020,5,71,76,7,4,2020
13,4/26/2020,6,61,67,7,4,2020
14,4/26/2020,7,50,57,7,4,2020
15,4/26/2020,8,19,27,7,4,2020
16,4/26/2020,20,0,20,7,4,2020
17,4/26/2020,15,0,15,7,4,2020
18,4/26/2020,11,50,61,7,4,2020
19,4/26/2020,21,36,57,7,4,2020
20,4/26/2020,33,0,33,7,4,2020
21,4/26/2020,30,0,30,7,4,2020
22,4/26/2020,44,7,51,7,4,2020
23,4/26/2020,46,45,91,7,4,2020
0,4/27/2020,8,39,47,1,4,2020
1,4/27/2020,1,0,1,1,4,2020
2,4/27/2020,0,0,0,1,4,2020
3,4/27/2020,0,0,0,1,4,2020
4,4/27/2020,2,0,2,1,4,2020
5,4/27/2020,1,0,1,1,4,2020
6,4/27/2020,12,0,12,1,4,2020
7,4/27/2020,39,0,39,1,4,2020
8,4/27/2020,21,88,109,1,4,2020
9,4/27/2020,15,81,96,1,4,2020
10,4/27/2020,2,6,8,1,4,2020
11,4/27/2020,5,0,5,1,4,2020
12,4/27/2020,4,23,27,1,4,2020
13,4/27/2020,0,60,60,1,4,2020
14,4/27/2020,4,0,4,1,4,2020
15,4/27/2020,10,0,10,1,4,2020
16,4/27/2020,16,0,16,1,4,2020
17,4/27/2020,13,3,16,1,4,2020
18,4/27/2020,12,73,85,1,4,2020
19,4/27/2020,10,16,26,1,4,2020
20,4/27/2020,10,0,10,1,4,2020
21,4/27/2020,49,0,49,1,4,2020
22,4/27/2020,26,3,29,1,4,2020
23,4/27/2020,9,17,26,1,4,2020
0,4/28/2020,0,18,18,2,4,2020
1,4/28/2020,0,6,6,2,4,2020
2,4/28/2020,1,0,1,2,4,2020
3,4/28/2020,0,0,0,2,4,2020
4,4/28/2020,1,0,1,2,4,2020
5,4/28/2020,1,0,1,2,4,2020
6,4/28/2020,17,0,17,2,4,2020
7,4/28/2020,24,0,24,2,4,2020
8,4/28/2020,8,51,59,2,4,2020
9,4/28/2020,4,24,28,2,4,2020
10,4/28/2020,11,6,17,2,4,2020
11,4/28/2020,1,0,1,2,4,2020
12,4/28/2020,3,16,19,2,4,2020
13,4/28/2020,0,13,13,2,4,2020
14,4/28/2020,6,0,6,2,4,2020
15,4/28/2020,2,0,2,2,4,2020
16,4/28/2020,11,0,11,2,4,2020
17,4/28/2020,19,9,28,2,4,2020
18,4/28/2020,4,36,40,2,4,2020
19,4/28/2020,13,0,13,2,4,2020
20,4/28/2020,13,0,13,2,4,2020
21,4/28/2020,38,0,38,2,4,2020
22,4/28/2020,33,6,39,2,4,2020
23,4/28/2020,21,3,24,2,4,2020
0,4/29/2020,1,0,1,3,4,2020
1,4/29/2020,0,0,0,3,4,2020
2,4/29/2020,0,0,0,3,4,2020
3,4/29/2020,3,0,3,3,4,2020
4,4/29/2020,0,0,0,3,4,2020
5,4/29/2020,7,0,7,3,4,2020
6,4/29/2020,20,0,20,3,4,2020
7,4/29/2020,41,0,41,3,4,2020
8,4/29/2020,15,0,15,3,4,2020
9,4/29/2020,16,10,26,3,4,2020
10,4/29/2020,12,137,149,3,4,2020
11,4/29/2020,2,0,2,3,4,2020
12,4/29/2020,0,91,91,3,4,2020
13,4/29/2020,2,20,22,3,4,2020
14,4/29/2020,1,2,3,3,4,2020
15,4/29/2020,2,15,17,3,4,2020
16,4/29/2020,6,0,6,3,4,2020
17,4/29/2020,19,0,19,3,4,2020
18,4/29/2020,4,49,53,3,4,2020
19,4/29/2020,19,1,20,3,4,2020
20,4/29/2020,38,10,48,3,4,2020
21,4/29/2020,49,0,49,3,4,2020
22,4/29/2020,44,11,55,3,4,2020
23,4/29/2020,38,0,38,3,4,2020
0,4/30/2020,18,0,18,4,4,2020
1,4/30/2020,10,0,10,4,4,2020
2,4/30/2020,5,0,5,4,4,2020
3,4/30/2020,5,0,5,4,4,2020
4,4/30/2020,10,0,10,4,4,2020
5,4/30/2020,28,0,28,4,4,2020
6,4/30/2020,48,0,48,4,4,2020
7,4/30/2020,45,0,45,4,4,2020
8,4/30/2020,20,6,26,4,4,2020
9,4/30/2020,17,62,79,4,4,2020
10,4/30/2020,21,171,192,4,4,2020
11,4/30/2020,19,73,92,4,4,2020
12,4/30/2020,15,36,51,4,4,2020
13,4/30/2020,19,68,87,4,4,2020
14,4/30/2020,17,0,17,4,4,2020
15,4/30/2020,6,22,28,4,4,2020
16,4/30/2020,43,2,45,4,4,2020
17,4/30/2020,33,4,37,4,4,2020
18,4/30/2020,5,79,84,4,4,2020
19,4/30/2020,1,39,40,4,4,2020
20,4/30/2020,9,7,16,4,4,2020
21,4/30/2020,11,24,35,4,4,2020
22,4/30/2020,7,3,10,4,4,2020
23,4/30/2020,1,42,43,4,4,2020
0,5/1/2020,0,6,6,5,5,2020
1,5/1/2020,2,0,2,5,5,2020
2,5/1/2020,5,0,5,5,5,2020
3,5/1/2020,2,0,2,5,5,2020
4,5/1/2020,2,0,2,5,5,2020
5,5/1/2020,20,0,20,5,5,2020
6,5/1/2020,60,0,60,5,5,2020
7,5/1/2020,38,0,38,5,5,2020
8,5/1/2020,10,0,10,5,5,2020
9,5/1/2020,14,29,43,5,5,2020
10,5/1/2020,43,25,68,5,5,2020
11,5/1/2020,27,46,73,5,5,2020
12,5/1/2020,38,0,38,5,5,2020
13,5/1/2020,28,12,40,5,5,2020
14,5/1/2020,32,19,51,5,5,2020
15,5/1/2020,16,111,127,5,5,2020
16,5/1/2020,16,0,16,5,5,2020
17,5/1/2020,14,0,14,5,5,2020
18,5/1/2020,8,8,16,5,5,2020
19,5/1/2020,0,47,47,5,5,2020
20,5/1/2020,6,39,45,5,5,2020
21,5/1/2020,14,77,91,5,5,2020
22,5/1/2020,19,3,22,5,5,2020
23,5/1/2020,6,0,6,5,5,2020
0,5/2/2020,7,0,7,6,5,2020
1,5/2/2020,4,0,4,6,5,2020
2,5/2/2020,1,0,1,6,5,2020
3,5/2/2020,4,0,4,6,5,2020
4,5/2/2020,9,0,9,6,5,2020
5,5/2/2020,26,0,26,6,5,2020
6,5/2/2020,60,0,60,6,5,2020
7,5/2/2020,49,0,49,6,5,2020
8,5/2/2020,21,0,21,6,5,2020
9,5/2/2020,24,1,25,6,5,2020
10,5/2/2020,27,18,45,6,5,2020
11,5/2/2020,28,52,80,6,5,2020
12,5/2/2020,71,0,71,6,5,2020
13,5/2/2020,36,16,52,6,5,2020
14,5/2/2020,11,70,81,6,5,2020
15,5/2/2020,1,110,111,6,5,2020
16,5/2/2020,0,44,44,6,5,2020
17,5/2/2020,0,0,0,6,5,2020
18,5/2/2020,1,0,1,6,5,2020
19,5/2/2020,0,20,20,6,5,2020
20,5/2/2020,3,10,13,6,5,2020
21,5/2/2020,0,56,56,6,5,2020
22,5/2/2020,0,0,0,6,5,2020
23,5/2/2020,0,0,0,6,5,2020
0,5/3/2020,0,0,0,7,5,2020
1,5/3/2020,1,0,1,7,5,2020
2,5/3/2020,5,0,5,7,5,2020
3,5/3/2020,0,0,0,7,5,2020
4,5/3/2020,1,0,1,7,5,2020
5,5/3/2020,16,0,16,7,5,2020
6,5/3/2020,71,0,71,7,5,2020
7,5/3/2020,41,0,41,7,5,2020
8,5/3/2020,24,20,44,7,5,2020
9,5/3/2020,44,22,66,7,5,2020
10,5/3/2020,32,31,63,7,5,2020
11,5/3/2020,54,60,114,7,5,2020
12,5/3/2020,57,0,57,7,5,2020
13,5/3/2020,46,52,98,7,5,2020
14,5/3/2020,17,41,58,7,5,2020
15,5/3/2020,1,119,120,7,5,2020
16,5/3/2020,2,18,20,7,5,2020
17,5/3/2020,0,0,0,7,5,2020
18,5/3/2020,5,67,72,7,5,2020
19,5/3/2020,1,15,16,7,5,2020
20,5/3/2020,1,55,56,7,5,2020
21,5/3/2020,5,83,88,7,5,2020
22,5/3/2020,15,0,15,7,5,2020
23,5/3/2020,7,0,7,7,5,2020
0,5/4/2020,1,0,1,1,5,2020
1,5/4/2020,1,0,1,1,5,2020
2,5/4/2020,6,0,6,1,5,2020
3,5/4/2020,2,0,2,1,5,2020
4,5/4/2020,8,0,8,1,5,2020
5,5/4/2020,29,0,29,1,5,2020
6,5/4/2020,47,0,47,1,5,2020
7,5/4/2020,34,0,34,1,5,2020
8,5/4/2020,21,1,22,1,5,2020
9,5/4/2020,49,49,98,1,5,2020
10,5/4/2020,32,32,64,1,5,2020
11,5/4/2020,28,47,75,1,5,2020
12,5/4/2020,47,0,47,1,5,2020
13,5/4/2020,28,34,62,1,5,2020
14,5/4/2020,27,29,56,1,5,2020
15,5/4/2020,3,96,99,1,5,2020
16,5/4/2020,0,32,32,1,5,2020
17,5/4/2020,0,0,0,1,5,2020
18,5/4/2020,0,27,27,1,5,2020
19,5/4/2020,4,54,58,1,5,2020
20,5/4/2020,4,16,20,1,5,2020
21,5/4/2020,8,97,105,1,5,2020
22,5/4/2020,5,6,11,1,5,2020
23,5/4/2020,8,0,8,1,5,2020
0,5/5/2020,2,0,2,2,5,2020
1,5/5/2020,0,0,0,2,5,2020
2,5/5/2020,5,0,5,2,5,2020
3,5/5/2020,0,0,0,2,5,2020
4,5/5/2020,17,0,17,2,5,2020
5,5/5/2020,24,0,24,2,5,2020
6,5/5/2020,48,0,48,2,5,2020
7,5/5/2020,40,0,40,2,5,2020
8,5/5/2020,10,10,20,2,5,2020
9,5/5/2020,19,23,42,2,5,2020
10,5/5/2020,36,18,54,2,5,2020
11,5/5/2020,49,33,82,2,5,2020
12,5/5/2020,79,0,79,2,5,2020
13,5/5/2020,54,60,114,2,5,2020
14,5/5/2020,16,13,29,2,5,2020
15,5/5/2020,3,94,97,2,5,2020
16,5/5/2020,1,5,6,2,5,2020
17,5/5/2020,3,0,3,2,5,2020
18,5/5/2020,2,12,14,2,5,2020
19,5/5/2020,0,3,3,2,5,2020
20,5/5/2020,0,12,12,2,5,2020
21,5/5/2020,2,120,122,2,5,2020
22,5/5/2020,0,0,0,2,5,2020
23,5/5/2020,0,0,0,2,5,2020
0,5/6/2020,2,0,2,3,5,2020
1,5/6/2020,0,0,0,3,5,2020
2,5/6/2020,0,0,0,3,5,2020
3,5/6/2020,2,0,2,3,5,2020
4,5/6/2020,0,0,0,3,5,2020
5,5/6/2020,22,0,22,3,5,2020
6,5/6/2020,50,0,50,3,5,2020
7,5/6/2020,59,0,59,3,5,2020
8,5/6/2020,7,1,8,3,5,2020
9,5/6/2020,37,42,79,3,5,2020
10,5/6/2020,50,12,62,3,5,2020
11,5/6/2020,44,45,89,3,5,2020
12,5/6/2020,61,0,61,3,5,2020
13,5/6/2020,47,18,65,3,5,2020
14,5/6/2020,17,36,53,3,5,2020
15,5/6/2020,2,113,115,3,5,2020
16,5/6/2020,0,0,0,3,5,2020
17,5/6/2020,1,0,1,3,5,2020
18,5/6/2020,0,0,0,3,5,2020
19,5/6/2020,0,32,32,3,5,2020
20,5/6/2020,0,30,30,3,5,2020
21,5/6/2020,1,45,46,3,5,2020
22,5/6/2020,3,0,3,3,5,2020
23,5/6/2020,3,0,3,3,5,2020
0,5/7/2020,3,0,3,4,5,2020
1,5/7/2020,3,0,3,4,5,2020
2,5/7/2020,0,0,0,4,5,2020
3,5/7/2020,3,0,3,4,5,2020
4,5/7/2020,9,0,9,4,5,2020
5,5/7/2020,37,0,37,4,5,2020
6,5/7/2020,63,0,63,4,5,2020
7,5/7/2020,29,0,29,4,5,2020
8,5/7/2020,23,0,23,4,5,2020
9,5/7/2020,48,0,48,4,5,2020
10,5/7/2020,79,61,140,4,5,2020
11,5/7/2020,52,33,85,4,5,2020
12,5/7/2020,94,1,95,4,5,2020
13,5/7/2020,68,37,105,4,5,2020
14,5/7/2020,30,32,62,4,5,2020
15,5/7/2020,4,107,111,4,5,2020
16,5/7/2020,0,20,20,4,5,2020
17,5/7/2020,0,0,0,4,5,2020
18,5/7/2020,0,46,46,4,5,2020
19,5/7/2020,1,16,17,4,5,2020
20,5/7/2020,7,31,38,4,5,2020
21,5/7/2020,11,73,84,4,5,2020
22,5/7/2020,5,0,5,4,5,2020
23,5/7/2020,0,0,0,4,5,2020
0,5/8/2020,0,0,0,5,5,2020
1,5/8/2020,8,0,8,5,5,2020
2,5/8/2020,7,0,7,5,5,2020
3,5/8/2020,7,0,7,5,5,2020
4,5/8/2020,16,0,16,5,5,2020
5,5/8/2020,45,0,45,5,5,2020
6,5/8/2020,94,0,94,5,5,2020
7,5/8/2020,71,0,71,5,5,2020
8,5/8/2020,34,0,34,5,5,2020
9,5/8/2020,66,0,66,5,5,2020
10,5/8/2020,69,69,138,5,5,2020
11,5/8/2020,47,52,99,5,5,2020
12,5/8/2020,58,0,58,5,5,2020
13,5/8/2020,52,28,80,5,5,2020
14,5/8/2020,32,26,58,5,5,2020
15,5/8/2020,1,134,135,5,5,2020
16,5/8/2020,1,0,1,5,5,2020
17,5/8/2020,1,0,1,5,5,2020
18,5/8/2020,2,43,45,5,5,2020
19,5/8/2020,1,25,26,5,5,2020
20,5/8/2020,9,47,56,5,5,2020
21,5/8/2020,7,69,76,5,5,2020
22,5/8/2020,12,0,12,5,5,2020
23,5/8/2020,1,0,1,5,5,2020
0,5/9/2020,7,0,7,6,5,2020
1,5/9/2020,2,0,2,6,5,2020
2,5/9/2020,2,0,2,6,5,2020
3,5/9/2020,7,0,7,6,5,2020
4,5/9/2020,10,0,10,6,5,2020
5,5/9/2020,28,0,28,6,5,2020
6,5/9/2020,84,0,84,6,5,2020
7,5/9/2020,75,0,75,6,5,2020
8,5/9/2020,21,0,21,6,5,2020
9,5/9/2020,34,40,74,6,5,2020
10,5/9/2020,52,45,97,6,5,2020
11,5/9/2020,58,21,79,6,5,2020
12,5/9/2020,77,26,103,6,5,2020
13,5/9/2020,60,59,119,6,5,2020
14,5/9/2020,14,35,49,6,5,2020
15,5/9/2020,0,101,101,6,5,2020
16,5/9/2020,0,28,28,6,5,2020
17,5/9/2020,0,0,0,6,5,2020
18,5/9/2020,0,0,0,6,5,2020
19,5/9/2020,2,22,24,6,5,2020
20,5/9/2020,0,51,51,6,5,2020
21,5/9/2020,5,49,54,6,5,2020
22,5/9/2020,1,0,1,6,5,2020
23,5/9/2020,0,0,0,6,5,2020
0,5/10/2020,1,0,1,7,5,2020
1,5/10/2020,0,0,0,7,5,2020
2,5/10/2020,1,0,1,7,5,2020
3,5/10/2020,10,0,10,7,5,2020
4,5/10/2020,5,0,5,7,5,2020
5,5/10/2020,23,0,23,7,5,2020
6,5/10/2020,85,0,85,7,5,2020
7,5/10/2020,65,0,65,7,5,2020
8,5/10/2020,32,0,32,7,5,2020
9,5/10/2020,60,44,104,7,5,2020
10,5/10/2020,68,23,91,7,5,2020
11,5/10/2020,40,48,88,7,5,2020
12,5/10/2020,83,9,92,7,5,2020
13,5/10/2020,47,24,71,7,5,2020
14,5/10/2020,12,43,55,7,5,2020
15,5/10/2020,1,78,79,7,5,2020
16,5/10/2020,1,6,7,7,5,2020
17,5/10/2020,0,10,10,7,5,2020
18,5/10/2020,0,57,57,7,5,2020
19,5/10/2020,1,12,13,7,5,2020
20,5/10/2020,0,78,78,7,5,2020
21,5/10/2020,6,96,102,7,5,2020
22,5/10/2020,6,1,7,7,5,2020
23,5/10/2020,2,0,2,7,5,2020
0,5/11/2020,0,0,0,1,5,2020
1,5/11/2020,0,0,0,1,5,2020
2,5/11/2020,0,0,0,1,5,2020
3,5/11/2020,4,0,4,1,5,2020
4,5/11/2020,5,0,5,1,5,2020
5,5/11/2020,23,0,23,1,5,2020
6,5/11/2020,84,0,84,1,5,2020
7,5/11/2020,60,0,60,1,5,2020
8,5/11/2020,25,0,25,1,5,2020
9,5/11/2020,52,33,85,1,5,2020
10,5/11/2020,44,22,66,1,5,2020
11,5/11/2020,48,42,90,1,5,2020
12,5/11/2020,41,0,41,1,5,2020
13,5/11/2020,45,37,82,1,5,2020
14,5/11/2020,22,35,57,1,5,2020
15,5/11/2020,2,184,186,1,5,2020
16,5/11/2020,0,3,3,1,5,2020
17,5/11/2020,1,0,1,1,5,2020
18,5/11/2020,0,49,49,1,5,2020
19,5/11/2020,1,19,20,1,5,2020
20,5/11/2020,2,24,26,1,5,2020
21,5/11/2020,7,100,107,1,5,2020
22,5/11/2020,4,0,4,1,5,2020
23,5/11/2020,8,0,8,1,5,2020
0,5/12/2020,0,0,0,2,5,2020
1,5/12/2020,0,0,0,2,5,2020
2,5/12/2020,0,0,0,2,5,2020
3,5/12/2020,2,0,2,2,5,2020
4,5/12/2020,3,0,3,2,5,2020
5,5/12/2020,42,0,42,2,5,2020
6,5/12/2020,69,0,69,2,5,2020
7,5/12/2020,34,0,34,2,5,2020
8,5/12/2020,18,0,18,2,5,2020
9,5/12/2020,17,48,65,2,5,2020
10,5/12/2020,26,30,56,2,5,2020
11,5/12/2020,57,44,101,2,5,2020
12,5/12/2020,47,0,47,2,5,2020
13,5/12/2020,46,19,65,2,5,2020
14,5/12/2020,24,78,102,2,5,2020
15,5/12/2020,0,119,119,2,5,2020
16,5/12/2020,0,0,0,2,5,2020
17,5/12/2020,0,0,0,2,5,2020
18,5/12/2020,0,68,68,2,5,2020
19,5/12/2020,0,0,0,2,5,2020
20,5/12/2020,0,37,37,2,5,2020
21,5/12/2020,1,96,97,2,5,2020
22,5/12/2020,4,0,4,2,5,2020
23,5/12/2020,4,0,4,2,5,2020
0,5/13/2020,3,0,3,3,5,2020
1,5/13/2020,0,0,0,3,5,2020
2,5/13/2020,1,0,1,3,5,2020
3,5/13/2020,0,0,0,3,5,2020
4,5/13/2020,7,0,7,3,5,2020
5,5/13/2020,26,0,26,3,5,2020
6,5/13/2020,48,0,48,3,5,2020
7,5/13/2020,33,0,33,3,5,2020
8,5/13/2020,20,0,20,3,5,2020
9,5/13/2020,29,57,86,3,5,2020
10,5/13/2020,38,8,46,3,5,2020
11,5/13/2020,46,17,63,3,5,2020
12,5/13/2020,47,1,48,3,5,2020
13,5/13/2020,35,15,50,3,5,2020
14,5/13/2020,22,27,49,3,5,2020
15,5/13/2020,0,51,51,3,5,2020
16,5/13/2020,0,33,33,3,5,2020
17,5/13/2020,0,0,0,3,5,2020
18,5/13/2020,0,37,37,3,5,2020
19,5/13/2020,1,29,30,3,5,2020
20,5/13/2020,0,80,80,3,5,2020
21,5/13/2020,1,19,20,3,5,2020
22,5/13/2020,1,0,1,3,5,2020
23,5/13/2020,0,0,0,3,5,2020
0,5/14/2020,4,0,4,4,5,2020
1,5/14/2020,0,0,0,4,5,2020
2,5/14/2020,0,0,0,4,5,2020
3,5/14/2020,0,0,0,4,5,2020
4,5/14/2020,3,0,3,4,5,2020
5,5/14/2020,26,0,26,4,5,2020
6,5/14/2020,83,0,83,4,5,2020
7,5/14/2020,86,0,86,4,5,2020
8,5/14/2020,34,0,34,4,5,2020
9,5/14/2020,51,25,76,4,5,2020
10,5/14/2020,54,57,111,4,5,2020
11,5/14/2020,43,39,82,4,5,2020
12,5/14/2020,65,0,65,4,5,2020
13,5/14/2020,51,44,95,4,5,2020
14,5/14/2020,18,24,42,4,5,2020
15,5/14/2020,4,92,96,4,5,2020
16,5/14/2020,0,55,55,4,5,2020
17,5/14/2020,1,6,7,4,5,2020
18,5/14/2020,1,25,26,4,5,2020
19,5/14/2020,3,5,8,4,5,2020
20,5/14/2020,3,82,85,4,5,2020
21,5/14/2020,7,80,87,4,5,2020
22,5/14/2020,10,1,11,4,5,2020
23,5/14/2020,8,0,8,4,5,2020
0,5/15/2020,6,0,6,5,5,2020
1,5/15/2020,1,0,1,5,5,2020
2,5/15/2020,15,0,15,5,5,2020
3,5/15/2020,9,0,9,5,5,2020
4,5/15/2020,4,0,4,5,5,2020
5,5/15/2020,50,0,50,5,5,2020
6,5/15/2020,131,0,131,5,5,2020
7,5/15/2020,70,0,70,5,5,2020
8,5/15/2020,59,0,59,5,5,2020
9,5/15/2020,47,39,86,5,5,2020
10,5/15/2020,70,5,75,5,5,2020
11,5/15/2020,31,50,81,5,5,2020
12,5/15/2020,22,22,44,5,5,2020
13,5/15/2020,42,41,83,5,5,2020
14,5/15/2020,26,18,44,5,5,2020
15,5/15/2020,3,180,183,5,5,2020
16,5/15/2020,3,10,13,5,5,2020
17,5/15/2020,0,0,0,5,5,2020
18,5/15/2020,1,15,16,5,5,2020
19,5/15/2020,0,43,43,5,5,2020
20,5/15/2020,1,40,41,5,5,2020
21,5/15/2020,7,101,108,5,5,2020
22,5/15/2020,3,0,3,5,5,2020
23,5/15/2020,6,0,6,5,5,2020
0,5/16/2020,0,0,0,6,5,2020
1,5/16/2020,0,0,0,6,5,2020
2,5/16/2020,1,0,1,6,5,2020
3,5/16/2020,3,0,3,6,5,2020
4,5/16/2020,9,0,9,6,5,2020
5,5/16/2020,51,0,51,6,5,2020
6,5/16/2020,89,0,89,6,5,2020
7,5/16/2020,55,0,55,6,5,2020
8,5/16/2020,57,0,57,6,5,2020
9,5/16/2020,54,48,102,6,5,2020
10,5/16/2020,63,25,88,6,5,2020
11,5/16/2020,73,45,118,6,5,2020
12,5/16/2020,65,0,65,6,5,2020
13,5/16/2020,52,75,127,6,5,2020
14,5/16/2020,15,75,90,6,5,2020
15,5/16/2020,2,176,178,6,5,2020
16,5/16/2020,5,1,6,6,5,2020
17,5/16/2020,0,0,0,6,5,2020
18,5/16/2020,0,0,0,6,5,2020
19,5/16/2020,0,67,67,6,5,2020
20,5/16/2020,3,99,102,6,5,2020
21,5/16/2020,2,43,45,6,5,2020
22,5/16/2020,0,0,0,6,5,2020
23,5/16/2020,0,0,0,6,5,2020
0,5/17/2020,0,0,0,7,5,2020
1,5/17/2020,0,0,0,7,5,2020
2,5/17/2020,1,0,1,7,5,2020
3,5/17/2020,10,0,10,7,5,2020
4,5/17/2020,4,0,4,7,5,2020
5,5/17/2020,45,0,45,7,5,2020
6,5/17/2020,93,0,93,7,5,2020
7,5/17/2020,54,0,54,7,5,2020
8,5/17/2020,36,18,54,7,5,2020
9,5/17/2020,61,55,116,7,5,2020
10,5/17/2020,68,27,95,7,5,2020
11,5/17/2020,73,103,176,7,5,2020
12,5/17/2020,79,1,80,7,5,2020
13,5/17/2020,70,36,106,7,5,2020
14,5/17/2020,39,74,113,7,5,2020
15,5/17/2020,10,219,229,7,5,2020
16,5/17/2020,4,16,20,7,5,2020
17,5/17/2020,0,15,15,7,5,2020
18,5/17/2020,0,31,31,7,5,2020
19,5/17/2020,2,34,36,7,5,2020
20,5/17/2020,7,114,121,7,5,2020
21,5/17/2020,11,87,98,7,5,2020
22,5/17/2020,7,0,7,7,5,2020
23,5/17/2020,6,0,6,7,5,2020
0,5/18/2020,0,0,0,1,5,2020
1,5/18/2020,0,0,0,1,5,2020
2,5/18/2020,0,0,0,1,5,2020
3,5/18/2020,2,0,2,1,5,2020
4,5/18/2020,9,0,9,1,5,2020
5,5/18/2020,16,0,16,1,5,2020
6,5/18/2020,74,0,74,1,5,2020
7,5/18/2020,44,0,44,1,5,2020
8,5/18/2020,55,0,55,1,5,2020
9,5/18/2020,38,51,89,1,5,2020
10,5/18/2020,70,24,94,1,5,2020
11,5/18/2020,43,54,97,1,5,2020
12,5/18/2020,38,0,38,1,5,2020
13,5/18/2020,33,34,67,1,5,2020
14,5/18/2020,19,33,52,1,5,2020
15,5/18/2020,1,114,115,1,5,2020
16,5/18/2020,1,0,1,1,5,2020
17,5/18/2020,0,71,71,1,5,2020
18,5/18/2020,3,66,69,1,5,2020
19,5/18/2020,1,0,1,1,5,2020
20,5/18/2020,5,83,88,1,5,2020
21,5/18/2020,5,70,75,1,5,2020
22,5/18/2020,5,0,5,1,5,2020
23,5/18/2020,3,0,3,1,5,2020
0,5/19/2020,2,0,2,2,5,2020
1,5/19/2020,1,0,1,2,5,2020
2,5/19/2020,4,0,4,2,5,2020
3,5/19/2020,2,0,2,2,5,2020
4,5/19/2020,8,0,8,2,5,2020
5,5/19/2020,38,0,38,2,5,2020
6,5/19/2020,46,0,46,2,5,2020
7,5/19/2020,33,0,33,2,5,2020
8,5/19/2020,52,0,52,2,5,2020
9,5/19/2020,43,69,112,2,5,2020
10,5/19/2020,37,13,50,2,5,2020
11,5/19/2020,64,51,115,2,5,2020
12,5/19/2020,40,0,40,2,5,2020
13,5/19/2020,44,47,91,2,5,2020
14,5/19/2020,20,52,72,2,5,2020
15,5/19/2020,1,108,109,2,5,2020
16,5/19/2020,0,0,0,2,5,2020
17,5/19/2020,0,0,0,2,5,2020
18,5/19/2020,0,30,30,2,5,2020
19,5/19/2020,0,19,19,2,5,2020
20,5/19/2020,21,27,48,2,5,2020
21,5/19/2020,9,110,119,2,5,2020
22,5/19/2020,10,0,10,2,5,2020
23,5/19/2020,9,0,9,2,5,2020
0,5/20/2020,2,0,2,3,5,2020
1,5/20/2020,2,0,2,3,5,2020
2,5/20/2020,0,0,0,3,5,2020
3,5/20/2020,0,0,0,3,5,2020
4,5/20/2020,8,0,8,3,5,2020
5,5/20/2020,6,0,6,3,5,2020
6,5/20/2020,39,0,39,3,5,2020
7,5/20/2020,50,0,50,3,5,2020
8,5/20/2020,54,0,54,3,5,2020
9,5/20/2020,36,33,69,3,5,2020
10,5/20/2020,59,33,92,3,5,2020
11,5/20/2020,46,40,86,3,5,2020
12,5/20/2020,58,0,58,3,5,2020
13,5/20/2020,48,30,78,3,5,2020
14,5/20/2020,37,31,68,3,5,2020
15,5/20/2020,3,69,72,3,5,2020
16,5/20/2020,0,25,25,3,5,2020
17,5/20/2020,1,0,1,3,5,2020
18,5/20/2020,0,22,22,3,5,2020
19,5/20/2020,1,45,46,3,5,2020
20,5/20/2020,5,7,12,3,5,2020
21,5/20/2020,15,67,82,3,5,2020
22,5/20/2020,15,0,15,3,5,2020
23,5/20/2020,8,0,8,3,5,2020
0,5/21/2020,0,0,0,4,5,2020
1,5/21/2020,0,0,0,4,5,2020
2,5/21/2020,1,0,1,4,5,2020
3,5/21/2020,0,0,0,4,5,2020
4,5/21/2020,10,0,10,4,5,2020
5,5/21/2020,34,0,34,4,5,2020
6,5/21/2020,86,0,86,4,5,2020
7,5/21/2020,69,0,69,4,5,2020
8,5/21/2020,59,0,59,4,5,2020
9,5/21/2020,91,22,113,4,5,2020
10,5/21/2020,57,52,109,4,5,2020
11,5/21/2020,53,29,82,4,5,2020
12,5/21/2020,94,0,94,4,5,2020
13,5/21/2020,69,27,96,4,5,2020
14,5/21/2020,32,42,74,4,5,2020
15,5/21/2020,5,127,132,4,5,2020
16,5/21/2020,0,37,37,4,5,2020
17,5/21/2020,1,3,4,4,5,2020
18,5/21/2020,7,36,43,4,5,2020
19,5/21/2020,3,0,3,4,5,2020
20,5/21/2020,17,61,78,4,5,2020
21,5/21/2020,9,73,82,4,5,2020
22,5/21/2020,14,0,14,4,5,2020
23,5/21/2020,8,0,8,4,5,2020
0,5/22/2020,16,0,16,5,5,2020
1,5/22/2020,17,0,17,5,5,2020
2,5/22/2020,17,0,17,5,5,2020
3,5/22/2020,24,0,24,5,5,2020
4,5/22/2020,16,0,16,5,5,2020
5,5/22/2020,98,0,98,5,5,2020
6,5/22/2020,122,0,122,5,5,2020
7,5/22/2020,65,0,65,5,5,2020
8,5/22/2020,53,0,53,5,5,2020
9,5/22/2020,97,42,139,5,5,2020
10,5/22/2020,90,10,100,5,5,2020
11,5/22/2020,79,57,136,5,5,2020
12,5/22/2020,61,21,82,5,5,2020
13,5/22/2020,76,24,100,5,5,2020
14,5/22/2020,65,32,97,5,5,2020
15,5/22/2020,1,158,159,5,5,2020
16,5/22/2020,0,31,31,5,5,2020
17,5/22/2020,0,0,0,5,5,2020
18,5/22/2020,0,38,38,5,5,2020
19,5/22/2020,2,1,3,5,5,2020
20,5/22/2020,1,30,31,5,5,2020
21,5/22/2020,4,151,155,5,5,2020
22,5/22/2020,23,0,23,5,5,2020
23,5/22/2020,5,0,5,5,5,2020
0,5/23/2020,3,0,3,6,5,2020
1,5/23/2020,4,0,4,6,5,2020
2,5/23/2020,10,0,10,6,5,2020
3,5/23/2020,1,0,1,6,5,2020
4,5/23/2020,7,0,7,6,5,2020
5,5/23/2020,52,0,52,6,5,2020
6,5/23/2020,84,0,84,6,5,2020
7,5/23/2020,110,0,110,6,5,2020
8,5/23/2020,71,0,71,6,5,2020
9,5/23/2020,72,4,76,6,5,2020
10,5/23/2020,51,88,139,6,5,2020
11,5/23/2020,68,66,134,6,5,2020
12,5/23/2020,88,2,90,6,5,2020
13,5/23/2020,68,41,109,6,5,2020
14,5/23/2020,58,53,111,6,5,2020
15,5/23/2020,3,217,220,6,5,2020
16,5/23/2020,2,2,4,6,5,2020
17,5/23/2020,2,0,2,6,5,2020
18,5/23/2020,0,69,69,6,5,2020
19,5/23/2020,2,37,39,6,5,2020
20,5/23/2020,12,38,50,6,5,2020
21,5/23/2020,9,68,77,6,5,2020
22,5/23/2020,11,0,11,6,5,2020
23,5/23/2020,0,0,0,6,5,2020
0,5/24/2020,1,0,1,7,5,2020
1,5/24/2020,2,0,2,7,5,2020
2,5/24/2020,1,0,1,7,5,2020
3,5/24/2020,0,0,0,7,5,2020
4,5/24/2020,14,0,14,7,5,2020
5,5/24/2020,50,0,50,7,5,2020
6,5/24/2020,104,0,104,7,5,2020
7,5/24/2020,89,0,89,7,5,2020
8,5/24/2020,71,0,71,7,5,2020
9,5/24/2020,108,48,156,7,5,2020
10,5/24/2020,94,17,111,7,5,2020
11,5/24/2020,90,64,154,7,5,2020
12,5/24/2020,102,35,137,7,5,2020
13,5/24/2020,81,34,115,7,5,2020
14,5/24/2020,58,100,158,7,5,2020
15,5/24/2020,3,259,262,7,5,2020
16,5/24/2020,0,42,42,7,5,2020
17,5/24/2020,0,0,0,7,5,2020
18,5/24/2020,12,66,78,7,5,2020
19,5/24/2020,9,3,12,7,5,2020
20,5/24/2020,3,41,44,7,5,2020
21,5/24/2020,0,167,167,7,5,2020
22,5/24/2020,6,0,6,7,5,2020
23,5/24/2020,3,0,3,7,5,2020
0,5/25/2020,0,0,0,1,5,2020
1,5/25/2020,0,0,0,1,5,2020
2,5/25/2020,4,0,4,1,5,2020
3,5/25/2020,1,0,1,1,5,2020
4,5/25/2020,11,0,11,1,5,2020
5,5/25/2020,52,0,52,1,5,2020
6,5/25/2020,87,0,87,1,5,2020
7,5/25/2020,52,0,52,1,5,2020
8,5/25/2020,52,0,52,1,5,2020
9,5/25/2020,69,66,135,1,5,2020
10,5/25/2020,78,26,104,1,5,2020
11,5/25/2020,58,90,148,1,5,2020
12,5/25/2020,39,30,69,1,5,2020
13,5/25/2020,39,37,76,1,5,2020
14,5/25/2020,20,56,76,1,5,2020
15,5/25/2020,1,260,261,1,5,2020
16,5/25/2020,1,26,27,1,5,2020
17,5/25/2020,4,14,18,1,5,2020
18,5/25/2020,2,67,69,1,5,2020
19,5/25/2020,0,0,0,1,5,2020
20,5/25/2020,3,93,96,1,5,2020
21,5/25/2020,9,127,136,1,5,2020
22,5/25/2020,19,0,19,1,5,2020
23,5/25/2020,19,0,19,1,5,2020
0,5/26/2020,1,0,1,2,5,2020
1,5/26/2020,0,0,0,2,5,2020
2,5/26/2020,1,0,1,2,5,2020
3,5/26/2020,7,0,7,2,5,2020
4,5/26/2020,18,0,18,2,5,2020
5,5/26/2020,42,0,42,2,5,2020
6,5/26/2020,67,0,67,2,5,2020
7,5/26/2020,79,0,79,2,5,2020
8,5/26/2020,55,0,55,2,5,2020
9,5/26/2020,49,0,49,2,5,2020
10,5/26/2020,61,93,154,2,5,2020
11,5/26/2020,67,58,125,2,5,2020
12,5/26/2020,55,67,122,2,5,2020
13,5/26/2020,61,56,117,2,5,2020
14,5/26/2020,18,47,65,2,5,2020
15,5/26/2020,0,207,207,2,5,2020
16,5/26/2020,0,0,0,2,5,2020
17,5/26/2020,7,0,7,2,5,2020
18,5/26/2020,0,33,33,2,5,2020
19,5/26/2020,0,37,37,2,5,2020
20,5/26/2020,6,54,60,2,5,2020
21,5/26/2020,15,73,88,2,5,2020
22,5/26/2020,5,0,5,2,5,2020
23,5/26/2020,1,0,1,2,5,2020
0,5/27/2020,0,0,0,3,5,2020
1,5/27/2020,1,0,1,3,5,2020
2,5/27/2020,1,0,1,3,5,2020
3,5/27/2020,4,0,4,3,5,2020
4,5/27/2020,21,0,21,3,5,2020
5,5/27/2020,39,0,39,3,5,2020
6,5/27/2020,64,0,64,3,5,2020
7,5/27/2020,59,0,59,3,5,2020
8,5/27/2020,51,0,51,3,5,2020
9,5/27/2020,39,0,39,3,5,2020
10,5/27/2020,51,64,115,3,5,2020
11,5/27/2020,22,47,69,3,5,2020
12,5/27/2020,39,3,42,3,5,2020
13,5/27/2020,23,17,40,3,5,2020
14,5/27/2020,37,6,43,3,5,2020
15,5/27/2020,4,178,182,3,5,2020
16,5/27/2020,2,10,12,3,5,2020
17,5/27/2020,0,10,10,3,5,2020
18,5/27/2020,1,33,34,3,5,2020
19,5/27/2020,0,70,70,3,5,2020
20,5/27/2020,4,40,44,3,5,2020
21,5/27/2020,7,11,18,3,5,2020
22,5/27/2020,10,0,10,3,5,2020
23,5/27/2020,14,0,14,3,5,2020
0,5/28/2020,1,0,1,4,5,2020
1,5/28/2020,0,0,0,4,5,2020
2,5/28/2020,1,0,1,4,5,2020
3,5/28/2020,3,0,3,4,5,2020
4,5/28/2020,9,0,9,4,5,2020
5,5/28/2020,78,0,78,4,5,2020
6,5/28/2020,121,0,121,4,5,2020
7,5/28/2020,64,0,64,4,5,2020
8,5/28/2020,100,0,100,4,5,2020
9,5/28/2020,69,37,106,4,5,2020
10,5/28/2020,73,29,102,4,5,2020
11,5/28/2020,75,34,109,4,5,2020
12,5/28/2020,75,58,133,4,5,2020
13,5/28/2020,52,47,99,4,5,2020
14,5/28/2020,46,33,79,4,5,2020
15,5/28/2020,1,126,127,4,5,2020
16,5/28/2020,1,63,64,4,5,2020
17,5/28/2020,2,19,21,4,5,2020
18,5/28/2020,0,24,24,4,5,2020
19,5/28/2020,0,21,21,4,5,2020
20,5/28/2020,8,11,19,4,5,2020
21,5/28/2020,7,116,123,4,5,2020
22,5/28/2020,28,0,28,4,5,2020
23,5/28/2020,6,0,6,4,5,2020
0,5/29/2020,13,0,13,5,5,2020
1,5/29/2020,16,0,16,5,5,2020
2,5/29/2020,17,0,17,5,5,2020
3,5/29/2020,16,0,16,5,5,2020
4,5/29/2020,12,0,12,5,5,2020
5,5/29/2020,60,0,60,5,5,2020
6,5/29/2020,122,0,122,5,5,2020
7,5/29/2020,68,0,68,5,5,2020
8,5/29/2020,59,0,59,5,5,2020
9,5/29/2020,56,28,84,5,5,2020
10,5/29/2020,101,9,110,5,5,2020
11,5/29/2020,39,70,109,5,5,2020
12,5/29/2020,64,45,109,5,5,2020
13,5/29/2020,47,30,77,5,5,2020
14,5/29/2020,26,81,107,5,5,2020
15,5/29/2020,1,117,118,5,5,2020
16,5/29/2020,0,25,25,5,5,2020
17,5/29/2020,0,9,9,5,5,2020
18,5/29/2020,0,0,0,5,5,2020
19,5/29/2020,2,85,87,5,5,2020
20,5/29/2020,6,93,99,5,5,2020
21,5/29/2020,12,33,45,5,5,2020
22,5/29/2020,17,3,20,5,5,2020
23,5/29/2020,3,0,3,5,5,2020
0,5/30/2020,0,0,0,6,5,2020
1,5/30/2020,0,0,0,6,5,2020
2,5/30/2020,0,0,0,6,5,2020
3,5/30/2020,5,0,5,6,5,2020
4,5/30/2020,15,0,15,6,5,2020
5,5/30/2020,41,0,41,6,5,2020
6,5/30/2020,139,0,139,6,5,2020
7,5/30/2020,135,0,135,6,5,2020
8,5/30/2020,103,0,103,6,5,2020
9,5/30/2020,96,54,150,6,5,2020
10,5/30/2020,91,14,105,6,5,2020
11,5/30/2020,55,58,113,6,5,2020
12,5/30/2020,82,65,147,6,5,2020
13,5/30/2020,70,32,102,6,5,2020
14,5/30/2020,35,95,130,6,5,2020
15,5/30/2020,2,192,194,6,5,2020
16,5/30/2020,0,74,74,6,5,2020
17,5/30/2020,2,0,2,6,5,2020
18,5/30/2020,0,29,29,6,5,2020
19,5/30/2020,3,77,80,6,5,2020
20,5/30/2020,3,26,29,6,5,2020
21,5/30/2020,11,52,63,6,5,2020
22,5/30/2020,4,0,4,6,5,2020
23,5/30/2020,3,0,3,6,5,2020
0,5/31/2020,0,0,0,7,5,2020
1,5/31/2020,0,0,0,7,5,2020
2,5/31/2020,0,0,0,7,5,2020
3,5/31/2020,1,0,1,7,5,2020
4,5/31/2020,10,0,10,7,5,2020
5,5/31/2020,57,0,57,7,5,2020
6,5/31/2020,115,0,115,7,5,2020
7,5/31/2020,56,0,56,7,5,2020
8,5/31/2020,64,0,64,7,5,2020
9,5/31/2020,87,59,146,7,5,2020
10,5/31/2020,100,10,110,7,5,2020
11,5/31/2020,73,67,140,7,5,2020
12,5/31/2020,64,74,138,7,5,2020
13,5/31/2020,66,57,123,7,5,2020
14,5/31/2020,44,102,146,7,5,2020
15,5/31/2020,1,200,201,7,5,2020
16,5/31/2020,0,15,15,7,5,2020
17,5/31/2020,7,0,7,7,5,2020
18,5/31/2020,1,55,56,7,5,2020
19,5/31/2020,11,114,125,7,5,2020
20,5/31/2020,21,111,132,7,5,2020
21,5/31/2020,13,74,87,7,5,2020
22,5/31/2020,30,50,80,7,5,2020
23,5/31/2020,22,4,26,7,5,2020
0,6/1/2020,18,0,18,1,6,2020
1,6/1/2020,17,0,17,1,6,2020
2,6/1/2020,17,0,17,1,6,2020
3,6/1/2020,19,0,19,1,6,2020
4,6/1/2020,41,0,41,1,6,2020
5,6/1/2020,111,0,111,1,6,2020
6,6/1/2020,123,0,123,1,6,2020
7,6/1/2020,89,0,89,1,6,2020
8,6/1/2020,75,100,175,1,6,2020
9,6/1/2020,116,40,156,1,6,2020
10,6/1/2020,97,3,100,1,6,2020
11,6/1/2020,87,99,186,1,6,2020
12,6/1/2020,80,122,202,1,6,2020
13,6/1/2020,70,48,118,1,6,2020
14,6/1/2020,81,84,165,1,6,2020
15,6/1/2020,26,213,239,1,6,2020
16,6/1/2020,6,85,91,1,6,2020
17,6/1/2020,1,0,1,1,6,2020
18,6/1/2020,5,36,41,1,6,2020
19,6/1/2020,12,59,71,1,6,2020
20,6/1/2020,30,114,144,1,6,2020
21,6/1/2020,23,131,154,1,6,2020
22,6/1/2020,24,35,59,1,6,2020
23,6/1/2020,6,1,7,1,6,2020
0,6/2/2020,4,0,4,2,6,2020
1,6/2/2020,5,0,5,2,6,2020
2,6/2/2020,51,0,51,2,6,2020
3,6/2/2020,24,0,24,2,6,2020
4,6/2/2020,44,0,44,2,6,2020
5,6/2/2020,124,0,124,2,6,2020
6,6/2/2020,116,0,116,2,6,2020
7,6/2/2020,81,0,81,2,6,2020
8,6/2/2020,63,32,95,2,6,2020
9,6/2/2020,65,47,112,2,6,2020
10,6/2/2020,104,0,104,2,6,2020
11,6/2/2020,77,90,167,2,6,2020
12,6/2/2020,98,75,173,2,6,2020
13,6/2/2020,87,40,127,2,6,2020
14,6/2/2020,19,107,126,2,6,2020
15,6/2/2020,8,140,148,2,6,2020
16,6/2/2020,13,75,88,2,6,2020
17,6/2/2020,6,0,6,2,6,2020
18,6/2/2020,8,31,39,2,6,2020
19,6/2/2020,14,85,99,2,6,2020
20,6/2/2020,26,65,91,2,6,2020
21,6/2/2020,40,95,135,2,6,2020
22,6/2/2020,14,29,43,2,6,2020
23,6/2/2020,3,30,33,2,6,2020
0,6/3/2020,7,0,7,3,6,2020
1,6/3/2020,8,0,8,3,6,2020
2,6/3/2020,2,0,2,3,6,2020
3,6/3/2020,3,0,3,3,6,2020
4,6/3/2020,30,0,30,3,6,2020
5,6/3/2020,79,0,79,3,6,2020
6,6/3/2020,129,0,129,3,6,2020
7,6/3/2020,126,0,126,3,6,2020
8,6/3/2020,99,26,125,3,6,2020
9,6/3/2020,86,43,129,3,6,2020
10,6/3/2020,83,2,85,3,6,2020
11,6/3/2020,58,91,149,3,6,2020
12,6/3/2020,51,5,56,3,6,2020
13,6/3/2020,76,22,98,3,6,2020
14,6/3/2020,48,42,90,3,6,2020
15,6/3/2020,21,213,234,3,6,2020
16,6/3/2020,12,77,89,3,6,2020
17,6/3/2020,19,0,19,3,6,2020
18,6/3/2020,8,35,43,3,6,2020
19,6/3/2020,5,82,87,3,6,2020
20,6/3/2020,48,19,67,3,6,2020
21,6/3/2020,55,55,110,3,6,2020
22,6/3/2020,52,41,93,3,6,2020
23,6/3/2020,6,15,21,3,6,2020
0,6/4/2020,1,0,1,4,6,2020
1,6/4/2020,9,0,9,4,6,2020
2,6/4/2020,9,0,9,4,6,2020
3,6/4/2020,38,0,38,4,6,2020
4,6/4/2020,69,0,69,4,6,2020
5,6/4/2020,125,0,125,4,6,2020
6,6/4/2020,141,0,141,4,6,2020
7,6/4/2020,97,0,97,4,6,2020
8,6/4/2020,156,8,164,4,6,2020
9,6/4/2020,83,32,115,4,6,2020
10,6/4/2020,118,2,120,4,6,2020
11,6/4/2020,72,88,160,4,6,2020
12,6/4/2020,103,28,131,4,6,2020
13,6/4/2020,86,14,100,4,6,2020
14,6/4/2020,38,97,135,4,6,2020
15,6/4/2020,13,68,81,4,6,2020
16,6/4/2020,12,182,194,4,6,2020
17,6/4/2020,20,2,22,4,6,2020
18,6/4/2020,9,47,56,4,6,2020
19,6/4/2020,23,53,76,4,6,2020
20,6/4/2020,32,50,82,4,6,2020
21,6/4/2020,58,47,105,4,6,2020
22,6/4/2020,47,18,65,4,6,2020
23,6/4/2020,28,17,45,4,6,2020
0,6/5/2020,11,0,11,5,6,2020
1,6/5/2020,5,0,5,5,6,2020
2,6/5/2020,22,0,22,5,6,2020
3,6/5/2020,33,0,33,5,6,2020
4,6/5/2020,97,0,97,5,6,2020
5,6/5/2020,155,0,155,5,6,2020
6,6/5/2020,134,0,134,5,6,2020
7,6/5/2020,170,0,170,5,6,2020
8,6/5/2020,76,77,153,5,6,2020
9,6/5/2020,88,16,104,5,6,2020
10,6/5/2020,106,17,123,5,6,2020
11,6/5/2020,76,71,147,5,6,2020
12,6/5/2020,98,32,130,5,6,2020
13,6/5/2020,124,44,168,5,6,2020
14,6/5/2020,73,128,201,5,6,2020
15,6/5/2020,9,130,139,5,6,2020
16,6/5/2020,14,28,42,5,6,2020
17,6/5/2020,18,0,18,5,6,2020
18,6/5/2020,6,30,36,5,6,2020
19,6/5/2020,16,57,73,5,6,2020
20,6/5/2020,39,19,58,5,6,2020
21,6/5/2020,66,63,129,5,6,2020
22,6/5/2020,25,62,87,5,6,2020
23,6/5/2020,10,19,29,5,6,2020
0,6/6/2020,11,0,11,6,6,2020
1,6/6/2020,5,0,5,6,6,2020
2,6/6/2020,12,0,12,6,6,2020
3,6/6/2020,13,0,13,6,6,2020
4,6/6/2020,57,0,57,6,6,2020
5,6/6/2020,162,0,162,6,6,2020
6,6/6/2020,153,0,153,6,6,2020
7,6/6/2020,153,0,153,6,6,2020
8,6/6/2020,141,20,161,6,6,2020
9,6/6/2020,133,33,166,6,6,2020
10,6/6/2020,162,0,162,6,6,2020
11,6/6/2020,84,143,227,6,6,2020
12,6/6/2020,110,47,157,6,6,2020
13,6/6/2020,110,74,184,6,6,2020
14,6/6/2020,80,117,197,6,6,2020
15,6/6/2020,26,190,216,6,6,2020
16,6/6/2020,23,168,191,6,6,2020
17,6/6/2020,8,53,61,6,6,2020
18,6/6/2020,13,47,60,6,6,2020
19,6/6/2020,8,61,69,6,6,2020
20,6/6/2020,27,111,138,6,6,2020
21,6/6/2020,40,70,110,6,6,2020
22,6/6/2020,20,47,67,6,6,2020
23,6/6/2020,3,20,23,6,6,2020
0,6/7/2020,1,0,1,7,6,2020
1,6/7/2020,10,0,10,7,6,2020
2,6/7/2020,14,0,14,7,6,2020
3,6/7/2020,29,0,29,7,6,2020
4,6/7/2020,44,0,44,7,6,2020
5,6/7/2020,135,0,135,7,6,2020
6,6/7/2020,150,0,150,7,6,2020
7,6/7/2020,125,0,125,7,6,2020
8,6/7/2020,111,69,180,7,6,2020
9,6/7/2020,139,60,199,7,6,2020
10,6/7/2020,113,25,138,7,6,2020
11,6/7/2020,79,123,202,7,6,2020
12,6/7/2020,76,35,111,7,6,2020
13,6/7/2020,116,80,196,7,6,2020
14,6/7/2020,74,205,279,7,6,2020
15,6/7/2020,27,221,248,7,6,2020
16,6/7/2020,25,152,177,7,6,2020
17,6/7/2020,13,11,24,7,6,2020
18,6/7/2020,18,140,158,7,6,2020
19,6/7/2020,9,51,60,7,6,2020
20,6/7/2020,23,55,78,7,6,2020
21,6/7/2020,53,93,146,7,6,2020
22,6/7/2020,26,39,65,7,6,2020
23,6/7/2020,52,84,136,7,6,2020
0,6/8/2020,20,0,20,1,6,2020
1,6/8/2020,15,0,15,1,6,2020
2,6/8/2020,10,0,10,1,6,2020
3,6/8/2020,26,0,26,1,6,2020
4,6/8/2020,93,0,93,1,6,2020
5,6/8/2020,85,0,85,1,6,2020
6,6/8/2020,124,0,124,1,6,2020
7,6/8/2020,84,0,84,1,6,2020
8,6/8/2020,46,80,126,1,6,2020
9,6/8/2020,57,54,111,1,6,2020
10,6/8/2020,51,6,57,1,6,2020
11,6/8/2020,55,131,186,1,6,2020
12,6/8/2020,72,54,126,1,6,2020
13,6/8/2020,71,86,157,1,6,2020
14,6/8/2020,20,140,160,1,6,2020
15,6/8/2020,11,159,170,1,6,2020
16,6/8/2020,13,90,103,1,6,2020
17,6/8/2020,7,0,7,1,6,2020
18,6/8/2020,11,53,64,1,6,2020
19,6/8/2020,2,95,97,1,6,2020
20,6/8/2020,35,85,120,1,6,2020
21,6/8/2020,38,53,91,1,6,2020
22,6/8/2020,29,46,75,1,6,2020
23,6/8/2020,2,41,43,1,6,2020
0,6/9/2020,5,0,5,2,6,2020
1,6/9/2020,10,0,10,2,6,2020
2,6/9/2020,16,0,16,2,6,2020
3,6/9/2020,16,0,16,2,6,2020
4,6/9/2020,54,0,54,2,6,2020
5,6/9/2020,123,0,123,2,6,2020
6,6/9/2020,104,0,104,2,6,2020
7,6/9/2020,99,0,99,2,6,2020
8,6/9/2020,58,28,86,2,6,2020
9,6/9/2020,106,35,141,2,6,2020
10,6/9/2020,72,3,75,2,6,2020
11,6/9/2020,70,85,155,2,6,2020
12,6/9/2020,69,86,155,2,6,2020
13,6/9/2020,78,76,154,2,6,2020
14,6/9/2020,35,91,126,2,6,2020
15,6/9/2020,12,113,125,2,6,2020
16,6/9/2020,6,22,28,2,6,2020
17,6/9/2020,1,1,2,2,6,2020
18,6/9/2020,3,50,53,2,6,2020
19,6/9/2020,18,31,49,2,6,2020
20,6/9/2020,28,70,98,2,6,2020
21,6/9/2020,55,45,100,2,6,2020
22,6/9/2020,43,25,68,2,6,2020
23,6/9/2020,10,31,41,2,6,2020
0,6/10/2020,0,0,0,3,6,2020
1,6/10/2020,4,0,4,3,6,2020
2,6/10/2020,3,0,3,3,6,2020
3,6/10/2020,7,0,7,3,6,2020
4,6/10/2020,19,0,19,3,6,2020
5,6/10/2020,68,0,68,3,6,2020
6,6/10/2020,168,0,168,3,6,2020
7,6/10/2020,85,0,85,3,6,2020
8,6/10/2020,93,33,126,3,6,2020
9,6/10/2020,79,57,136,3,6,2020
10,6/10/2020,116,32,148,3,6,2020
11,6/10/2020,56,89,145,3,6,2020
12,6/10/2020,43,14,57,3,6,2020
13,6/10/2020,63,26,89,3,6,2020
14,6/10/2020,51,85,136,3,6,2020
15,6/10/2020,11,119,130,3,6,2020
16,6/10/2020,13,61,74,3,6,2020
17,6/10/2020,3,7,10,3,6,2020
18,6/10/2020,2,43,45,3,6,2020
19,6/10/2020,12,46,58,3,6,2020
20,6/10/2020,33,51,84,3,6,2020
21,6/10/2020,63,79,142,3,6,2020
22,6/10/2020,33,9,42,3,6,2020
23,6/10/2020,11,25,36,3,6,2020
0,6/11/2020,3,0,3,4,6,2020
1,6/11/2020,3,0,3,4,6,2020
2,6/11/2020,20,0,20,4,6,2020
3,6/11/2020,29,0,29,4,6,2020
4,6/11/2020,62,0,62,4,6,2020
5,6/11/2020,115,0,115,4,6,2020
6,6/11/2020,193,0,193,4,6,2020
7,6/11/2020,138,0,138,4,6,2020
8,6/11/2020,109,18,127,4,6,2020
9,6/11/2020,93,34,127,4,6,2020
10,6/11/2020,84,12,96,4,6,2020
11,6/11/2020,100,47,147,4,6,2020
12,6/11/2020,99,32,131,4,6,2020
13,6/11/2020,75,135,210,4,6,2020
14,6/11/2020,39,82,121,4,6,2020
15,6/11/2020,22,132,154,4,6,2020
16,6/11/2020,23,35,58,4,6,2020
17,6/11/2020,9,3,12,4,6,2020
18,6/11/2020,4,51,55,4,6,2020
19,6/11/2020,26,28,54,4,6,2020
20,6/11/2020,46,52,98,4,6,2020
21,6/11/2020,83,52,135,4,6,2020
22,6/11/2020,96,11,107,4,6,2020
23,6/11/2020,19,21,40,4,6,2020
0,6/12/2020,23,0,23,5,6,2020
1,6/12/2020,7,0,7,5,6,2020
2,6/12/2020,47,0,47,5,6,2020
3,6/12/2020,44,0,44,5,6,2020
4,6/12/2020,102,0,102,5,6,2020
5,6/12/2020,124,0,124,5,6,2020
6,6/12/2020,221,0,221,5,6,2020
7,6/12/2020,145,0,145,5,6,2020
8,6/12/2020,82,66,148,5,6,2020
9,6/12/2020,101,23,124,5,6,2020
10,6/12/2020,102,10,112,5,6,2020
11,6/12/2020,89,67,156,5,6,2020
12,6/12/2020,95,46,141,5,6,2020
13,6/12/2020,131,29,160,5,6,2020
14,6/12/2020,72,137,209,5,6,2020
15,6/12/2020,28,144,172,5,6,2020
16,6/12/2020,26,30,56,5,6,2020
17,6/12/2020,29,8,37,5,6,2020
18,6/12/2020,13,82,95,5,6,2020
19,6/12/2020,6,64,70,5,6,2020
20,6/12/2020,41,33,74,5,6,2020
21,6/12/2020,60,83,143,5,6,2020
22,6/12/2020,33,11,44,5,6,2020
23,6/12/2020,4,45,49,5,6,2020
0,6/13/2020,3,0,3,6,6,2020
1,6/13/2020,2,0,2,6,6,2020
2,6/13/2020,12,0,12,6,6,2020
3,6/13/2020,48,0,48,6,6,2020
4,6/13/2020,73,0,73,6,6,2020
5,6/13/2020,148,0,148,6,6,2020
6,6/13/2020,215,0,215,6,6,2020
7,6/13/2020,140,0,140,6,6,2020
8,6/13/2020,154,33,187,6,6,2020
9,6/13/2020,167,65,232,6,6,2020
10,6/13/2020,132,25,157,6,6,2020
11,6/13/2020,133,71,204,6,6,2020
12,6/13/2020,93,107,200,6,6,2020
13,6/13/2020,82,76,158,6,6,2020
14,6/13/2020,52,197,249,6,6,2020
15,6/13/2020,9,152,161,6,6,2020
16,6/13/2020,11,155,166,6,6,2020
17,6/13/2020,10,14,24,6,6,2020
18,6/13/2020,15,24,39,6,6,2020
19,6/13/2020,18,62,80,6,6,2020
20,6/13/2020,31,114,145,6,6,2020
21,6/13/2020,52,102,154,6,6,2020
22,6/13/2020,24,33,57,6,6,2020
23,6/13/2020,3,47,50,6,6,2020
0,6/14/2020,0,0,0,7,6,2020
1,6/14/2020,27,0,27,7,6,2020
2,6/14/2020,4,0,4,7,6,2020
3,6/14/2020,20,0,20,7,6,2020
4,6/14/2020,71,0,71,7,6,2020
5,6/14/2020,111,0,111,7,6,2020
6,6/14/2020,181,0,181,7,6,2020
7,6/14/2020,164,3,167,7,6,2020
8,6/14/2020,173,29,202,7,6,2020
9,6/14/2020,158,52,210,7,6,2020
10,6/14/2020,157,28,185,7,6,2020
11,6/14/2020,97,118,215,7,6,2020
12,6/14/2020,116,33,149,7,6,2020
13,6/14/2020,108,60,168,7,6,2020
14,6/14/2020,39,203,242,7,6,2020
15,6/14/2020,13,205,218,7,6,2020
16,6/14/2020,16,193,209,7,6,2020
17,6/14/2020,13,36,49,7,6,2020
18,6/14/2020,4,101,105,7,6,2020
19,6/14/2020,13,98,111,7,6,2020
20,6/14/2020,45,73,118,7,6,2020
21,6/14/2020,47,52,99,7,6,2020
22,6/14/2020,50,92,142,7,6,2020
23,6/14/2020,30,82,112,7,6,2020
0,6/15/2020,9,0,9,1,6,2020
1,6/15/2020,3,0,3,1,6,2020
2,6/15/2020,11,0,11,1,6,2020
3,6/15/2020,60,0,60,1,6,2020
4,6/15/2020,80,0,80,1,6,2020
5,6/15/2020,111,0,111,1,6,2020
6,6/15/2020,150,0,150,1,6,2020
7,6/15/2020,105,0,105,1,6,2020
8,6/15/2020,65,106,171,1,6,2020
9,6/15/2020,66,76,142,1,6,2020
10,6/15/2020,71,31,102,1,6,2020
11,6/15/2020,94,99,193,1,6,2020
12,6/15/2020,95,96,191,1,6,2020
13,6/15/2020,92,58,150,1,6,2020
14,6/15/2020,63,137,200,1,6,2020
15,6/15/2020,22,205,227,1,6,2020
16,6/15/2020,18,135,153,1,6,2020
17,6/15/2020,17,0,17,1,6,2020
18,6/15/2020,13,61,74,1,6,2020
19,6/15/2020,29,60,89,1,6,2020
20,6/15/2020,44,155,199,1,6,2020
21,6/15/2020,72,73,145,1,6,2020
22,6/15/2020,35,22,57,1,6,2020
23,6/15/2020,2,62,64,1,6,2020
0,6/16/2020,0,0,0,2,6,2020
1,6/16/2020,6,0,6,2,6,2020
2,6/16/2020,8,0,8,2,6,2020
3,6/16/2020,26,0,26,2,6,2020
4,6/16/2020,65,0,65,2,6,2020
5,6/16/2020,126,0,126,2,6,2020
6,6/16/2020,107,0,107,2,6,2020
7,6/16/2020,83,0,83,2,6,2020
8,6/16/2020,84,26,110,2,6,2020
9,6/16/2020,94,46,140,2,6,2020
10,6/16/2020,113,11,124,2,6,2020
11,6/16/2020,102,80,182,2,6,2020
12,6/16/2020,78,27,105,2,6,2020
13,6/16/2020,81,96,177,2,6,2020
14,6/16/2020,39,121,160,2,6,2020
15,6/16/2020,9,151,160,2,6,2020
16,6/16/2020,13,75,88,2,6,2020
17,6/16/2020,4,30,34,2,6,2020
18,6/16/2020,19,30,49,2,6,2020
19,6/16/2020,15,56,71,2,6,2020
20,6/16/2020,36,71,107,2,6,2020
21,6/16/2020,61,122,183,2,6,2020
22,6/16/2020,51,17,68,2,6,2020
23,6/16/2020,38,46,84,2,6,2020
0,6/17/2020,20,0,20,3,6,2020
1,6/17/2020,26,0,26,3,6,2020
2,6/17/2020,20,0,20,3,6,2020
3,6/17/2020,18,0,18,3,6,2020
4,6/17/2020,47,0,47,3,6,2020
5,6/17/2020,113,0,113,3,6,2020
6,6/17/2020,167,0,167,3,6,2020
7,6/17/2020,160,0,160,3,6,2020
8,6/17/2020,119,88,207,3,6,2020
9,6/17/2020,102,31,133,3,6,2020
10,6/17/2020,91,12,103,3,6,2020
11,6/17/2020,83,99,182,3,6,2020
12,6/17/2020,74,9,83,3,6,2020
13,6/17/2020,58,27,85,3,6,2020
14,6/17/2020,47,108,155,3,6,2020
15,6/17/2020,19,134,153,3,6,2020
16,6/17/2020,11,111,122,3,6,2020
17,6/17/2020,9,32,41,3,6,2020
18,6/17/2020,23,47,70,3,6,2020
19,6/17/2020,27,86,113,3,6,2020
20,6/17/2020,53,49,102,3,6,2020
21,6/17/2020,67,38,105,3,6,2020
22,6/17/2020,82,25,107,3,6,2020
23,6/17/2020,44,29,73,3,6,2020
0,6/18/2020,32,0,32,4,6,2020
1,6/18/2020,25,0,25,4,6,2020
2,6/18/2020,17,0,17,4,6,2020
3,6/18/2020,22,0,22,4,6,2020
4,6/18/2020,74,0,74,4,6,2020
5,6/18/2020,135,0,135,4,6,2020
6,6/18/2020,208,0,208,4,6,2020
7,6/18/2020,119,0,119,4,6,2020
8,6/18/2020,137,28,165,4,6,2020
9,6/18/2020,122,32,154,4,6,2020
10,6/18/2020,140,19,159,4,6,2020
11,6/18/2020,60,62,122,4,6,2020
12,6/18/2020,110,12,122,4,6,2020
13,6/18/2020,117,135,252,4,6,2020
14,6/18/2020,69,89,158,4,6,2020
15,6/18/2020,38,99,137,4,6,2020
16,6/18/2020,43,89,132,4,6,2020
17,6/18/2020,22,25,47,4,6,2020
18,6/18/2020,24,50,74,4,6,2020
19,6/18/2020,30,53,83,4,6,2020
20,6/18/2020,76,31,107,4,6,2020
21,6/18/2020,147,47,194,4,6,2020
22,6/18/2020,128,1,129,4,6,2020
23,6/18/2020,124,17,141,4,6,2020
0,6/19/2020,78,0,78,5,6,2020
1,6/19/2020,27,0,27,5,6,2020
2,6/19/2020,16,0,16,5,6,2020
3,6/19/2020,43,0,43,5,6,2020
4,6/19/2020,127,0,127,5,6,2020
5,6/19/2020,188,0,188,5,6,2020
6,6/19/2020,150,0,150,5,6,2020
7,6/19/2020,209,0,209,5,6,2020
8,6/19/2020,164,120,284,5,6,2020
9,6/19/2020,106,53,159,5,6,2020
10,6/19/2020,104,33,137,5,6,2020
11,6/19/2020,81,71,152,5,6,2020
12,6/19/2020,119,56,175,5,6,2020
13,6/19/2020,155,118,273,5,6,2020
14,6/19/2020,106,97,203,5,6,2020
15,6/19/2020,103,106,209,5,6,2020
16,6/19/2020,90,87,177,5,6,2020
17,6/19/2020,31,84,115,5,6,2020
18,6/19/2020,11,81,92,5,6,2020
19,6/19/2020,18,50,68,5,6,2020
20,6/19/2020,50,25,75,5,6,2020
21,6/19/2020,131,79,210,5,6,2020
22,6/19/2020,110,48,158,5,6,2020
23,6/19/2020,83,17,100,5,6,2020
0,6/20/2020,29,0,29,6,6,2020
1,6/20/2020,24,0,24,6,6,2020
2,6/20/2020,29,0,29,6,6,2020
3,6/20/2020,59,0,59,6,6,2020
4,6/20/2020,110,0,110,6,6,2020
5,6/20/2020,168,0,168,6,6,2020
6,6/20/2020,228,0,228,6,6,2020
7,6/20/2020,163,0,163,6,6,2020
8,6/20/2020,151,65,216,6,6,2020
9,6/20/2020,241,120,361,6,6,2020
10,6/20/2020,234,31,265,6,6,2020
11,6/20/2020,135,137,272,6,6,2020
12,6/20/2020,124,35,159,6,6,2020
13,6/20/2020,155,104,259,6,6,2020
14,6/20/2020,112,219,331,6,6,2020
15,6/20/2020,51,165,216,6,6,2020
16,6/20/2020,65,133,198,6,6,2020
17,6/20/2020,12,99,111,6,6,2020
18,6/20/2020,19,65,84,6,6,2020
19,6/20/2020,23,148,171,6,6,2020
20,6/20/2020,63,151,214,6,6,2020
21,6/20/2020,111,86,197,6,6,2020
22,6/20/2020,102,55,157,6,6,2020
23,6/20/2020,100,33,133,6,6,2020
0,6/21/2020,56,0,56,7,6,2020
1,6/21/2020,25,0,25,7,6,2020
2,6/21/2020,50,0,50,7,6,2020
3,6/21/2020,68,0,68,7,6,2020
4,6/21/2020,60,0,60,7,6,2020
5,6/21/2020,131,0,131,7,6,2020
6,6/21/2020,154,0,154,7,6,2020
7,6/21/2020,100,0,100,7,6,2020
8,6/21/2020,84,125,209,7,6,2020
9,6/21/2020,89,128,217,7,6,2020
10,6/21/2020,103,38,141,7,6,2020
11,6/21/2020,77,191,268,7,6,2020
12,6/21/2020,82,78,160,7,6,2020
13,6/21/2020,66,118,184,7,6,2020
14,6/21/2020,55,202,257,7,6,2020
15,6/21/2020,25,211,236,7,6,2020
16,6/21/2020,30,131,161,7,6,2020
17,6/21/2020,10,77,87,7,6,2020
18,6/21/2020,11,261,272,7,6,2020
19,6/21/2020,9,146,155,7,6,2020
20,6/21/2020,45,33,78,7,6,2020
21,6/21/2020,67,92,159,7,6,2020
22,6/21/2020,77,48,125,7,6,2020
23,6/21/2020,75,41,116,7,6,2020
0,6/22/2020,47,0,47,1,6,2020
1,6/22/2020,2,0,2,1,6,2020
2,6/22/2020,20,0,20,1,6,2020
3,6/22/2020,46,0,46,1,6,2020
4,6/22/2020,64,0,64,1,6,2020
5,6/22/2020,74,0,74,1,6,2020
6,6/22/2020,120,0,120,1,6,2020
7,6/22/2020,89,0,89,1,6,2020
8,6/22/2020,82,96,178,1,6,2020
9,6/22/2020,112,179,291,1,6,2020
10,6/22/2020,108,25,133,1,6,2020
11,6/22/2020,48,90,138,1,6,2020
12,6/22/2020,81,69,150,1,6,2020
13,6/22/2020,57,160,217,1,6,2020
14,6/22/2020,45,183,228,1,6,2020
15,6/22/2020,34,249,283,1,6,2020
16,6/22/2020,28,160,188,1,6,2020
17,6/22/2020,10,26,36,1,6,2020
18,6/22/2020,12,131,143,1,6,2020
19,6/22/2020,13,164,177,1,6,2020
20,6/22/2020,17,198,215,1,6,2020
21,6/22/2020,59,48,107,1,6,2020
22,6/22/2020,53,96,149,1,6,2020
23,6/22/2020,28,85,113,1,6,2020
0,6/23/2020,16,0,16,2,6,2020
1,6/23/2020,9,0,9,2,6,2020
2,6/23/2020,8,0,8,2,6,2020
3,6/23/2020,27,0,27,2,6,2020
4,6/23/2020,29,0,29,2,6,2020
5,6/23/2020,83,0,83,2,6,2020
6,6/23/2020,98,0,98,2,6,2020
7,6/23/2020,86,0,86,2,6,2020
8,6/23/2020,83,44,127,2,6,2020
9,6/23/2020,63,106,169,2,6,2020
10,6/23/2020,117,17,134,2,6,2020
11,6/23/2020,81,45,126,2,6,2020
12,6/23/2020,100,62,162,2,6,2020
13,6/23/2020,45,142,187,2,6,2020
14,6/23/2020,32,136,168,2,6,2020
15,6/23/2020,24,185,209,2,6,2020
16,6/23/2020,23,153,176,2,6,2020
17,6/23/2020,8,77,85,2,6,2020
18,6/23/2020,13,47,60,2,6,2020
19,6/23/2020,35,144,179,2,6,2020
20,6/23/2020,30,109,139,2,6,2020
21,6/23/2020,64,131,195,2,6,2020
22,6/23/2020,63,72,135,2,6,2020
23,6/23/2020,73,49,122,2,6,2020
0,6/24/2020,41,0,41,3,6,2020
1,6/24/2020,6,0,6,3,6,2020
2,6/24/2020,4,0,4,3,6,2020
3,6/24/2020,8,0,8,3,6,2020
4,6/24/2020,35,0,35,3,6,2020
5,6/24/2020,74,0,74,3,6,2020
6,6/24/2020,158,0,158,3,6,2020
7,6/24/2020,151,0,151,3,6,2020
8,6/24/2020,75,59,134,3,6,2020
9,6/24/2020,52,60,112,3,6,2020
10,6/24/2020,108,52,160,3,6,2020
11,6/24/2020,84,81,165,3,6,2020
12,6/24/2020,70,10,80,3,6,2020
13,6/24/2020,93,13,106,3,6,2020
14,6/24/2020,59,161,220,3,6,2020
15,6/24/2020,29,177,206,3,6,2020
16,6/24/2020,50,73,123,3,6,2020
17,6/24/2020,9,73,82,3,6,2020
18,6/24/2020,4,104,108,3,6,2020
19,6/24/2020,11,83,94,3,6,2020
20,6/24/2020,34,101,135,3,6,2020
21,6/24/2020,70,78,148,3,6,2020
22,6/24/2020,71,13,84,3,6,2020
23,6/24/2020,29,62,91,3,6,2020
0,6/25/2020,28,0,28,4,6,2020
1,6/25/2020,24,0,24,4,6,2020
2,6/25/2020,20,0,20,4,6,2020
3,6/25/2020,37,0,37,4,6,2020
4,6/25/2020,82,0,82,4,6,2020
5,6/25/2020,102,0,102,4,6,2020
6,6/25/2020,162,0,162,4,6,2020
7,6/25/2020,113,0,113,4,6,2020
8,6/25/2020,96,17,113,4,6,2020
9,6/25/2020,94,62,156,4,6,2020
10,6/25/2020,118,14,132,4,6,2020
11,6/25/2020,71,82,153,4,6,2020
12,6/25/2020,70,7,77,4,6,2020
13,6/25/2020,70,120,190,4,6,2020
14,6/25/2020,72,145,217,4,6,2020
15,6/25/2020,58,97,155,4,6,2020
16,6/25/2020,47,116,163,4,6,2020
17,6/25/2020,11,45,56,4,6,2020
18,6/25/2020,8,68,76,4,6,2020
19,6/25/2020,31,34,65,4,6,2020
20,6/25/2020,51,55,106,4,6,2020
21,6/25/2020,126,48,174,4,6,2020
22,6/25/2020,103,36,139,4,6,2020
23,6/25/2020,99,8,107,4,6,2020
0,6/26/2020,81,0,81,5,6,2020
1,6/26/2020,21,0,21,5,6,2020
2,6/26/2020,0,0,0,5,6,2020
3,6/26/2020,27,0,27,5,6,2020
4,6/26/2020,124,0,124,5,6,2020
5,6/26/2020,190,0,190,5,6,2020
6,6/26/2020,196,0,196,5,6,2020
7,6/26/2020,164,0,164,5,6,2020
8,6/26/2020,103,82,185,5,6,2020
9,6/26/2020,106,65,171,5,6,2020
10,6/26/2020,101,49,150,5,6,2020
11,6/26/2020,86,69,155,5,6,2020
12,6/26/2020,88,57,145,5,6,2020
13,6/26/2020,135,81,216,5,6,2020
14,6/26/2020,92,133,225,5,6,2020
15,6/26/2020,64,142,206,5,6,2020
16,6/26/2020,62,92,154,5,6,2020
17,6/26/2020,7,80,87,5,6,2020
18,6/26/2020,8,72,80,5,6,2020
19,6/26/2020,24,61,85,5,6,2020
20,6/26/2020,44,22,66,5,6,2020
21,6/26/2020,87,66,153,5,6,2020
22,6/26/2020,73,39,112,5,6,2020
23,6/26/2020,69,27,96,5,6,2020
0,6/27/2020,57,0,57,6,6,2020
1,6/27/2020,9,0,9,6,6,2020
2,6/27/2020,45,0,45,6,6,2020
3,6/27/2020,36,0,36,6,6,2020
4,6/27/2020,86,0,86,6,6,2020
5,6/27/2020,196,0,196,6,6,2020
6,6/27/2020,186,0,186,6,6,2020
7,6/27/2020,201,0,201,6,6,2020
8,6/27/2020,156,81,237,6,6,2020
9,6/27/2020,215,138,353,6,6,2020
10,6/27/2020,138,23,161,6,6,2020
11,6/27/2020,154,166,320,6,6,2020
12,6/27/2020,105,132,237,6,6,2020
13,6/27/2020,123,62,185,6,6,2020
14,6/27/2020,84,217,301,6,6,2020
15,6/27/2020,42,231,273,6,6,2020
16,6/27/2020,35,62,97,6,6,2020
17,6/27/2020,13,105,118,6,6,2020
18,6/27/2020,12,119,131,6,6,2020
19,6/27/2020,28,99,127,6,6,2020
20,6/27/2020,60,191,251,6,6,2020
21,6/27/2020,93,91,184,6,6,2020
22,6/27/2020,103,106,209,6,6,2020
23,6/27/2020,75,33,108,6,6,2020
0,6/28/2020,44,0,44,7,6,2020
1,6/28/2020,17,0,17,7,6,2020
2,6/28/2020,45,0,45,7,6,2020
3,6/28/2020,50,0,50,7,6,2020
4,6/28/2020,94,0,94,7,6,2020
5,6/28/2020,96,0,96,7,6,2020
6,6/28/2020,140,0,140,7,6,2020
7,6/28/2020,114,0,114,7,6,2020
8,6/28/2020,86,165,251,7,6,2020
9,6/28/2020,103,165,268,7,6,2020
10,6/28/2020,101,39,140,7,6,2020
11,6/28/2020,83,200,283,7,6,2020
12,6/28/2020,79,166,245,7,6,2020
13,6/28/2020,70,130,200,7,6,2020
14,6/28/2020,65,231,296,7,6,2020
15,6/28/2020,39,319,358,7,6,2020
16,6/28/2020,30,167,197,7,6,2020
17,6/28/2020,10,168,178,7,6,2020
18,6/28/2020,6,334,340,7,6,2020
19,6/28/2020,31,160,191,7,6,2020
20,6/28/2020,30,82,112,7,6,2020
21,6/28/2020,50,158,208,7,6,2020
22,6/28/2020,68,105,173,7,6,2020
23,6/28/2020,28,58,86,7,6,2020
0,6/29/2020,9,0,9,1,6,2020
1,6/29/2020,3,0,3,1,6,2020
2,6/29/2020,6,0,6,1,6,2020
3,6/29/2020,31,0,31,1,6,2020
4,6/29/2020,48,0,48,1,6,2020
5,6/29/2020,116,0,116,1,6,2020
6,6/29/2020,111,0,111,1,6,2020
7,6/29/2020,98,0,98,1,6,2020
8,6/29/2020,67,112,179,1,6,2020
9,6/29/2020,89,79,168,1,6,2020
10,6/29/2020,57,45,102,1,6,2020
11,6/29/2020,69,93,162,1,6,2020
12,6/29/2020,76,111,187,1,6,2020
13,6/29/2020,36,147,183,1,6,2020
14,6/29/2020,39,245,284,1,6,2020
15,6/29/2020,23,221,244,1,6,2020
16,6/29/2020,18,212,230,1,6,2020
17,6/29/2020,17,55,72,1,6,2020
18,6/29/2020,8,164,172,1,6,2020
19,6/29/2020,13,147,160,1,6,2020
20,6/29/2020,39,126,165,1,6,2020
21,6/29/2020,54,87,141,1,6,2020
22,6/29/2020,44,130,174,1,6,2020
23,6/29/2020,40,59,99,1,6,2020
0,6/30/2020,12,0,12,2,6,2020
1,6/30/2020,9,0,9,2,6,2020
2,6/30/2020,0,0,0,2,6,2020
3,6/30/2020,36,0,36,2,6,2020
4,6/30/2020,32,0,32,2,6,2020
5,6/30/2020,88,0,88,2,6,2020
6,6/30/2020,137,0,137,2,6,2020
7,6/30/2020,87,0,87,2,6,2020
8,6/30/2020,59,85,144,2,6,2020
9,6/30/2020,68,61,129,2,6,2020
10,6/30/2020,76,29,105,2,6,2020
11,6/30/2020,98,90,188,2,6,2020
12,6/30/2020,76,30,106,2,6,2020
13,6/30/2020,86,114,200,2,6,2020
14,6/30/2020,31,105,136,2,6,2020
15,6/30/2020,24,210,234,2,6,2020
16,6/30/2020,37,76,113,2,6,2020
17,6/30/2020,25,18,43,2,6,2020
18,6/30/2020,16,90,106,2,6,2020
19,6/30/2020,8,104,112,2,6,2020
20,6/30/2020,73,110,183,2,6,2020
21,6/30/2020,138,120,258,2,6,2020
22,6/30/2020,150,62,212,2,6,2020
23,6/30/2020,139,35,174,2,6,2020
0,7/1/2020,48,0,48,3,7,2020
1,7/1/2020,3,0,3,3,7,2020
2,7/1/2020,18,0,18,3,7,2020
3,7/1/2020,30,0,30,3,7,2020
4,7/1/2020,115,0,115,3,7,2020
5,7/1/2020,107,0,107,3,7,2020
6,7/1/2020,155,0,155,3,7,2020
7,7/1/2020,163,0,163,3,7,2020
8,7/1/2020,116,262,378,3,7,2020
9,7/1/2020,96,71,167,3,7,2020
10,7/1/2020,85,62,147,3,7,2020
11,7/1/2020,81,65,146,3,7,2020
12,7/1/2020,77,59,136,3,7,2020
13,7/1/2020,58,8,66,3,7,2020
14,7/1/2020,52,66,118,3,7,2020
15,7/1/2020,58,119,177,3,7,2020
16,7/1/2020,37,156,193,3,7,2020
17,7/1/2020,24,33,57,3,7,2020
18,7/1/2020,4,68,72,3,7,2020
19,7/1/2020,33,45,78,3,7,2020
20,7/1/2020,93,115,208,3,7,2020
21,7/1/2020,207,46,253,3,7,2020
22,7/1/2020,196,21,217,3,7,2020
23,7/1/2020,162,5,167,3,7,2020
0,7/2/2020,52,0,52,4,7,2020
1,7/2/2020,18,0,18,4,7,2020
2,7/2/2020,29,0,29,4,7,2020
3,7/2/2020,94,0,94,4,7,2020
4,7/2/2020,147,0,147,4,7,2020
5,7/2/2020,215,0,215,4,7,2020
6,7/2/2020,197,0,197,4,7,2020
7,7/2/2020,208,0,208,4,7,2020
8,7/2/2020,199,287,486,4,7,2020
9,7/2/2020,115,156,271,4,7,2020
10,7/2/2020,102,46,148,4,7,2020
11,7/2/2020,96,58,154,4,7,2020
12,7/2/2020,114,83,197,4,7,2020
13,7/2/2020,111,102,213,4,7,2020
14,7/2/2020,90,22,112,4,7,2020
15,7/2/2020,145,59,204,4,7,2020
16,7/2/2020,85,91,176,4,7,2020
17,7/2/2020,73,53,126,4,7,2020
18,7/2/2020,35,155,190,4,7,2020
19,7/2/2020,44,91,135,4,7,2020
20,7/2/2020,96,64,160,4,7,2020
21,7/2/2020,256,78,334,4,7,2020
22,7/2/2020,282,21,303,4,7,2020
23,7/2/2020,292,13,305,4,7,2020
0,7/3/2020,64,0,64,5,7,2020
1,7/3/2020,38,0,38,5,7,2020
2,7/3/2020,57,0,57,5,7,2020
3,7/3/2020,99,0,99,5,7,2020
4,7/3/2020,197,0,197,5,7,2020
5,7/3/2020,230,0,230,5,7,2020
6,7/3/2020,309,0,309,5,7,2020
7,7/3/2020,249,5,254,5,7,2020
8,7/3/2020,189,318,507,5,7,2020
9,7/3/2020,172,73,245,5,7,2020
10,7/3/2020,166,69,235,5,7,2020
11,7/3/2020,128,105,233,5,7,2020
12,7/3/2020,99,61,160,5,7,2020
13,7/3/2020,71,109,180,5,7,2020
14,7/3/2020,88,56,144,5,7,2020
15,7/3/2020,89,107,196,5,7,2020
16,7/3/2020,39,135,174,5,7,2020
17,7/3/2020,41,38,79,5,7,2020
18,7/3/2020,16,97,113,5,7,2020
19,7/3/2020,56,45,101,5,7,2020
20,7/3/2020,115,71,186,5,7,2020
21,7/3/2020,197,156,353,5,7,2020
22,7/3/2020,240,43,283,5,7,2020
23,7/3/2020,144,52,196,5,7,2020
0,7/4/2020,85,0,85,6,7,2020
1,7/4/2020,10,0,10,6,7,2020
2,7/4/2020,26,0,26,6,7,2020
3,7/4/2020,65,0,65,6,7,2020
4,7/4/2020,87,0,87,6,7,2020
5,7/4/2020,113,0,113,6,7,2020
6,7/4/2020,173,0,173,6,7,2020
7,7/4/2020,178,4,182,6,7,2020
8,7/4/2020,191,330,521,6,7,2020
9,7/4/2020,134,143,277,6,7,2020
10,7/4/2020,125,179,304,6,7,2020
11,7/4/2020,85,65,150,6,7,2020
12,7/4/2020,89,140,229,6,7,2020
13,7/4/2020,91,75,166,6,7,2020
14,7/4/2020,57,85,142,6,7,2020
15,7/4/2020,49,185,234,6,7,2020
16,7/4/2020,28,138,166,6,7,2020
17,7/4/2020,31,61,92,6,7,2020
18,7/4/2020,19,91,110,6,7,2020
19,7/4/2020,32,84,116,6,7,2020
20,7/4/2020,108,39,147,6,7,2020
21,7/4/2020,105,95,200,6,7,2020
22,7/4/2020,151,125,276,6,7,2020
23,7/4/2020,116,53,169,6,7,2020
0,7/5/2020,42,16,58,7,7,2020
1,7/5/2020,13,1,14,7,7,2020
2,7/5/2020,21,0,21,7,7,2020
3,7/5/2020,36,0,36,7,7,2020
4,7/5/2020,119,0,119,7,7,2020
5,7/5/2020,114,0,114,7,7,2020
6,7/5/2020,163,77,240,7,7,2020
7,7/5/2020,140,288,428,7,7,2020
8,7/5/2020,135,226,361,7,7,2020
9,7/5/2020,102,138,240,7,7,2020
10,7/5/2020,114,180,294,7,7,2020
11,7/5/2020,80,159,239,7,7,2020
12,7/5/2020,68,130,198,7,7,2020
13,7/5/2020,59,262,321,7,7,2020
14,7/5/2020,80,136,216,7,7,2020
15,7/5/2020,41,150,191,7,7,2020
16,7/5/2020,55,370,425,7,7,2020
17,7/5/2020,15,116,131,7,7,2020
18,7/5/2020,16,364,380,7,7,2020
19,7/5/2020,42,111,153,7,7,2020
20,7/5/2020,63,146,209,7,7,2020
21,7/5/2020,112,178,290,7,7,2020
22,7/5/2020,151,107,258,7,7,2020
23,7/5/2020,67,211,278,7,7,2020
0,7/6/2020,29,120,149,1,7,2020
1,7/6/2020,12,15,27,1,7,2020
2,7/6/2020,15,0,15,1,7,2020
3,7/6/2020,36,0,36,1,7,2020
4,7/6/2020,43,0,43,1,7,2020
5,7/6/2020,62,0,62,1,7,2020
6,7/6/2020,137,82,219,1,7,2020
7,7/6/2020,94,20,114,1,7,2020
8,7/6/2020,85,271,356,1,7,2020
9,7/6/2020,65,186,251,1,7,2020
10,7/6/2020,82,117,199,1,7,2020
11,7/6/2020,81,174,255,1,7,2020
12,7/6/2020,31,55,86,1,7,2020
13,7/6/2020,44,212,256,1,7,2020
14,7/6/2020,28,84,112,1,7,2020
15,7/6/2020,42,154,196,1,7,2020
16,7/6/2020,20,275,295,1,7,2020
17,7/6/2020,12,47,59,1,7,2020
18,7/6/2020,18,179,197,1,7,2020
19,7/6/2020,19,259,278,1,7,2020
20,7/6/2020,61,168,229,1,7,2020
21,7/6/2020,82,140,222,1,7,2020
22,7/6/2020,118,70,188,1,7,2020
23,7/6/2020,88,105,193,1,7,2020
0,7/7/2020,28,97,125,2,7,2020
1,7/7/2020,12,0,12,2,7,2020
2,7/7/2020,27,0,27,2,7,2020
3,7/7/2020,44,0,44,2,7,2020
4,7/7/2020,52,0,52,2,7,2020
5,7/7/2020,105,0,105,2,7,2020
6,7/7/2020,107,45,152,2,7,2020
7,7/7/2020,131,173,304,2,7,2020
8,7/7/2020,95,123,218,2,7,2020
9,7/7/2020,53,48,101,2,7,2020
10,7/7/2020,65,90,155,2,7,2020
11,7/7/2020,40,93,133,2,7,2020
12,7/7/2020,44,98,142,2,7,2020
13,7/7/2020,35,59,94,2,7,2020
14,7/7/2020,35,131,166,2,7,2020
15,7/7/2020,24,86,110,2,7,2020
16,7/7/2020,18,72,90,2,7,2020
17,7/7/2020,23,97,120,2,7,2020
18,7/7/2020,16,249,265,2,7,2020
19,7/7/2020,5,55,60,2,7,2020
20,7/7/2020,56,161,217,2,7,2020
21,7/7/2020,118,81,199,2,7,2020
22,7/7/2020,157,22,179,2,7,2020
23,7/7/2020,106,45,151,2,7,2020
0,7/8/2020,19,29,48,3,7,2020
1,7/8/2020,17,0,17,3,7,2020
2,7/8/2020,25,0,25,3,7,2020
3,7/8/2020,58,0,58,3,7,2020
4,7/8/2020,69,0,69,3,7,2020
5,7/8/2020,64,0,64,3,7,2020
6,7/8/2020,135,45,180,3,7,2020
7,7/8/2020,133,144,277,3,7,2020
8,7/8/2020,85,112,197,3,7,2020
9,7/8/2020,84,67,151,3,7,2020
10,7/8/2020,89,62,151,3,7,2020
11,7/8/2020,58,167,225,3,7,2020
12,7/8/2020,60,75,135,3,7,2020
13,7/8/2020,53,54,107,3,7,2020
14,7/8/2020,35,47,82,3,7,2020
15,7/8/2020,40,146,186,3,7,2020
16,7/8/2020,19,159,178,3,7,2020
17,7/8/2020,12,21,33,3,7,2020
18,7/8/2020,21,119,140,3,7,2020
19,7/8/2020,25,16,41,3,7,2020
20,7/8/2020,69,118,187,3,7,2020
21,7/8/2020,187,34,221,3,7,2020
22,7/8/2020,123,61,184,3,7,2020
23,7/8/2020,128,40,168,3,7,2020
0,7/9/2020,64,11,75,4,7,2020
1,7/9/2020,13,5,18,4,7,2020
2,7/9/2020,48,0,48,4,7,2020
3,7/9/2020,97,0,97,4,7,2020
4,7/9/2020,125,0,125,4,7,2020
5,7/9/2020,114,0,114,4,7,2020
6,7/9/2020,153,36,189,4,7,2020
7,7/9/2020,170,158,328,4,7,2020
8,7/9/2020,167,80,247,4,7,2020
9,7/9/2020,74,90,164,4,7,2020
10,7/9/2020,74,40,114,4,7,2020
11,7/9/2020,64,42,106,4,7,2020
12,7/9/2020,60,47,107,4,7,2020
13,7/9/2020,51,121,172,4,7,2020
14,7/9/2020,43,38,81,4,7,2020
15,7/9/2020,77,51,128,4,7,2020
16,7/9/2020,37,78,115,4,7,2020
17,7/9/2020,31,73,104,4,7,2020
18,7/9/2020,27,128,155,4,7,2020
19,7/9/2020,27,9,36,4,7,2020
20,7/9/2020,102,93,195,4,7,2020
21,7/9/2020,190,122,312,4,7,2020
22,7/9/2020,197,13,210,4,7,2020
23,7/9/2020,114,15,129,4,7,2020
0,7/10/2020,78,2,80,5,7,2020
1,7/10/2020,22,10,32,5,7,2020
2,7/10/2020,32,0,32,5,7,2020
3,7/10/2020,61,0,61,5,7,2020
4,7/10/2020,78,0,78,5,7,2020
5,7/10/2020,133,0,133,5,7,2020
6,7/10/2020,212,51,263,5,7,2020
7,7/10/2020,141,128,269,5,7,2020
8,7/10/2020,148,128,276,5,7,2020
9,7/10/2020,116,85,201,5,7,2020
10,7/10/2020,124,38,162,5,7,2020
11,7/10/2020,58,80,138,5,7,2020
12,7/10/2020,36,46,82,5,7,2020
13,7/10/2020,67,91,158,5,7,2020
14,7/10/2020,86,66,152,5,7,2020
15,7/10/2020,69,94,163,5,7,2020
16,7/10/2020,52,117,169,5,7,2020
17,7/10/2020,34,74,108,5,7,2020
18,7/10/2020,7,108,115,5,7,2020
19,7/10/2020,66,32,98,5,7,2020
20,7/10/2020,93,111,204,5,7,2020
21,7/10/2020,221,111,332,5,7,2020
22,7/10/2020,257,38,295,5,7,2020
23,7/10/2020,183,44,227,5,7,2020
0,7/11/2020,96,9,105,6,7,2020
1,7/11/2020,21,5,26,6,7,2020
2,7/11/2020,35,0,35,6,7,2020
3,7/11/2020,49,0,49,6,7,2020
4,7/11/2020,132,0,132,6,7,2020
5,7/11/2020,110,0,110,6,7,2020
6,7/11/2020,197,0,197,6,7,2020
7,7/11/2020,234,30,264,6,7,2020
8,7/11/2020,149,93,242,6,7,2020
9,7/11/2020,158,308,466,6,7,2020
10,7/11/2020,134,323,457,6,7,2020
11,7/11/2020,80,136,216,6,7,2020
12,7/11/2020,62,95,157,6,7,2020
13,7/11/2020,57,138,195,6,7,2020
14,7/11/2020,58,57,115,6,7,2020
15,7/11/2020,68,112,180,6,7,2020
16,7/11/2020,31,231,262,6,7,2020
17,7/11/2020,9,144,153,6,7,2020
18,7/11/2020,22,131,153,6,7,2020
19,7/11/2020,38,137,175,6,7,2020
20,7/11/2020,102,106,208,6,7,2020
21,7/11/2020,93,156,249,6,7,2020
22,7/11/2020,158,97,255,6,7,2020
23,7/11/2020,117,76,193,6,7,2020
0,7/12/2020,26,71,97,7,7,2020
1,7/12/2020,35,0,35,7,7,2020
2,7/12/2020,26,0,26,7,7,2020
3,7/12/2020,58,0,58,7,7,2020
4,7/12/2020,92,0,92,7,7,2020
5,7/12/2020,106,0,106,7,7,2020
6,7/12/2020,162,106,268,7,7,2020
7,7/12/2020,132,208,340,7,7,2020
8,7/12/2020,95,226,321,7,7,2020
9,7/12/2020,85,55,140,7,7,2020
10,7/12/2020,80,170,250,7,7,2020
11,7/12/2020,76,143,219,7,7,2020
12,7/12/2020,76,151,227,7,7,2020
13,7/12/2020,49,273,322,7,7,2020
14,7/12/2020,63,101,164,7,7,2020
15,7/12/2020,42,198,240,7,7,2020
16,7/12/2020,29,253,282,7,7,2020
17,7/12/2020,15,169,184,7,7,2020
18,7/12/2020,6,240,246,7,7,2020
19,7/12/2020,21,144,165,7,7,2020
20,7/12/2020,68,95,163,7,7,2020
21,7/12/2020,98,158,256,7,7,2020
22,7/12/2020,104,89,193,7,7,2020
23,7/12/2020,74,103,177,7,7,2020
0,7/13/2020,41,122,163,1,7,2020
1,7/13/2020,2,5,7,1,7,2020
2,7/13/2020,15,0,15,1,7,2020
3,7/13/2020,20,0,20,1,7,2020
4,7/13/2020,60,0,60,1,7,2020
5,7/13/2020,66,0,66,1,7,2020
6,7/13/2020,94,44,138,1,7,2020
7,7/13/2020,87,158,245,1,7,2020
8,7/13/2020,61,98,159,1,7,2020
9,7/13/2020,76,69,145,1,7,2020
10,7/13/2020,46,75,121,1,7,2020
11,7/13/2020,55,129,184,1,7,2020
12,7/13/2020,27,108,135,1,7,2020
13,7/13/2020,35,128,163,1,7,2020
14,7/13/2020,31,29,60,1,7,2020
15,7/13/2020,24,129,153,1,7,2020
16,7/13/2020,23,182,205,1,7,2020
17,7/13/2020,7,64,71,1,7,2020
18,7/13/2020,7,152,159,1,7,2020
19,7/13/2020,38,129,167,1,7,2020
20,7/13/2020,79,106,185,1,7,2020
21,7/13/2020,116,168,284,1,7,2020
22,7/13/2020,110,15,125,1,7,2020
23,7/13/2020,88,116,204,1,7,2020
0,7/14/2020,27,52,79,2,7,2020
1,7/14/2020,10,6,16,2,7,2020
2,7/14/2020,8,0,8,2,7,2020
3,7/14/2020,29,0,29,2,7,2020
4,7/14/2020,37,0,37,2,7,2020
5,7/14/2020,79,0,79,2,7,2020
6,7/14/2020,124,49,173,2,7,2020
7,7/14/2020,126,182,308,2,7,2020
8,7/14/2020,131,125,256,2,7,2020
9,7/14/2020,53,38,91,2,7,2020
10,7/14/2020,64,46,110,2,7,2020
11,7/14/2020,52,49,101,2,7,2020
12,7/14/2020,43,85,128,2,7,2020
13,7/14/2020,33,95,128,2,7,2020
14,7/14/2020,22,70,92,2,7,2020
15,7/14/2020,20,112,132,2,7,2020
16,7/14/2020,15,137,152,2,7,2020
17,7/14/2020,8,132,140,2,7,2020
18,7/14/2020,12,128,140,2,7,2020
19,7/14/2020,8,68,76,2,7,2020
20,7/14/2020,61,78,139,2,7,2020
21,7/14/2020,122,113,235,2,7,2020
22,7/14/2020,147,56,203,2,7,2020
23,7/14/2020,99,31,130,2,7,2020
0,7/15/2020,24,21,45,3,7,2020
1,7/15/2020,10,2,12,3,7,2020
2,7/15/2020,24,0,24,3,7,2020
3,7/15/2020,47,0,47,3,7,2020
4,7/15/2020,48,0,48,3,7,2020
5,7/15/2020,69,0,69,3,7,2020
6,7/15/2020,146,30,176,3,7,2020
7,7/15/2020,122,147,269,3,7,2020
8,7/15/2020,139,56,195,3,7,2020
9,7/15/2020,99,66,165,3,7,2020
10,7/15/2020,78,70,148,3,7,2020
11,7/15/2020,67,88,155,3,7,2020
12,7/15/2020,43,81,124,3,7,2020
13,7/15/2020,50,48,98,3,7,2020
14,7/15/2020,47,58,105,3,7,2020
15,7/15/2020,21,95,116,3,7,2020
16,7/15/2020,31,129,160,3,7,2020
17,7/15/2020,19,8,27,3,7,2020
18,7/15/2020,13,123,136,3,7,2020
19,7/15/2020,24,84,108,3,7,2020
20,7/15/2020,74,73,147,3,7,2020
21,7/15/2020,114,46,160,3,7,2020
22,7/15/2020,178,18,196,3,7,2020
23,7/15/2020,97,30,127,3,7,2020
0,7/16/2020,51,12,63,4,7,2020
1,7/16/2020,9,2,11,4,7,2020
2,7/16/2020,17,0,17,4,7,2020
3,7/16/2020,85,0,85,4,7,2020
4,7/16/2020,168,0,168,4,7,2020
5,7/16/2020,102,0,102,4,7,2020
6,7/16/2020,179,28,207,4,7,2020
7,7/16/2020,143,124,267,4,7,2020
8,7/16/2020,129,142,271,4,7,2020
9,7/16/2020,78,87,165,4,7,2020
10,7/16/2020,86,68,154,4,7,2020
11,7/16/2020,96,80,176,4,7,2020
12,7/16/2020,54,66,120,4,7,2020
13,7/16/2020,29,97,126,4,7,2020
14,7/16/2020,69,33,102,4,7,2020
15,7/16/2020,70,51,121,4,7,2020
16,7/16/2020,34,80,114,4,7,2020
17,7/16/2020,45,65,110,4,7,2020
18,7/16/2020,13,133,146,4,7,2020
19,7/16/2020,34,57,91,4,7,2020
20,7/16/2020,93,88,181,4,7,2020
21,7/16/2020,202,94,296,4,7,2020
22,7/16/2020,222,16,238,4,7,2020
23,7/16/2020,172,20,192,4,7,2020
0,7/17/2020,56,8,64,5,7,2020
1,7/17/2020,5,3,8,5,7,2020
2,7/17/2020,37,0,37,5,7,2020
3,7/17/2020,69,0,69,5,7,2020
4,7/17/2020,101,0,101,5,7,2020
5,7/17/2020,134,0,134,5,7,2020
6,7/17/2020,172,40,212,5,7,2020
7,7/17/2020,136,115,251,5,7,2020
8,7/17/2020,80,158,238,5,7,2020
9,7/17/2020,115,67,182,5,7,2020
10,7/17/2020,108,66,174,5,7,2020
11,7/17/2020,108,93,201,5,7,2020
12,7/17/2020,89,54,143,5,7,2020
13,7/17/2020,49,74,123,5,7,2020
14,7/17/2020,68,63,131,5,7,2020
15,7/17/2020,70,102,172,5,7,2020
16,7/17/2020,45,116,161,5,7,2020
17,7/17/2020,24,81,105,5,7,2020
18,7/17/2020,22,92,114,5,7,2020
19,7/17/2020,46,46,92,5,7,2020
20,7/17/2020,106,90,196,5,7,2020
21,7/17/2020,232,117,349,5,7,2020
22,7/17/2020,297,58,355,5,7,2020
23,7/17/2020,136,52,188,5,7,2020
0,7/18/2020,92,15,107,6,7,2020
1,7/18/2020,42,2,44,6,7,2020
2,7/18/2020,43,0,43,6,7,2020
3,7/18/2020,58,0,58,6,7,2020
4,7/18/2020,77,0,77,6,7,2020
5,7/18/2020,135,0,135,6,7,2020
6,7/18/2020,193,15,208,6,7,2020
7,7/18/2020,224,62,286,6,7,2020
8,7/18/2020,171,168,339,6,7,2020
9,7/18/2020,150,215,365,6,7,2020
10,7/18/2020,147,225,372,6,7,2020
11,7/18/2020,78,104,182,6,7,2020
12,7/18/2020,75,114,189,6,7,2020
13,7/18/2020,40,100,140,6,7,2020
14,7/18/2020,50,78,128,6,7,2020
15,7/18/2020,63,160,223,6,7,2020
16,7/18/2020,36,192,228,6,7,2020
17,7/18/2020,22,111,133,6,7,2020
18,7/18/2020,22,156,178,6,7,2020
19,7/18/2020,39,117,156,6,7,2020
20,7/18/2020,105,103,208,6,7,2020
21,7/18/2020,139,129,268,6,7,2020
22,7/18/2020,141,104,245,6,7,2020
23,7/18/2020,141,78,219,6,7,2020
0,7/19/2020,45,57,102,7,7,2020
1,7/19/2020,8,2,10,7,7,2020
2,7/19/2020,34,0,34,7,7,2020
3,7/19/2020,72,0,72,7,7,2020
4,7/19/2020,92,0,92,7,7,2020
5,7/19/2020,92,0,92,7,7,2020
6,7/19/2020,142,94,236,7,7,2020
7,7/19/2020,92,204,296,7,7,2020
8,7/19/2020,76,212,288,7,7,2020
9,7/19/2020,93,112,205,7,7,2020
10,7/19/2020,79,139,218,7,7,2020
11,7/19/2020,99,150,249,7,7,2020
12,7/19/2020,81,134,215,7,7,2020
13,7/19/2020,50,202,252,7,7,2020
14,7/19/2020,34,105,139,7,7,2020
15,7/19/2020,43,186,229,7,7,2020
16,7/19/2020,25,267,292,7,7,2020
17,7/19/2020,24,143,167,7,7,2020
18,7/19/2020,10,246,256,7,7,2020
19,7/19/2020,19,119,138,7,7,2020
20,7/19/2020,46,114,160,7,7,2020
21,7/19/2020,115,144,259,7,7,2020
22,7/19/2020,103,107,210,7,7,2020
23,7/19/2020,40,124,164,7,7,2020
0,7/20/2020,2,169,171,1,7,2020
1,7/20/2020,8,0,8,1,7,2020
2,7/20/2020,1,0,1,1,7,2020
3,7/20/2020,17,0,17,1,7,2020
4,7/20/2020,56,0,56,1,7,2020
5,7/20/2020,65,0,65,1,7,2020
6,7/20/2020,86,0,86,1,7,2020
7,7/20/2020,72,5,77,1,7,2020
8,7/20/2020,60,10,70,1,7,2020
9,7/20/2020,99,243,342,1,7,2020
10,7/20/2020,95,291,386,1,7,2020
11,7/20/2020,42,101,143,1,7,2020
12,7/20/2020,39,68,107,1,7,2020
13,7/20/2020,52,177,229,1,7,2020
14,7/20/2020,20,21,41,1,7,2020
15,7/20/2020,19,140,159,1,7,2020
16,7/20/2020,16,192,208,1,7,2020
17,7/20/2020,7,49,56,1,7,2020
18,7/20/2020,10,181,191,1,7,2020
19,7/20/2020,18,94,112,1,7,2020
20,7/20/2020,45,103,148,1,7,2020
21,7/20/2020,112,109,221,1,7,2020
22,7/20/2020,105,58,163,1,7,2020
23,7/20/2020,91,161,252,1,7,2020
0,7/21/2020,47,75,122,2,7,2020
1,7/21/2020,15,0,15,2,7,2020
2,7/21/2020,11,0,11,2,7,2020
3,7/21/2020,30,0,30,2,7,2020
4,7/21/2020,49,0,49,2,7,2020
5,7/21/2020,88,0,88,2,7,2020
6,7/21/2020,97,50,147,2,7,2020
7,7/21/2020,101,130,231,2,7,2020
8,7/21/2020,61,100,161,2,7,2020
9,7/21/2020,62,30,92,2,7,2020
10,7/21/2020,40,28,68,2,7,2020
11,7/21/2020,44,96,140,2,7,2020
12,7/21/2020,43,81,124,2,7,2020
13,7/21/2020,34,112,146,2,7,2020
14,7/21/2020,20,73,93,2,7,2020
15,7/21/2020,8,69,77,2,7,2020
16,7/21/2020,19,105,124,2,7,2020
17,7/21/2020,5,125,130,2,7,2020
18,7/21/2020,7,171,178,2,7,2020
19,7/21/2020,17,37,54,2,7,2020
20,7/21/2020,47,186,233,2,7,2020
21,7/21/2020,138,75,213,2,7,2020
22,7/21/2020,115,12,127,2,7,2020
23,7/21/2020,120,16,136,2,7,2020
0,7/22/2020,21,20,41,3,7,2020
1,7/22/2020,6,0,6,3,7,2020
2,7/22/2020,22,0,22,3,7,2020
3,7/22/2020,46,0,46,3,7,2020
4,7/22/2020,56,0,56,3,7,2020
5,7/22/2020,99,0,99,3,7,2020
6,7/22/2020,153,30,183,3,7,2020
7,7/22/2020,169,114,283,3,7,2020
8,7/22/2020,114,53,167,3,7,2020
9,7/22/2020,50,88,138,3,7,2020
10,7/22/2020,76,52,128,3,7,2020
11,7/22/2020,55,95,150,3,7,2020
12,7/22/2020,48,135,183,3,7,2020
13,7/22/2020,30,27,57,3,7,2020
14,7/22/2020,26,80,106,3,7,2020
15,7/22/2020,30,70,100,3,7,2020
16,7/22/2020,14,184,198,3,7,2020
17,7/22/2020,24,18,42,3,7,2020
18,7/22/2020,10,113,123,3,7,2020
19,7/22/2020,28,36,64,3,7,2020
20,7/22/2020,49,98,147,3,7,2020
21,7/22/2020,191,41,232,3,7,2020
22,7/22/2020,147,44,191,3,7,2020
23,7/22/2020,141,21,162,3,7,2020
0,7/23/2020,78,6,84,4,7,2020
1,7/23/2020,16,0,16,4,7,2020
2,7/23/2020,31,0,31,4,7,2020
3,7/23/2020,78,0,78,4,7,2020
4,7/23/2020,93,0,93,4,7,2020
5,7/23/2020,142,0,142,4,7,2020
6,7/23/2020,188,60,248,4,7,2020
7,7/23/2020,184,96,280,4,7,2020
8,7/23/2020,144,116,260,4,7,2020
9,7/23/2020,72,75,147,4,7,2020
10,7/23/2020,52,38,90,4,7,2020
11,7/23/2020,54,44,98,4,7,2020
12,7/23/2020,80,75,155,4,7,2020
13,7/23/2020,54,44,98,4,7,2020
14,7/23/2020,77,31,108,4,7,2020
15,7/23/2020,46,79,125,4,7,2020
16,7/23/2020,53,87,140,4,7,2020
17,7/23/2020,37,93,130,4,7,2020
18,7/23/2020,19,85,104,4,7,2020
19,7/23/2020,23,79,102,4,7,2020
20,7/23/2020,96,64,160,4,7,2020
21,7/23/2020,151,115,266,4,7,2020
22,7/23/2020,234,39,273,4,7,2020
23,7/23/2020,156,19,175,4,7,2020
0,7/24/2020,85,17,102,5,7,2020
1,7/24/2020,13,12,25,5,7,2020
2,7/24/2020,23,2,25,5,7,2020
3,7/24/2020,61,0,61,5,7,2020
4,7/24/2020,174,0,174,5,7,2020
5,7/24/2020,141,0,141,5,7,2020
6,7/24/2020,187,32,219,5,7,2020
7,7/24/2020,164,84,248,5,7,2020
8,7/24/2020,139,102,241,5,7,2020
9,7/24/2020,135,46,181,5,7,2020
10,7/24/2020,140,55,195,5,7,2020
11,7/24/2020,83,84,167,5,7,2020
12,7/24/2020,85,85,170,5,7,2020
13,7/24/2020,53,61,114,5,7,2020
14,7/24/2020,52,61,113,5,7,2020
15,7/24/2020,68,65,133,5,7,2020
16,7/24/2020,40,106,146,5,7,2020
17,7/24/2020,37,75,112,5,7,2020
18,7/24/2020,29,91,120,5,7,2020
19,7/24/2020,36,86,122,5,7,2020
20,7/24/2020,83,101,184,5,7,2020
21,7/24/2020,195,113,308,5,7,2020
22,7/24/2020,217,70,287,5,7,2020
23,7/24/2020,253,27,280,5,7,2020
0,7/25/2020,87,22,98,6,7,2020
1,7/25/2020,31,0,20,6,7,2020
2,7/25/2020,25,0,31,6,7,2020
3,7/25/2020,69,0,54,6,7,2020
4,7/25/2020,99,0,99,6,7,2020
5,7/25/2020,97,0,103,6,7,2020
6,7/25/2020,155,37,183,6,7,2020
7,7/25/2020,256,208,251,6,7,2020
8,7/25/2020,201,166,335,6,7,2020
9,7/25/2020,109,160,345,6,7,2020
10,7/25/2020,99,119,338,6,7,2020
11,7/25/2020,71,69,183,6,7,2020
12,7/25/2020,65,154,185,6,7,2020
13,7/25/2020,57,158,168,6,7,2020
14,7/25/2020,33,161,133,6,7,2020
15,7/25/2020,40,101,218,6,7,2020
16,7/25/2020,49,171,222,6,7,2020
17,7/25/2020,13,34,123,6,7,2020
18,7/25/2020,16,161,173,6,7,2020
19,7/25/2020,43,85,148,6,7,2020
20,7/25/2020,81,103,198,6,7,2020
21,7/25/2020,127,160,232,6,7,2020
22,7/25/2020,116,132,249,6,7,2020
23,7/25/2020,111,75,195,6,7,2020
0,7/26/2020,71,31,95,7,7,2020
1,7/26/2020,9,0,23,7,7,2020
2,7/26/2020,8,0,28,7,7,2020
3,7/26/2020,61,0,51,7,7,2020
4,7/26/2020,69,2,90,7,7,2020
5,7/26/2020,107,0,103,7,7,2020
6,7/26/2020,156,96,241,7,7,2020
7,7/26/2020,119,319,333,7,7,2020
8,7/26/2020,107,161,312,7,7,2020
9,7/26/2020,63,131,207,7,7,2020
10,7/26/2020,94,129,226,7,7,2020
11,7/26/2020,83,76,220,7,7,2020
12,7/26/2020,54,164,195,7,7,2020
13,7/26/2020,45,230,258,7,7,2020
14,7/26/2020,23,108,167,7,7,2020
15,7/26/2020,48,123,227,7,7,2020
16,7/26/2020,58,212,295,7,7,2020
17,7/26/2020,21,191,158,7,7,2020
18,7/26/2020,15,248,260,7,7,2020
19,7/26/2020,26,81,142,7,7,2020
20,7/26/2020,32,191,181,7,7,2020
21,7/26/2020,122,165,262,7,7,2020
22,7/26/2020,90,84,234,7,7,2020
23,7/26/2020,52,166,216,7,7,2020
0,7/27/2020,31,102,133,1,7,2020
1,7/27/2020,15,5,20,1,7,2020
2,7/27/2020,18,1,19,1,7,2020
3,7/27/2020,39,1,40,1,7,2020
4,7/27/2020,51,1,52,1,7,2020
5,7/27/2020,77,1,78,1,7,2020
6,7/27/2020,128,57,185,1,7,2020
7,7/27/2020,91,94,185,1,7,2020
8,7/27/2020,82,158,240,1,7,2020
9,7/27/2020,73,130,203,1,7,2020
10,7/27/2020,78,89,167,1,7,2020
11,7/27/2020,66,135,201,1,7,2020
12,7/27/2020,33,93,126,1,7,2020
13,7/27/2020,44,130,174,1,7,2020
14,7/27/2020,33,41,74,1,7,2020
15,7/27/2020,47,134,181,1,7,2020
16,7/27/2020,31,177,208,1,7,2020
17,7/27/2020,17,82,99,1,7,2020
18,7/27/2020,16,153,169,1,7,2020
19,7/27/2020,18,118,136,1,7,2020
20,7/27/2020,62,110,172,1,7,2020
21,7/27/2020,93,126,219,1,7,2020
22,7/27/2020,94,46,140,1,7,2020
23,7/27/2020,80,108,188,1,7,2020
0,7/28/2020,29,75,104,2,7,2020
1,7/28/2020,14,2,16,2,7,2020
2,7/28/2020,25,0,25,2,7,2020
3,7/28/2020,40,2,42,2,7,2020
4,7/28/2020,55,0,55,2,7,2020
5,7/28/2020,88,0,88,2,7,2020
6,7/28/2020,113,58,171,2,7,2020
7,7/28/2020,125,149,274,2,7,2020
8,7/28/2020,111,120,231,2,7,2020
9,7/28/2020,69,93,162,2,7,2020
10,7/28/2020,72,58,130,2,7,2020
11,7/28/2020,40,95,135,2,7,2020
12,7/28/2020,43,91,134,2,7,2020
13,7/28/2020,29,105,134,2,7,2020
14,7/28/2020,35,100,135,2,7,2020
15,7/28/2020,25,109,134,2,7,2020
16,7/28/2020,23,109,132,2,7,2020
17,7/28/2020,18,91,109,2,7,2020
18,7/28/2020,16,185,201,2,7,2020
19,7/28/2020,21,66,87,2,7,2020
20,7/28/2020,64,107,171,2,7,2020
21,7/28/2020,114,98,212,2,7,2020
22,7/28/2020,122,46,168,2,7,2020
23,7/28/2020,102,51,153,2,7,2020
0,7/29/2020,29,29,58,3,7,2020
1,7/29/2020,18,0,18,3,7,2020
2,7/29/2020,27,1,28,3,7,2020
3,7/29/2020,55,0,55,3,7,2020
4,7/29/2020,68,0,68,3,7,2020
5,7/29/2020,94,0,94,3,7,2020
6,7/29/2020,143,34,177,3,7,2020
7,7/29/2020,133,95,228,3,7,2020
8,7/29/2020,101,71,172,3,7,2020
9,7/29/2020,85,74,159,3,7,2020
10,7/29/2020,75,72,147,3,7,2020
11,7/29/2020,59,119,178,3,7,2020
12,7/29/2020,57,79,136,3,7,2020
13,7/29/2020,54,49,103,3,7,2020
14,7/29/2020,35,56,91,3,7,2020
15,7/29/2020,46,107,153,3,7,2020
16,7/29/2020,22,127,149,3,7,2020
17,7/29/2020,14,28,42,3,7,2020
18,7/29/2020,16,120,136,3,7,2020
19,7/29/2020,23,51,74,3,7,2020
20,7/29/2020,84,86,170,3,7,2020
21,7/29/2020,152,58,210,3,7,2020
22,7/29/2020,143,45,188,3,7,2020
23,7/29/2020,132,41,173,3,7,2020
0,7/30/2020,59,12,71,4,7,2020
1,7/30/2020,17,2,19,4,7,2020
2,7/30/2020,39,0,39,4,7,2020
3,7/30/2020,87,0,87,4,7,2020
4,7/30/2020,127,0,127,4,7,2020
5,7/30/2020,120,0,120,4,7,2020
6,7/30/2020,160,28,188,4,7,2020
7,7/30/2020,171,124,295,4,7,2020
8,7/30/2020,175,142,317,4,7,2020
9,7/30/2020,80,87,167,4,7,2020
10,7/30/2020,77,68,145,4,7,2020
11,7/30/2020,69,80,149,4,7,2020
12,7/30/2020,65,66,131,4,7,2020
13,7/30/2020,57,97,154,4,7,2020
14,7/30/2020,47,33,80,4,7,2020
15,7/30/2020,100,51,151,4,7,2020
16,7/30/2020,62,80,142,4,7,2020
17,7/30/2020,40,65,105,4,7,2020
18,7/30/2020,28,133,161,4,7,2020
19,7/30/2020,26,57,83,4,7,2020
20,7/30/2020,96,88,184,4,7,2020
21,7/30/2020,196,94,290,4,7,2020
22,7/30/2020,200,16,216,4,7,2020
23,7/30/2020,125,20,145,4,7,2020
0,7/31/2020,61,8,69,5,7,2020
1,7/31/2020,23,3,26,5,7,2020
2,7/31/2020,34,0,34,5,7,2020
3,7/31/2020,60,0,60,5,7,2020
4,7/31/2020,73,0,73,5,7,2020
5,7/31/2020,149,0,149,5,7,2020
6,7/31/2020,198,40,238,5,7,2020
7,7/31/2020,148,115,263,5,7,2020
8,7/31/2020,151,158,309,5,7,2020
9,7/31/2020,116,67,183,5,7,2020
10,7/31/2020,123,66,189,5,7,2020
11,7/31/2020,76,93,169,5,7,2020
12,7/31/2020,66,54,120,5,7,2020
13,7/31/2020,66,74,140,5,7,2020
14,7/31/2020,80,63,143,5,7,2020
15,7/31/2020,79,102,181,5,7,2020
16,7/31/2020,42,116,158,5,7,2020
17,7/31/2020,26,81,107,5,7,2020
18,7/31/2020,11,92,103,5,7,2020
19,7/31/2020,39,46,85,5,7,2020
20,7/31/2020,89,90,179,5,7,2020
21,7/31/2020,204,117,321,5,7,2020
22,7/31/2020,212,58,270,5,7,2020
23,7/31/2020,161,52,213,5,7,2020
